codmun;nomemun;ano;Total;Urbana;Rural
1100106;Guajará-Mirim;1970;27016;11719;15297
1100205;Porto Velho;1970;84048;47888;36160
1200104;Brasiléia;1970;12311;2664;9647
1200203;Cruzeiro do Sul;1970;43584;9610;33974
1200302;Feijó;1970;15768;2256;13512
1200401;Rio Branco;1970;83977;35628;48349
1200500;Sena Madureira;1970;22470;3577;18893
1200609;Tarauacá;1970;23862;3832;20030
1200708;Xapuri;1970;13327;1872;11455
1300102;Anori;1970;12212;3504;8708
1300201;Atalaia do Norte;1970;6014;740;5274
1300300;Autazes;1970;17725;915;16810
1300409;Barcelos;1970;9628;1152;8476
1300508;Barreirinha;1970;13998;1931;12067
1300607;Benjamin Constant;1970;15127;4448;10679
1300706;Boca do Acre;1970;19989;4105;15884
1300805;Borba;1970;16514;2750;13764
1300904;Canutama;1970;5759;1322;4437
1301001;Carauari;1970;16984;2373;14611
1301100;Careiro;1970;40767;168;40599
1301209;Coari;1970;27636;8878;18758
1301308;Codajás;1970;12110;2387;9723
1301407;Eirunepé;1970;10882;3930;6952
1301506;Envira;1970;11705;802;10903
1301605;Fonte Boa;1970;11744;2015;9729
1301704;Humaitá;1970;14877;1169;13708
1301803;Ipixuna;1970;12846;688;12158
1301902;Itacoatiara;1970;37346;16084;21262
1302009;Itapiranga;1970;2646;675;1971
1302108;Japurá;1970;2415;127;2288
1302207;Juruá;1970;6785;213;6572
1302306;Jutaí;1970;3955;427;3528
1302405;Lábrea;1970;16737;3010;13727
1302504;Manacapuru;1970;49469;7247;42222
1302603;Manaus;1970;311622;283673;27949
1302702;Manicoré;1970;21100;3358;17742
1302801;Maraã;1970;8293;314;7979
1302900;Maués;1970;24095;6029;18066
1303007;Nhamundá;1970;15539;554;14985
1303106;Nova Olinda do Norte;1970;11903;1896;10007
1303205;Novo Airão;1970;6077;312;5765
1303304;Novo Aripuanã;1970;16585;2354;14231
1303403;Parintins;1970;38086;16747;21339
1303502;Pauini;1970;9693;454;9239
1303601;Santa Isabel do Rio Negro;1970;3646;509;3137
1303700;Santo Antônio do Içá;1970;9437;1975;7462
1303809;São Gabriel da Cachoeira;1970;13420;1346;12074
1303908;São Paulo de Olivença;1970;18814;3479;15335
1304005;Silves;1970;4437;602;3835
1304104;Tapauá;1970;10571;951;9620
1304203;Tefé;1970;19173;7822;11351
1304302;Urucará;1970;6550;2091;4459
1304401;Urucurituba;1970;10292;526;9766
1400100;Boa Vista;1970;36464;16868;19596
1400209;Caracaraí;1970;4421;714;3707
1500107;Abaetetuba;1970;57520;19785;37735
1500206;Acará;1970;24487;1288;23199
1500305;Afuá;1970;17826;752;17074
1500404;Alenquer;1970;35021;11367;23654
1500503;Almeirim;1970;11889;3527;8362
1500602;Altamira;1970;15345;5905;9440
1500701;Anajás;1970;10092;255;9837
1500800;Ananindeua;1970;22527;2923;19604
1500909;Augusto Corrêa;1970;18331;3099;15232
1501006;Aveiro;1970;8819;1108;7711
1501105;Bagre;1970;4405;708;3697
1501204;Baião;1970;12134;2791;9343
1501303;Barcarena;1970;17498;2399;15099
1501402;Belém;1970;633374;602829;30545
1501501;Benevides;1970;13867;3509;10358
1501600;Bonito;1970;6084;578;5506
1501709;Bragança;1970;61934;20098;41836
1501808;Breves;1970;38201;4950;33251
1501907;Bujaru;1970;15735;1828;13907
1502004;Cachoeira do Arari;1970;10386;4281;6105
1502103;Cametá;1970;59754;10981;48773
1502202;Capanema;1970;26650;16670;9980
1502301;Capitão Poço;1970;25565;5408;20157
1502400;Castanhal;1970;37910;25667;12243
1502509;Chaves;1970;20764;441;20323
1502608;Colares;1970;6339;1314;5025
1502707;Conceição do Araguaia;1970;28953;6637;22316
1502806;Curralinho;1970;10572;1214;9358
1502905;Curuçá;1970;22537;8423;14114
1503002;Faro;1970;10054;4358;5696
1503101;Gurupá;1970;13971;1291;12680
1503200;Igarapé-Açu;1970;15966;5432;10534
1503309;Igarapé-Miri;1970;31228;7258;23970
1503408;Inhangapi;1970;6610;411;6199
1503507;Irituia;1970;33393;1387;32006
1503606;Itaituba;1970;12690;3776;8914
1503705;Itupiranga;1970;5346;1447;3899
1503804;Jacundá;1970;2219;542;1677
1503903;Juruti;1970;18684;3072;15612
1504000;Limoeiro do Ajuru;1970;10074;891;9183
1504109;Magalhães Barata;1970;5058;2115;2943
1504208;Marabá;1970;24474;14569;9905
1504307;Maracanã;1970;18089;6744;11345
1504406;Marapanim;1970;16922;6127;10795
1504505;Melgaço;1970;6103;346;5757
1504604;Mocajuba;1970;9087;2434;6653
1504703;Moju;1970;18035;927;17108
1504802;Monte Alegre;1970;28379;6007;22372
1504901;Muaná;1970;14985;1140;13845
1505007;Nova Timboteua;1970;8235;2700;5535
1505106;Óbidos;1970;26426;8993;17433
1505205;Oeiras do Pará;1970;10768;1449;9319
1505304;Oriximiná;1970;18994;6719;12275
1505403;Ourém;1970;27644;2596;25048
1505502;Paragominas;1970;14697;1683;13014
1505601;Peixe-Boi;1970;6136;1609;4527
1505700;Ponta de Pedras;1970;10998;2003;8995
1505809;Portel;1970;16411;5723;10688
1505908;Porto de Moz;1970;7523;1347;6176
1506005;Prainha;1970;12304;1714;10590
1506104;Primavera;1970;21512;6932;14580
1506203;Salinópolis;1970;9651;6608;3043
1506302;Salvaterra;1970;9127;4650;4477
1506401;Santa Cruz do Arari;1970;5258;907;4351
1506500;Santa Izabel do Pará;1970;15848;5094;10754
1506609;Santa Maria do Pará;1970;9927;3088;6839
1506708;Santana do Araguaia;1970;9085;1661;7424
1506807;Santarém;1970;135215;61324;73891
1506906;Santarém Novo;1970;3991;804;3187
1507003;Santo Antônio do Tauá;1970;10919;2884;8035
1507102;São Caetano de Odivelas;1970;14229;4933;9296
1507201;São Domingos do Capim;1970;29786;691;29095
1507300;São Félix do Xingu;1970;2332;897;1435
1507409;São Francisco do Pará;1970;6827;1458;5369
1507508;São João do Araguaia;1970;15322;1712;13610
1507607;São Miguel do Guamá;1970;17452;3904;13548
1507706;São Sebastião da Boa Vista;1970;11409;1871;9538
1507805;Senador José Porfírio;1970;2971;378;2593
1507904;Soure;1970;13787;9509;4278
1508001;Tomé-Açu;1970;24132;2236;21896
1508100;Tucuruí;1970;9921;5628;4293
1508209;Vigia;1970;19261;11681;7580
1508308;Viseu;1970;33014;4800;28214
1600105;Amapá;1970;10377;2508;7869
1600204;Calçoene;1970;2834;1285;1549
1600303;Macapá;1970;86097;54903;31194
1600402;Mazagão;1970;10497;1675;8822
1600501;Oiapoque;1970;4425;2029;2396
1700400;Almas;1970;5912;441;5471
1700707;Alvorada;1970;4239;972;3267
1701002;Ananás;1970;7983;1825;6158
1701903;Araguacema;1970;10421;2436;7985
1702000;Araguaçu;1970;10416;903;9513
1702109;Araguaína;1970;37780;17372;20408
1702208;Araguatins;1970;12542;3907;8635
1702307;Arapoema;1970;7295;1268;6027
1702406;Arraias;1970;11476;2225;9251
1702703;Aurora do Tocantins;1970;3501;588;2913
1702901;Axixá do Tocantins;1970;7595;2172;5423
1703008;Babaçulândia;1970;14661;1182;13479
1703701;Brejinho de Nazaré;1970;6179;749;5430
1705508;Colinas do Tocantins;1970;8444;4560;3884
1705607;Conceição do Tocantins;1970;2811;583;2228
1706001;Couto Magalhães;1970;2434;555;1879
1706100;Cristalândia;1970;10694;3719;6975
1707009;Dianópolis;1970;9252;3046;6206
1707207;Dois Irmãos do Tocantins;1970;5407;937;4470
1707306;Dueré;1970;4722;781;3941
1707702;Filadélfia;1970;14884;2455;12429
1708205;Formoso do Araguaia;1970;7856;850;7006
1709005;Goiatins;1970;14676;1225;13451
1709302;Guaraí;1970;11078;2971;8107
1709500;Gurupi;1970;24660;15682;8978
1710508;Itacajá;1970;12168;1561;10607
1710706;Itaguatins;1970;11097;937;10160
1711100;Itaporã do Tocantins;1970;2302;668;1634
1712405;Lizarda;1970;8400;326;8074
1713205;Miracema do Tocantins;1970;20285;4051;16234
1713304;Miranorte;1970;5041;1796;3245
1713601;Monte do Carmo;1970;4158;448;3710
1714203;Natividade;1970;11330;1780;9550
1714302;Nazaré;1970;8217;1320;6897
1715101;Novo Acordo;1970;5571;820;4751
1716109;Paraíso do Tocantins;1970;9310;6032;3278
1716208;Paranã;1970;13357;1032;12325
1716505;Pedro Afonso;1970;10455;3637;6818
1716604;Peixe;1970;14496;1624;12872
1716703;Colméia;1970;6246;1632;4614
1717008;Pindorama do Tocantins;1970;2972;715;2257
1717503;Pium;1970;6679;1057;5622
1717800;Ponte Alta do Bom Jesus;1970;5154;697;4457
1717909;Ponte Alta do Tocantins;1970;7325;1073;6252
1718204;Porto Nacional;1970;31517;10025;21492
1718402;Presidente Kennedy;1970;4764;845;3919
1720309;São Sebastião do Tocantins;1970;9454;957;8497
1720804;Sítio Novo do Tocantins;1970;7133;1497;5636
1720903;Taguatinga;1970;8178;1406;6772
1721109;Tocantínia;1970;6500;1450;5050
1721208;Tocantinópolis;1970;23659;5328;18331
1722107;Xambioá;1970;8453;3469;4984
2100105;Afonso Cunha;1970;3045;382;2663
2100204;Alcântara;1970;16627;2005;14622
2100303;Aldeias Altas;1970;16845;216;16629
2100402;Altamira do Maranhão;1970;21345;1826;19519
2100501;Alto Parnaíba;1970;7209;1318;5891
2100600;Amarante do Maranhão;1970;13831;1932;11899
2100709;Anajatuba;1970;16350;2289;14061
2100808;Anapurus;1970;6719;655;6064
2100907;Araioses;1970;39561;4859;34702
2101004;Arari;1970;17792;5889;11903
2101103;Axixá;1970;7644;751;6893
2101202;Bacabal;1970;69578;29671;39907
2101301;Bacuri;1970;17054;1293;15761
2101400;Balsas;1970;19385;7108;12277
2101509;Barão de Grajaú;1970;11452;2723;8729
2101608;Barra do Corda;1970;57839;10895;46944
2101707;Barreirinhas;1970;24969;3399;21570
2101806;Benedito Leite;1970;7374;408;6966
2101905;Bequimão;1970;18736;1371;17365
2102002;Bom Jardim;1970;24991;3457;21534
2102101;Brejo;1970;22049;4356;17693
2102200;Buriti;1970;19231;1851;17380
2102309;Buriti Bravo;1970;13587;3313;10274
2102408;Cajapió;1970;11050;1411;9639
2102507;Cajari;1970;13448;1478;11970
2102606;Cândido Mendes;1970;10165;2925;7240
2102705;Cantanhede;1970;15412;1854;13558
2102804;Carolina;1970;28815;10869;17946
2102903;Carutapera;1970;10356;2891;7465
2103000;Caxias;1970;88334;30735;57599
2103109;Cedral;1970;11400;518;10882
2103208;Chapadinha;1970;44997;10264;34733
2103307;Codó;1970;93003;19990;73013
2103406;Coelho Neto;1970;16660;2759;13901
2103505;Colinas;1970;22824;4480;18344
2103604;Coroatá;1970;65797;13390;52407
2103703;Cururupu;1970;33880;8318;25562
2103802;Dom Pedro;1970;16315;6165;10150
2103901;Duque Bacelar;1970;15413;1815;13598
2104008;Esperantinópolis;1970;23210;2268;20942
2104107;Fortaleza dos Nogueiras;1970;7245;702;6543
2104206;Fortuna;1970;8432;3287;5145
2104305;Godofredo Viana;1970;7562;1159;6403
2104404;Gonçalves Dias;1970;15881;2287;13594
2104503;Governador Archer;1970;10722;1993;8729
2104602;Governador Eugênio Barros;1970;20290;1079;19211
2104701;Graça Aranha;1970;6012;2021;3991
2104800;Grajaú;1970;33130;3987;29143
2104909;Guimarães;1970;9670;2027;7643
2105005;Humberto de Campos;1970;16242;2220;14022
2105104;Icatu;1970;15228;1632;13596
2105203;Igarapé Grande;1970;15904;2473;13431
2105302;Imperatriz;1970;80827;34698;46129
2105401;Itapecuru Mirim;1970;31589;6343;25246
2105500;João Lisboa;1970;26997;2466;24531
2105609;Joselândia;1970;15541;2232;13309
2105708;Lago da Pedra;1970;43525;5060;38465
2105807;Lago do Junco;1970;17766;1424;16342
2105906;Lago Verde;1970;10657;871;9786
2106003;Lima Campos;1970;10639;2532;8107
2106102;Loreto;1970;7643;899;6744
2106201;Luís Domingues;1970;5893;2540;3353
2106300;Magalhães de Almeida;1970;10232;2993;7239
2106409;Mata Roma;1970;8068;733;7335
2106508;Matinha;1970;18536;1886;16650
2106607;Matões;1970;19200;1039;18161
2106706;Mirador;1970;13378;1385;11993
2106805;Mirinzal;1970;12377;732;11645
2106904;Monção;1970;50090;1937;48153
2107001;Montes Altos;1970;11824;1309;10515
2107100;Morros;1970;15729;2165;13564
2107209;Nina Rodrigues;1970;6336;868;5468
2107308;Nova Iorque;1970;4638;1339;3299
2107407;Olho d'Água das Cunhãs;1970;22315;4016;18299
2107506;Paço do Lumiar;1970;13487;521;12966
2107605;Palmeirândia;1970;10620;752;9868
2107704;Paraibano;1970;10079;3026;7053
2107803;Parnarama;1970;24109;2242;21867
2107902;Passagem Franca;1970;19419;1772;17647
2108009;Pastos Bons;1970;12712;2223;10489
2108108;Paulo Ramos;1970;21548;2728;18820
2108207;Pedreiras;1970;33054;19595;13459
2108306;Penalva;1970;22644;4154;18490
2108405;Peri Mirim;1970;10821;1761;9060
2108504;Pindaré-Mirim;1970;23585;7917;15668
2108603;Pinheiro;1970;53831;11941;41890
2108702;Pio XII;1970;26324;1469;24855
2108801;Pirapemas;1970;12359;2460;9899
2108900;Poção de Pedras;1970;30215;3714;26501
2109007;Porto Franco;1970;16058;2501;13557
2109106;Presidente Dutra;1970;30756;4969;25787
2109205;Presidente Juscelino;1970;6094;791;5303
2109304;Presidente Vargas;1970;6264;687;5577
2109403;Primeira Cruz;1970;15507;4349;11158
2109502;Riachão;1970;17831;2352;15479
2109601;Rosário;1970;22041;8553;13488
2109700;Sambaíba;1970;5110;660;4450
2109809;Santa Helena;1970;16428;2240;14188
2109908;Santa Inês;1970;27598;14890;12708
2110005;Santa Luzia;1970;47714;5904;41810
2110104;Santa Quitéria do Maranhão;1970;14896;1403;13493
2110203;Santa Rita;1970;12286;1755;10531
2110302;Santo Antônio dos Lopes;1970;19664;2193;17471
2110401;São Benedito do Rio Preto;1970;12211;2076;10135
2110500;São Bento;1970;18743;7471;11272
2110609;São Bernardo;1970;19795;1342;18453
2110708;São Domingos do Maranhão;1970;20440;5528;14912
2110807;São Félix de Balsas;1970;4850;359;4491
2110906;São Francisco do Maranhão;1970;12237;1140;11097
2111003;São João Batista;1970;21240;2243;18997
2111102;São João dos Patos;1970;17457;6252;11205
2111201;São José de Ribamar;1970;23636;14071;9565
2111300;São Luís;1970;265486;205512;59974
2111409;São Luís Gonzaga do Maranhão;1970;29844;2091;27753
2111508;São Mateus do Maranhão;1970;17284;5169;12115
2111607;São Raimundo das Mangabeiras;1970;11336;3366;7970
2111706;São Vicente Ferrer;1970;15933;1054;14879
2111805;Sítio Novo;1970;6500;1023;5477
2111904;Sucupira do Norte;1970;9298;980;8318
2112001;Tasso Fragoso;1970;5008;347;4661
2112100;Timbiras;1970;18648;1886;16762
2112209;Timon;1970;36893;16205;20688
2112308;Tuntum;1970;30269;5415;24854
2112407;Turiaçu;1970;23867;2613;21254
2112506;Tutóia;1970;32832;7059;25773
2112605;Urbano Santos;1970;16383;1604;14779
2112704;Vargem Grande;1970;27431;4679;22752
2112803;Viana;1970;36633;5850;30783
2112902;Vitória do Mearim;1970;34168;2905;31263
2113009;Vitorino Freire;1970;36792;7273;29519
2200103;Agricolândia;1970;3105;1302;1803
2200202;Água Branca;1970;10085;5573;4512
2200301;Alto Longá;1970;16176;1359;14817
2200400;Altos;1970;30334;9670;20664
2200509;Amarante;1970;12796;4413;8383
2200608;Angical do Piauí;1970;4498;1778;2720
2200707;Anísio de Abreu;1970;5911;390;5521
2200806;Antônio Almeida;1970;3725;163;3562
2200905;Aroazes;1970;9913;573;9340
2201002;Arraial;1970;3340;347;2993
2201101;Avelino Lopes;1970;7676;810;6866
2201200;Barras;1970;38175;5770;32405
2201309;Barreiras do Piauí;1970;2273;396;1877
2201408;Barro Duro;1970;6035;1865;4170
2201507;Batalha;1970;19020;2132;16888
2201606;Beneditinos;1970;11606;1426;10180
2201705;Bertolínia;1970;6447;1152;5295
2201804;Bocaina;1970;3962;913;3049
2201903;Bom Jesus;1970;9977;2299;7678
2202000;Buriti dos Lopes;1970;25145;2682;22463
2202109;Campinas do Piauí;1970;6416;419;5997
2202208;Campo Maior;1970;61549;18490;43059
2202307;Canto do Buriti;1970;19863;3194;16669
2202406;Capitão de Campos;1970;7342;1725;5617
2202505;Caracol;1970;7829;1870;5959
2202604;Castelo do Piauí;1970;25077;4638;20439
2202703;Cocal;1970;18897;2671;16226
2202802;Conceição do Canindé;1970;5058;705;4353
2202901;Corrente;1970;14397;3397;11000
2203008;Cristalândia do Piauí;1970;3300;517;2783
2203107;Cristino Castro;1970;6023;1220;4803
2203206;Curimatá;1970;8184;999;7185
2203305;Demerval Lobão;1970;8421;2898;5523
2203404;Dom Expedito Lopes;1970;3518;1105;2413
2203420;Domingos Mourão;1970;3567;388;3179
2203503;Elesbão Veloso;1970;14340;3402;10938
2203602;Eliseu Martins;1970;5309;676;4633
2203701;Esperantina;1970;24582;7572;17010
2203800;Flores do Piauí;1970;3526;1085;2441
2203909;Floriano;1970;35850;26737;9113
2204006;Francinópolis;1970;4023;1177;2846
2204105;Francisco Ayres;1970;3937;403;3534
2204204;Francisco Santos;1970;3877;2284;1593
2204303;Fronteiras;1970;12612;2321;10291
2204402;Gilbués;1970;8071;572;7499
2204501;Guadalupe;1970;9284;7308;1976
2204600;Hugo Napoleão;1970;2027;871;1156
2204709;Inhuma;1970;9685;2756;6929
2204808;Ipiranga do Piauí;1970;5393;1778;3615
2204907;Isaías Coelho;1970;4873;368;4505
2205003;Itainópolis;1970;10168;1345;8823
2205102;Itaueira;1970;9252;1635;7617
2205201;Jaicós;1970;20360;1769;18591
2205300;Jerumenha;1970;6987;1468;5519
2205409;Joaquim Pires;1970;11433;886;10547
2205508;José de Freitas;1970;21669;5391;16278
2205607;Landri Sales;1970;4047;998;3049
2205706;Luís Correia;1970;20521;2148;18373
2205805;Luzilândia;1970;25525;4255;21270
2205904;Manoel Emídio;1970;4413;855;3558
2206001;Marcos Parente;1970;2428;687;1741
2206100;Matias Olímpio;1970;9261;1710;7551
2206209;Miguel Alves;1970;24597;2211;22386
2206308;Miguel Leão;1970;1418;239;1179
2206407;Monsenhor Gil;1970;9090;784;8306
2206506;Monsenhor Hipólito;1970;4243;1122;3121
2206605;Monte Alegre do Piauí;1970;7751;1354;6397
2206704;Nazaré do Piauí;1970;6268;1589;4679
2206803;Nossa Senhora dos Remédios;1970;5171;888;4283
2206902;Novo Oriente do Piauí;1970;6364;1286;5078
2207009;Oeiras;1970;41576;9650;31926
2207207;Padre Marcos;1970;11191;733;10458
2207306;Paes Landim;1970;3786;559;3227
2207405;Palmeira do Piauí;1970;3682;424;3258
2207504;Palmeirais;1970;10477;957;9520
2207603;Parnaguá;1970;7966;1032;6934
2207702;Parnaíba;1970;79216;57030;22186
2207801;Paulistana;1970;26034;2128;23906
2207900;Pedro II;1970;31041;4386;26655
2208007;Picos;1970;52757;18263;34494
2208106;Pimenteiras;1970;9082;1583;7499
2208205;Pio IX;1970;17765;1488;16277
2208304;Piracuruca;1970;25143;6373;18770
2208403;Piripiri;1970;43227;18550;24677
2208502;Porto;1970;10349;1666;8683
2208601;Prata do Piauí;1970;1528;436;1092
2208700;Redenção do Gurguéia;1970;3738;727;3011
2208809;Regeneração;1970;13552;2732;10820
2208908;Ribeiro Gonçalves;1970;8296;1084;7212
2209005;Rio Grande do Piauí;1970;7673;890;6783
2209104;Santa Cruz do Piauí;1970;8177;1624;6553
2209203;Santa Filomena;1970;4614;733;3881
2209302;Santa Luz;1970;3909;723;3186
2209401;Santo Antônio de Lisboa;1970;3022;1553;1469
2209500;Santo Inácio do Piauí;1970;4562;451;4111
2209609;São Félix do Piauí;1970;5970;910;5060
2209708;São Francisco do Piauí;1970;6116;597;5519
2209807;São Gonçalo do Piauí;1970;3204;1157;2047
2209906;São João da Serra;1970;6689;679;6010
2210003;São João do Piauí;1970;27823;4061;23762
2210102;São José do Peixe;1970;4516;591;3925
2210201;São José do Piauí;1970;5011;1002;4009
2210300;São Julião;1970;6307;635;5672
2210409;São Miguel do Tapuio;1970;20648;1423;19225
2210508;São Pedro do Piauí;1970;10088;2864;7224
2210607;São Raimundo Nonato;1970;47092;5537;41555
2210706;Simões;1970;14524;1176;13348
2210805;Simplício Mendes;1970;9564;2937;6627
2210904;Socorro do Piauí;1970;3433;438;2995
2211001;Teresina;1970;220487;181021;39466
2211100;União;1970;37463;6323;31140
2211209;Uruçuí;1970;10853;2829;8024
2211308;Valença do Piauí;1970;14702;5361;9341
2211407;Várzea Grande;1970;5725;1015;4710
2300101;Abaiara;1970;6838;524;6314
2300200;Acaraú;1970;62857;9181;53676
2300309;Acopiara;1970;48292;8311;39981
2300408;Aiuaba;1970;14462;1646;12816
2300507;Alcântaras;1970;9554;1236;8318
2300606;Altaneira;1970;3405;1117;2288
2300705;Alto Santo;1970;11904;1767;10137
2300804;Antonina do Norte;1970;5289;2077;3212
2300903;Apuiarés;1970;9749;1787;7962
2301000;Aquiraz;1970;32507;3561;28946
2301109;Aracati;1970;50120;17606;32514
2301208;Aracoiaba;1970;33902;4918;28984
2301307;Araripe;1970;13814;3900;9914
2301406;Aratuba;1970;10558;892;9666
2301505;Arneiroz;1970;6768;841;5927
2301604;Assaré;1970;29117;3963;25154
2301703;Aurora;1970;24599;6027;18572
2301802;Baixio;1970;4997;1311;3686
2301901;Barbalha;1970;25370;9626;15744
2302008;Barro;1970;17497;3182;14315
2302107;Baturité;1970;22220;8726;13494
2302206;Beberibe;1970;29373;4651;24722
2302305;Bela Cruz;1970;18319;5420;12899
2302404;Boa Viagem;1970;41825;5830;35995
2302503;Brejo Santo;1970;21752;7045;14707
2302602;Camocim;1970;35736;16442;19294
2302701;Campos Sales;1970;31694;9069;22625
2302800;Canindé;1970;50652;12047;38605
2302909;Capistrano;1970;12568;1743;10825
2303006;Caridade;1970;10301;1939;8362
2303105;Cariré;1970;18410;1835;16575
2303204;Caririaçu;1970;23766;4102;19664
2303303;Cariús;1970;18576;2791;15785
2303402;Carnaubal;1970;9655;3069;6586
2303501;Cascavel;1970;39028;10329;28699
2303600;Catarina;1970;9122;1087;8035
2303709;Caucaia;1970;54754;11200;43554
2303808;Cedro;1970;22758;8654;14104
2303907;Chaval;1970;6876;4058;2818
2304004;Coreaú;1970;14760;4053;10707
2304103;Crateús;1970;62011;27345;34666
2304202;Crato;1970;70996;41812;29184
2304301;Farias Brito;1970;17277;3628;13649
2304400;Fortaleza;1970;857980;827682;30298
2304509;Frecheirinha;1970;8200;1881;6319
2304608;General Sampaio;1970;4163;1608;2555
2304707;Granja;1970;36053;10826;25227
2304806;Granjeiro;1970;5771;808;4963
2304905;Groaíras;1970;6290;1584;4706
2305001;Guaraciaba do Norte;1970;32140;5068;27072
2305100;Guaramiranga;1970;6412;682;5730
2305209;Hidrolândia;1970;17458;3031;14427
2305308;Ibiapina;1970;14863;2065;12798
2305407;Icó;1970;41569;10453;31116
2305506;Iguatu;1970;75682;31796;43886
2305605;Independência;1970;39075;6997;32078
2305704;Ipaumirim;1970;10627;3337;7290
2305803;Ipu;1970;42412;11315;31097
2305902;Ipueiras;1970;30332;6752;23580
2306009;Iracema;1970;20310;3479;16831
2306108;Irauçuba;1970;15557;2779;12778
2306207;Itaiçaba;1970;4822;2005;2817
2306306;Itapajé;1970;33778;9934;23844
2306405;Itapipoca;1970;94846;16688;78158
2306504;Itapiúna;1970;13824;3051;10773
2306603;Itatira;1970;15990;1021;14969
2306702;Jaguaretama;1970;16838;1563;15275
2306801;Jaguaribara;1970;8714;1404;7310
2306900;Jaguaribe;1970;26161;8743;17418
2307007;Jaguaruana;1970;22437;6151;16286
2307106;Jardim;1970;19472;3258;16214
2307205;Jati;1970;5633;1443;4190
2307304;Juazeiro do Norte;1970;96047;80549;15498
2307403;Jucás;1970;21012;3894;17118
2307502;Lavras da Mangabeira;1970;30838;9787;21051
2307601;Limoeiro do Norte;1970;25623;6364;19259
2307700;Maranguape;1970;59622;24098;35524
2307809;Marco;1970;12631;4094;8537
2307908;Martinópole;1970;5596;2927;2669
2308005;Massapê;1970;21715;7955;13760
2308104;Mauriti;1970;31508;5843;25665
2308203;Meruoca;1970;10864;1707;9157
2308302;Milagres;1970;18910;5419;13491
2308401;Missão Velha;1970;30087;7790;22297
2308500;Mombaça;1970;40789;7362;33427
2308609;Monsenhor Tabosa;1970;13931;2959;10972
2308708;Morada Nova;1970;53552;9568;43984
2308807;Moraújo;1970;6184;1455;4729
2308906;Morrinhos;1970;12008;2766;9242
2309003;Mucambo;1970;10887;3063;7824
2309102;Mulungu;1970;8382;1338;7044
2309201;Nova Olinda;1970;9862;2515;7347
2309300;Nova Russas;1970;41052;11003;30049
2309409;Novo Oriente;1970;17361;1592;15769
2309508;Orós;1970;17515;8866;8649
2309607;Pacajus;1970;33335;8703;24632
2309706;Pacatuba;1970;31916;9087;22829
2309805;Pacoti;1970;11273;1857;9416
2309904;Pacujá;1970;3772;966;2806
2310001;Palhano;1970;5106;920;4186
2310100;Palmácia;1970;11295;2530;8765
2310209;Paracuru;1970;24522;6468;18054
2310308;Parambu;1970;21925;4045;17880
2310407;Paramoti;1970;10628;1048;9580
2310506;Pedra Branca;1970;31558;6629;24929
2310605;Penaforte;1970;4798;814;3984
2310704;Pentecoste;1970;34620;10654;23966
2310803;Pereiro;1970;20609;3865;16744
2310902;Piquet Carneiro;1970;15305;3315;11990
2311009;Poranga;1970;7369;2120;5249
2311108;Porteiras;1970;12576;1623;10953
2311207;Potengi;1970;7001;2197;4804
2311306;Quixadá;1970;98509;20287;78222
2311405;Quixeramobim;1970;66740;13090;53650
2311504;Quixeré;1970;11221;1500;9721
2311603;Redenção;1970;37669;9232;28437
2311702;Reriutaba;1970;27997;8130;19867
2311801;Russas;1970;34239;11374;22865
2311900;Saboeiro;1970;16183;2153;14030
2312007;Santana do Acaraú;1970;22537;5665;16872
2312106;Santana do Cariri;1970;15975;3490;12485
2312205;Santa Quitéria;1970;42778;6689;36089
2312304;São Benedito;1970;41076;6931;34145
2312403;São Gonçalo do Amarante;1970;21003;5042;15961
2312502;São João do Jaguaribe;1970;7723;1083;6640
2312601;São Luís do Curu;1970;7888;3966;3922
2312700;Senador Pompeu;1970;24693;9658;15035
2312809;Senador Sá;1970;4582;1953;2629
2312908;Sobral;1970;102197;60188;42009
2313005;Solonópole;1970;34085;4722;29363
2313104;Tabuleiro do Norte;1970;19421;5507;13914
2313203;Tamboril;1970;21065;3382;17683
2313302;Tauá;1970;44855;11264;33591
2313401;Tianguá;1970;26200;7943;18257
2313500;Trairi;1970;26423;2144;24279
2313609;Ubajara;1970;17700;3593;14107
2313708;Umari;1970;7471;1028;6443
2313807;Uruburetama;1970;30033;8700;21333
2313906;Uruoca;1970;10874;3155;7719
2314003;Várzea Alegre;1970;27423;6218;21205
2314102;Viçosa do Ceará;1970;33859;5268;28591
2399903;Cococi;1970;4163;206;3957
2400109;Acari;1970;10898;5267;5631
2400208;Açu;1970;25038;13205;11833
2400307;Afonso Bezerra;1970;8977;3582;5395
2400406;Água Nova;1970;1574;390;1184
2400505;Alexandria;1970;13252;4144;9108
2400604;Almino Afonso;1970;6021;1765;4256
2400703;Alto do Rodrigues;1970;4804;1456;3348
2400802;Angicos;1970;13987;6318;7669
2400901;Antônio Martins;1970;8038;1385;6653
2401008;Apodi;1970;21056;4978;16078
2401107;Areia Branca;1970;15600;10778;4822
2401206;Arês;1970;7962;2613;5349
2401305;Augusto Severo;1970;11189;2081;9108
2401404;Baía Formosa;1970;3814;2373;1441
2401503;Barcelona;1970;4664;1104;3560
2401602;Bento Fernandes;1970;4353;904;3449
2401701;Bom Jesus;1970;3270;1697;1573
2401800;Brejinho;1970;5389;1452;3937
2401909;Caiçara do Rio do Vento;1970;2393;256;2137
2402006;Caicó;1970;36521;24427;12094
2402105;Campo Redondo;1970;9243;2090;7153
2402204;Canguaretama;1970;15579;6554;9025
2402303;Caraúbas;1970;15545;4554;10991
2402402;Carnaúba dos Dantas;1970;4515;1916;2599
2402501;Carnaubais;1970;12021;2361;9660
2402600;Ceará-Mirim;1970;37930;12889;25041
2402709;Cerro Corá;1970;8459;2057;6402
2402808;Coronel Ezequiel;1970;6453;826;5627
2402907;Coronel João Pessoa;1970;3766;490;3276
2403004;Cruzeta;1970;6483;2999;3484
2403103;Currais Novos;1970;26179;15863;10316
2403202;Doutor Severiano;1970;4878;561;4317
2403251;Parnamirim;1970;14502;9922;4580
2403301;Encanto;1970;3433;692;2741
2403400;Equador;1970;4611;1215;3396
2403509;Espírito Santo;1970;6143;1351;4792
2403608;Extremoz;1970;8991;741;8250
2403707;Felipe Guerra;1970;3762;685;3077
2403806;Florânia;1970;10229;2290;7939
2403905;Francisco Dantas;1970;3158;218;2940
2404002;Frutuoso Gomes;1970;4052;1258;2794
2404101;Galinhos;1970;1838;806;1032
2404200;Goianinha;1970;9835;3409;6426
2404309;Governador Dix-Sept Rosado;1970;8768;1858;6910
2404408;Grossos;1970;7856;4055;3801
2404507;Guamaré;1970;2822;882;1940
2404606;Ielmo Marinho;1970;9582;593;8989
2404705;Ipanguaçu;1970;12210;1067;11143
2404804;Ipueira;1970;1481;402;1079
2404903;Itaú;1970;3608;1275;2333
2405009;Jaçanã;1970;3622;633;2989
2405108;Jandaíra;1970;3144;1074;2070
2405207;Janduís;1970;6680;1440;5240
2405306;Januário Cicco;1970;5243;1188;4055
2405405;Japi;1970;4034;1137;2897
2405504;Jardim de Angicos;1970;2829;222;2607
2405603;Jardim de Piranhas;1970;7910;2420;5490
2405702;Jardim do Seridó;1970;8906;4215;4691
2405801;João Câmara;1970;18310;8284;10026
2405900;João Dias;1970;2785;310;2475
2406007;José da Penha;1970;5148;1464;3684
2406106;Jucurutu;1970;12235;2290;9945
2406205;Lagoa d'Anta;1970;4132;935;3197
2406304;Lagoa de Pedras;1970;4590;725;3865
2406403;Lagoa de Velhos;1970;1629;425;1204
2406502;Lagoa Nova;1970;6014;2008;4006
2406601;Lagoa Salgada;1970;5314;1205;4109
2406700;Lajes;1970;9323;5261;4062
2406809;Lajes Pintadas;1970;4088;684;3404
2406908;Lucrécia;1970;1990;776;1214
2407005;Luís Gomes;1970;8920;2556;6364
2407104;Macaíba;1970;29126;9929;19197
2407203;Macau;1970;25800;18838;6962
2407302;Marcelino Vieira;1970;7267;1520;5747
2407401;Martins;1970;11907;3368;8539
2407500;Maxaranguape;1970;9223;1404;7819
2407609;Messias Targino;1970;2618;775;1843
2407708;Montanhas;1970;6527;2077;4450
2407807;Monte Alegre;1970;10929;1805;9124
2407906;Monte das Gameleiras;1970;1831;468;1363
2408003;Mossoró;1970;97245;79302;17943
2408102;Natal;1970;264379;257466;6913
2408201;Nísia Floresta;1970;9412;2037;7375
2408300;Nova Cruz;1970;22285;8470;13815
2408409;Olho d'Água do Borges;1970;3377;826;2551
2408508;Ouro Branco;1970;4993;1465;3528
2408607;Paraná;1970;1932;120;1812
2408706;Paraú;1970;3426;1209;2217
2408805;Parazinho;1970;2527;705;1822
2408904;Parelhas;1970;12469;6425;6044
2409100;Passa e Fica;1970;4428;1015;3413
2409209;Passagem;1970;3017;746;2271
2409308;Patu;1970;9016;3617;5399
2409407;Pau dos Ferros;1970;12138;8522;3616
2409506;Pedra Grande;1970;3352;669;2683
2409605;Pedra Preta;1970;2629;385;2244
2409704;Pedro Avelino;1970;10334;2153;8181
2409803;Pedro Velho;1970;10054;2420;7634
2409902;Pendências;1970;8659;5062;3597
2410009;Pilões;1970;1868;709;1159
2410108;Poço Branco;1970;7084;2849;4235
2410207;Portalegre;1970;6136;1350;4786
2410306;Serra Caiada;1970;4485;1600;2885
2410405;Pureza;1970;5379;1512;3867
2410504;Rafael Fernandes;1970;2650;341;2309
2410603;Rafael Godeiro;1970;3247;648;2599
2410702;Riacho da Cruz;1970;2014;805;1209
2410801;Riacho de Santana;1970;3408;385;3023
2410900;Riachuelo;1970;6795;2175;4620
2411007;Rodolfo Fernandes;1970;3028;1064;1964
2411106;Ruy Barbosa;1970;4100;476;3624
2411205;Santa Cruz;1970;20323;9906;10417
2411403;Santana do Matos;1970;18808;4241;14567
2411429;Santana do Seridó;1970;2439;363;2076
2411502;Santo Antônio;1970;15689;3698;11991
2411601;São Bento do Norte;1970;6093;4152;1941
2411700;São Bento do Trairí;1970;3615;509;3106
2411809;São Fernando;1970;3830;564;3266
2411908;São Francisco do Oeste;1970;1651;341;1310
2412005;São Gonçalo do Amarante;1970;18826;4055;14771
2412104;São João do Sabugi;1970;4236;1852;2384
2412203;São José de Mipibu;1970;17312;6986;10326
2412302;São José do Campestre;1970;11738;6047;5691
2412401;São José do Seridó;1970;2887;749;2138
2412500;São Miguel;1970;15600;3465;12135
2412609;São Paulo do Potengi;1970;12823;3959;8864
2412708;São Pedro;1970;7817;1198;6619
2412807;São Rafael;1970;8686;2774;5912
2412906;São Tomé;1970;13111;3112;9999
2413003;São Vicente;1970;4189;1241;2948
2413102;Senador Elói de Souza;1970;3687;651;3036
2413201;Senador Georgino Avelino;1970;1725;562;1163
2413300;Serra de São Bento;1970;5402;925;4477
2413409;Serra Negra do Norte;1970;7631;1527;6104
2413508;Serrinha;1970;7761;529;7232
2413607;Severiano Melo;1970;4961;457;4504
2413706;Sítio Novo;1970;4796;977;3819
2413805;Taboleiro Grande;1970;1719;309;1410
2413904;Taipu;1970;9758;2147;7611
2414001;Tangará;1970;7427;3175;4252
2414100;Tenente Ananias;1970;7414;1898;5516
2414209;Tibau do Sul;1970;3897;607;3290
2414308;Timbaúba dos Batistas;1970;1584;630;954
2414407;Touros;1970;19442;1946;17496
2414506;Umarizal;1970;8102;2246;5856
2414605;Upanema;1970;6530;1828;4702
2414704;Várzea;1970;7120;2449;4671
2414803;Vera Cruz;1970;4857;1487;3370
2414902;Viçosa;1970;874;345;529
2415008;Vila Flor;1970;1152;690;462
2500106;Água Branca;1970;6457;1184;5273
2500205;Aguiar;1970;12444;1113;11331
2500304;Alagoa Grande;1970;31635;12729;18906
2500403;Alagoa Nova;1970;21942;4071;17871
2500502;Alagoinha;1970;9779;3177;6602
2500601;Alhandra;1970;11534;3234;8300
2500700;São João do Rio do Peixe;1970;18694;4228;14466
2500809;Araçagi;1970;18474;2158;16316
2500908;Arara;1970;7704;2617;5087
2501005;Araruna;1970;18885;3750;15135
2501104;Areia;1970;29975;7235;22740
2501203;Areial;1970;4936;1123;3813
2501302;Aroeiras;1970;25106;2572;22534
2501401;Baía da Traição;1970;3346;1464;1882
2501500;Bananeiras;1970;27469;4016;23453
2501609;Barra de Santa Rosa;1970;14409;3091;11318
2501708;Barra de São Miguel;1970;4616;693;3923
2501807;Bayeux;1970;35464;34607;857
2501906;Belém;1970;12021;5578;6443
2502003;Belém do Brejo do Cruz;1970;8609;2212;6397
2502102;Boa Ventura;1970;6686;1703;4983
2502201;Bom Jesus;1970;1244;219;1025
2502300;Bom Sucesso;1970;6596;388;6208
2502409;Bonito de Santa Fé;1970;7066;1995;5071
2502508;Boqueirão;1970;26383;4552;21831
2502607;Igaracy;1970;5450;1223;4227
2502706;Borborema;1970;5111;1807;3304
2502805;Brejo do Cruz;1970;11979;2973;9006
2502904;Brejo dos Santos;1970;5875;1942;3933
2503001;Caaporã;1970;8303;2198;6105
2503100;Cabaceiras;1970;6254;976;5278
2503209;Cabedelo;1970;15830;12827;3003
2503308;Cachoeira dos Índios;1970;6835;1070;5765
2503407;Cacimba de Areia;1970;3155;624;2531
2503506;Cacimba de Dentro;1970;14135;1976;12159
2503605;Caiçara;1970;10541;3056;7485
2503704;Cajazeiras;1970;41693;24935;16758
2503803;Caldas Brandão;1970;3462;760;2702
2503902;Camalaú;1970;4843;669;4174
2504009;Campina Grande;1970;195303;167335;27968
2504108;Carrapateira;1970;1455;598;857
2504207;Catingueira;1970;5209;1467;3742
2504306;Catolé do Rocha;1970;23500;9152;14348
2504405;Conceição;1970;18789;4471;14318
2504504;Condado;1970;7157;2567;4590
2504603;Conde;1970;4911;277;4634
2504702;Congo;1970;3879;762;3117
2504801;Coremas;1970;12696;4845;7851
2504900;Cruz do Espírito Santo;1970;13620;2609;11011
2505006;Cubati;1970;5506;1982;3524
2505105;Cuité;1970;18249;5801;12448
2505204;Cuitegi;1970;3963;2157;1806
2505303;Curral Velho;1970;2247;274;1973
2505402;Desterro;1970;10085;1036;9049
2505501;Vista Serrana;1970;2124;495;1629
2505600;Diamante;1970;5283;1333;3950
2505709;Dona Inês;1970;9035;1880;7155
2505808;Duas Estradas;1970;7239;2613;4626
2505907;Emas;1970;2644;352;2292
2506004;Esperança;1970;20971;10380;10591
2506103;Fagundes;1970;12782;2039;10743
2506202;Frei Martinho;1970;2710;497;2213
2506301;Guarabira;1970;34732;23456;11276
2506400;Gurinhém;1970;12424;2115;10309
2506509;Gurjão;1970;5260;847;4413
2506608;Ibiara;1970;6227;1695;4532
2506707;Imaculada;1970;8425;835;7590
2506806;Ingá;1970;17272;5882;11390
2506905;Itabaiana;1970;24681;14957;9724
2507002;Itaporanga;1970;17426;6714;10712
2507101;Itapororoca;1970;11751;2165;9586
2507200;Itatuba;1970;8156;1741;6415
2507309;Jacaraú;1970;17350;861;16489
2507408;Jericó;1970;6467;1325;5142
2507507;João Pessoa;1970;221546;213591;7955
2507606;Juarez Távora;1970;4581;1849;2732
2507705;Juazeirinho;1970;12446;3170;9276
2507804;Junco do Seridó;1970;4644;794;3850
2507903;Juripiranga;1970;7163;4274;2889
2508000;Juru;1970;8170;730;7440
2508109;Lagoa;1970;4923;702;4221
2508208;Lagoa de Dentro;1970;6839;855;5984
2508307;Lagoa Seca;1970;18332;2058;16274
2508406;Lastro;1970;3243;286;2957
2508505;Livramento;1970;5627;737;4890
2508604;Lucena;1970;4747;699;4048
2508703;Mãe d'Água;1970;4727;331;4396
2508802;Malta;1970;5262;3194;2068
2508901;Mamanguape;1970;37058;14254;22804
2509008;Manaíra;1970;7696;1082;6614
2509107;Mari;1970;15504;9895;5609
2509206;Massaranduba;1970;14672;877;13795
2509305;Mataraca;1970;2297;472;1825
2509404;Mogeiro;1970;11002;953;10049
2509503;Montadas;1970;3096;383;2713
2509602;Monte Horebe;1970;4003;847;3156
2509701;Monteiro;1970;25396;8678;16718
2509800;Mulungu;1970;11672;3110;8562
2509909;Natuba;1970;10760;1477;9283
2510006;Nazarezinho;1970;7344;1710;5634
2510105;Nova Floresta;1970;5501;3869;1632
2510204;Nova Olinda;1970;4793;1338;3455
2510303;Nova Palmeira;1970;2725;443;2282
2510402;Olho d'Água;1970;7868;1336;6532
2510501;Olivedos;1970;3296;342;2954
2510600;Ouro Velho;1970;2767;899;1868
2510709;Passagem;1970;3613;651;2962
2510808;Patos;1970;46414;40094;6320
2510907;Paulista;1970;9920;483;9437
2511004;Pedra Branca;1970;3516;462;3054
2511103;Pedra Lavrada;1970;5701;734;4967
2511202;Pedras de Fogo;1970;15642;4868;10774
2511301;Piancó;1970;13380;4388;8992
2511400;Picuí;1970;17386;5351;12035
2511509;Pilar;1970;12008;2949;9059
2511608;Pilões;1970;8206;1194;7012
2511707;Pilõezinhos;1970;5465;592;4873
2511806;Pirpirituba;1970;9632;3723;5909
2511905;Pitimbu;1970;6773;2045;4728
2512002;Pocinhos;1970;14332;4036;10296
2512101;Pombal;1970;36191;11790;24401
2512200;Prata;1970;4026;1007;3019
2512309;Princesa Isabel;1970;16085;3581;12504
2512408;Puxinanã;1970;10653;1462;9191
2512507;Queimadas;1970;21258;3013;18245
2512606;Quixaba;1970;1644;148;1496
2512705;Remígio;1970;14168;3687;10481
2512804;Riacho dos Cavalos;1970;8987;1231;7756
2512903;Rio Tinto;1970;26190;15674;10516
2513000;Salgadinho;1970;3012;388;2624
2513109;Salgado de São Félix;1970;11198;1814;9384
2513208;Santa Cruz;1970;7615;1127;6488
2513307;Santa Helena;1970;5579;1223;4356
2513406;Santa Luzia;1970;8587;5300;3287
2513505;Santana de Mangueira;1970;5092;373;4719
2513604;Santana dos Garrotes;1970;9181;1629;7552
2513703;Santa Rita;1970;53357;30697;22660
2513802;Santa Teresinha;1970;5262;331;4931
2513901;São Bento;1970;10975;3618;7357
2514008;São João do Cariri;1970;8055;1558;6497
2514107;São João do Tigre;1970;4083;455;3628
2514206;São José da Lagoa Tapada;1970;9104;1561;7543
2514305;São José de Caiana;1970;6007;376;5631
2514404;São José de Espinharas;1970;8852;302;8550
2514503;São José de Piranhas;1970;16729;3205;13524
2514602;São José do Bonfim;1970;3014;289;2725
2514701;São José do Sabugi;1970;3959;686;3273
2514800;São José dos Cordeiros;1970;6239;692;5547
2514909;São Mamede;1970;8241;2543;5698
2515005;São Miguel de Taipu;1970;7971;1335;6636
2515104;São Sebastião de Lagoa de Roça;1970;6652;679;5973
2515203;São Sebastião do Umbuzeiro;1970;5662;1034;4628
2515302;Sapé;1970;45345;15779;29566
2515401;São Vicente do Seridó;1970;5355;821;4534
2515500;Serra Branca;1970;10531;3003;7528
2515609;Serra da Raiz;1970;3021;1352;1669
2515708;Serra Grande;1970;2540;454;2086
2515807;Serra Redonda;1970;7379;1445;5934
2515906;Serraria;1970;11997;1815;10182
2516003;Solânea;1970;25699;6623;19076
2516102;Soledade;1970;7612;2795;4817
2516201;Sousa;1970;62049;29989;32060
2516300;Sumé;1970;15532;5254;10278
2516409;Tacima;1970;11199;1958;9241
2516508;Taperoá;1970;12531;3505;9026
2516607;Tavares;1970;10834;1617;9217
2516706;Teixeira;1970;14182;3632;10550
2516805;Triunfo;1970;8100;573;7527
2516904;Uiraúna;1970;19577;5604;13973
2517001;Umbuzeiro;1970;16272;1840;14432
2517100;Várzea;1970;2924;488;2436
2600104;Afogados da Ingazeira;1970;19623;9201;10422
2600203;Afrânio;1970;9337;1622;7715
2600302;Agrestina;1970;17068;3833;13235
2600401;Água Preta;1970;34826;9773;25053
2600500;Águas Belas;1970;25581;6482;19099
2600609;Alagoinha;1970;9383;3203;6180
2600708;Aliança;1970;35057;10567;24490
2600807;Altinho;1970;28754;4486;24268
2600906;Amaraji;1970;16001;4531;11470
2601003;Angelim;1970;9761;2082;7679
2601102;Araripina;1970;38919;10452;28467
2601201;Arcoverde;1970;40162;33304;6858
2601300;Barra de Guabiraba;1970;7792;2678;5114
2601409;Barreiros;1970;28892;17666;11226
2601508;Belém de Maria;1970;12638;4042;8596
2601607;Belém do São Francisco;1970;17785;6266;11519
2601706;Belo Jardim;1970;45361;19651;25710
2601805;Betânia;1970;10329;1182;9147
2601904;Bezerros;1970;44289;18629;25660
2602001;Bodocó;1970;22121;3192;18929
2602100;Bom Conselho;1970;43933;14178;29755
2602209;Bom Jardim;1970;35249;4824;30425
2602308;Bonito;1970;33438;10199;23239
2602407;Brejão;1970;9929;1170;8759
2602506;Brejinho;1970;7394;1330;6064
2602605;Brejo da Madre de Deus;1970;25682;3966;21716
2602704;Buenos Aires;1970;12028;1320;10708
2602803;Buíque;1970;33405;5843;27562
2602902;Cabo de Santo Agostinho;1970;75829;40387;35442
2603009;Cabrobó;1970;19522;5805;13717
2603108;Cachoeirinha;1970;13512;5031;8481
2603207;Caetés;1970;16891;1117;15774
2603306;Calçado;1970;8467;1219;7248
2603405;Calumbi;1970;4993;787;4206
2603504;Camocim de São Félix;1970;9927;4298;5629
2603603;Camutanga;1970;6437;2997;3440
2603702;Canhotinho;1970;27117;6540;20577
2603801;Capoeiras;1970;18035;1547;16488
2603900;Carnaíba;1970;21951;3266;18685
2604007;Carpina;1970;45790;29064;16726
2604106;Caruaru;1970;142653;101531;41122
2604205;Catende;1970;28198;13493;14705
2604304;Cedro;1970;4667;843;3824
2604403;Chã de Alegria;1970;8098;3460;4638
2604502;Chã Grande;1970;13949;2348;11601
2604601;Condado;1970;12256;7753;4503
2604700;Correntes;1970;20670;5940;14730
2604809;Cortês;1970;10168;3096;7072
2604908;Cumaru;1970;17449;1903;15546
2605004;Cupira;1970;14539;5251;9288
2605103;Custódia;1970;20711;4812;15899
2605202;Escada;1970;43372;21590;21782
2605301;Exu;1970;30551;5000;25551
2605400;Feira Nova;1970;15207;4310;10897
2605459;Fernando de Noronha;1970;1241;1241;0
2605509;Ferreiros;1970;9572;3036;6536
2605608;Flores;1970;20946;3738;17208
2605707;Floresta;1970;28163;5973;22190
2605806;Frei Miguelinho;1970;13952;798;13154
2605905;Gameleira;1970;14890;6666;8224
2606002;Garanhuns;1970;71623;51574;20049
2606101;Glória do Goitá;1970;28697;3638;25059
2606200;Goiana;1970;51588;29410;22178
2606309;Granito;1970;3785;529;3256
2606408;Gravatá;1970;49366;22363;27003
2606507;Iati;1970;13140;1086;12054
2606606;Ibimirim;1970;12736;2893;9843
2606705;Ibirajuba;1970;10950;852;10098
2606804;Igarassu;1970;55079;31091;23988
2606903;Iguaracy;1970;10934;2372;8562
2607000;Inajá;1970;13575;2665;10910
2607109;Ingazeira;1970;3940;882;3058
2607208;Ipojuca;1970;35851;10033;25818
2607307;Ipubi;1970;15040;4170;10870
2607406;Itacuruba;1970;3662;1385;2277
2607505;Itaíba;1970;22701;1745;20956
2607604;Ilha de Itamaracá;1970;7117;4076;3041
2607653;Itambé;1970;25083;7978;17105
2607703;Itapetim;1970;15148;3267;11881
2607802;Itaquitinga;1970;9294;3920;5374
2607901;Jaboatão dos Guararapes;1970;200975;185825;15150
2608008;Jataúba;1970;14606;1822;12784
2608107;João Alfredo;1970;24025;3273;20752
2608206;Joaquim Nabuco;1970;12391;4705;7686
2608305;Jupi;1970;17216;2140;15076
2608404;Jurema;1970;11952;2385;9567
2608503;Lagoa de Itaenga;1970;11110;2761;8349
2608602;Lagoa do Ouro;1970;13994;1695;12299
2608701;Lagoa dos Gatos;1970;19141;3420;15721
2608800;Lajedo;1970;21478;7344;14134
2608909;Limoeiro;1970;57278;31368;25910
2609006;Macaparana;1970;16668;3860;12808
2609105;Machados;1970;8018;1570;6448
2609204;Maraial;1970;20606;5780;14826
2609303;Mirandiba;1970;9693;1681;8012
2609402;Moreno;1970;31204;17680;13524
2609501;Nazaré da Mata;1970;23742;12432;11310
2609600;Olinda;1970;196342;187429;8913
2609709;Orobó;1970;19601;2522;17079
2609808;Orocó;1970;5285;1463;3822
2609907;Ouricuri;1970;50167;10457;39710
2610004;Palmares;1970;50995;31928;19067
2610103;Palmeirina;1970;10165;2057;8108
2610202;Panelas;1970;30610;3389;27221
2610301;Paranatama;1970;13554;880;12674
2610400;Parnamirim;1970;13066;2970;10096
2610509;Passira;1970;21929;2582;19347
2610608;Paudalho;1970;32741;10746;21995
2610707;Paulista;1970;70059;62464;7595
2610806;Pedra;1970;17680;5250;12430
2610905;Pesqueira;1970;49687;27817;21870
2611002;Petrolândia;1970;14499;4840;9659
2611101;Petrolina;1970;61252;38189;23063
2611200;Poção;1970;8081;1979;6102
2611309;Pombos;1970;22899;3506;19393
2611408;Primavera;1970;8627;3590;5037
2611507;Quipapá;1970;19568;4450;15118
2611606;Recife;1970;1060701;1046320;14381
2611705;Riacho das Almas;1970;16222;1829;14393
2611804;Ribeirão;1970;31009;16021;14988
2611903;Rio Formoso;1970;28655;8832;19823
2612000;Sairé;1970;17235;1068;16167
2612109;Salgadinho;1970;5460;936;4524
2612208;Salgueiro;1970;31314;19533;11781
2612307;Saloá;1970;15829;2258;13571
2612406;Sanharó;1970;13570;3939;9631
2612505;Santa Cruz do Capibaribe;1970;11685;8796;2889
2612604;Santa Maria da Boa Vista;1970;18837;2472;16365
2612703;Santa Maria do Cambucá;1970;9724;1007;8717
2612802;Santa Terezinha;1970;7848;1340;6508
2612901;São Benedito do Sul;1970;11048;2972;8076
2613008;São Bento do Una;1970;33514;7521;25993
2613107;São Caitano;1970;23933;7779;16154
2613206;São João;1970;16323;2309;14014
2613305;São Joaquim do Monte;1970;20064;3728;16336
2613404;São José da Coroa Grande;1970;8292;3144;5148
2613503;São José do Belmonte;1970;23101;3751;19350
2613602;São José do Egito;1970;23607;6604;17003
2613701;São Lourenço da Mata;1970;94016;74431;19585
2613800;São Vicente Férrer;1970;12248;2756;9492
2613909;Serra Talhada;1970;55774;22729;33045
2614006;Serrita;1970;16383;1492;14891
2614105;Sertânia;1970;31373;11316;20057
2614204;Sirinhaém;1970;24806;5594;19212
2614303;Moreilândia;1970;10329;2067;8262
2614402;Solidão;1970;5516;766;4750
2614501;Surubim;1970;52275;13442;38833
2614600;Tabira;1970;16245;5660;10585
2614709;Tacaimbó;1970;9626;2099;7527
2614808;Tacaratu;1970;12948;5268;7680
2615003;Taquaritinga do Norte;1970;14492;3563;10929
2615102;Terezinha;1970;8053;1094;6959
2615201;Terra Nova;1970;4071;1434;2637
2615300;Timbaúba;1970;52077;27188;24889
2615409;Toritama;1970;6382;4713;1669
2615508;Tracunhaém;1970;11249;1904;9345
2615607;Trindade;1970;9112;4697;4415
2615706;Triunfo;1970;24849;5670;19179
2615805;Tupanatinga;1970;16456;2192;14264
2615904;Tuparetama;1970;5747;2217;3530
2616001;Venturosa;1970;8708;2930;5778
2616100;Verdejante;1970;7395;763;6632
2616209;Vertentes;1970;13285;3254;10031
2616308;Vicência;1970;25270;3886;21384
2616407;Vitória de Santo Antão;1970;80537;41682;38855
2700102;Água Branca;1970;22620;1782;20838
2700201;Anadia;1970;12586;3006;9580
2700300;Arapiraca;1970;94287;46592;47695
2700409;Atalaia;1970;40075;5599;34476
2700508;Barra de Santo Antônio;1970;6028;2253;3775
2700607;Barra de São Miguel;1970;1418;773;645
2700706;Batalha;1970;9015;3946;5069
2700805;Belém;1970;5761;1157;4604
2700904;Belo Monte;1970;4698;834;3864
2701001;Boca da Mata;1970;15362;2203;13159
2701100;Branquinha;1970;9983;1755;8228
2701209;Cacimbinhas;1970;9305;1440;7865
2701308;Cajueiro;1970;11910;3561;8349
2701407;Campo Alegre;1970;6950;1684;5266
2701506;Campo Grande;1970;7420;1430;5990
2701605;Canapi;1970;13824;1100;12724
2701704;Capela;1970;19601;5168;14433
2701803;Carneiros;1970;5012;925;4087
2701902;Chã Preta;1970;10587;913;9674
2702009;Coité do Nóia;1970;7047;676;6371
2702108;Colônia Leopoldina;1970;12701;4791;7910
2702207;Coqueiro Seco;1970;2857;2260;597
2702306;Coruripe;1970;27225;4695;22530
2702405;Delmiro Gouveia;1970;14680;9072;5608
2702504;Dois Riachos;1970;6222;1427;4795
2702603;Feira Grande;1970;13310;1707;11603
2702702;Feliz Deserto;1970;1723;1072;651
2702801;Flexeiras;1970;12042;2208;9834
2702900;Girau do Ponciano;1970;18347;1543;16804
2703007;Ibateguara;1970;11567;2594;8973
2703106;Igaci;1970;23331;2367;20964
2703205;Igreja Nova;1970;19343;3323;16020
2703304;Inhapi;1970;9453;813;8640
2703403;Jacaré dos Homens;1970;3708;1314;2394
2703502;Jacuípe;1970;7694;1790;5904
2703601;Japaratinga;1970;2802;612;2190
2703700;Jaramataia;1970;2320;778;1542
2703809;Joaquim Gomes;1970;15430;2066;13364
2703908;Jundiá;1970;9957;597;9360
2704005;Junqueiro;1970;14998;2101;12897
2704104;Lagoa da Canoa;1970;11562;1186;10376
2704203;Limoeiro de Anadia;1970;16725;1018;15707
2704302;Maceió;1970;263670;251713;11957
2704401;Major Isidoro;1970;14230;3131;11099
2704500;Maragogi;1970;12764;2737;10027
2704609;Maravilha;1970;8222;1919;6303
2704708;Marechal Deodoro;1970;14724;5481;9243
2704807;Maribondo;1970;13961;5000;8961
2704906;Mar Vermelho;1970;4857;416;4441
2705002;Mata Grande;1970;20858;2826;18032
2705101;Matriz de Camaragibe;1970;12720;5665;7055
2705200;Messias;1970;6216;1062;5154
2705309;Minador do Negrão;1970;7365;667;6698
2705408;Monteirópolis;1970;4721;1408;3313
2705507;Murici;1970;26599;6910;19689
2705606;Novo Lino;1970;13269;2422;10847
2705705;Olho d'Água das Flores;1970;10707;4093;6614
2705804;Olho d'Água do Casado;1970;2614;1130;1484
2705903;Olho d'Água Grande;1970;4333;646;3687
2706000;Olivença;1970;8657;805;7852
2706109;Ouro Branco;1970;6171;1759;4412
2706208;Palestina;1970;2274;956;1318
2706307;Palmeira dos Índios;1970;61860;26892;34968
2706406;Pão de Açúcar;1970;16721;6254;10467
2706505;Passo de Camaragibe;1970;7598;2647;4951
2706604;Paulo Jacinto;1970;9311;3885;5426
2706703;Penedo;1970;33142;23418;9724
2706802;Piaçabuçu;1970;10752;5333;5419
2706901;Pilar;1970;17801;9261;8540
2707008;Pindoba;1970;7772;1363;6409
2707107;Piranhas;1970;4567;1200;3367
2707206;Poço das Trincheiras;1970;10172;652;9520
2707305;Porto Calvo;1970;17654;4977;12677
2707404;Porto de Pedras;1970;8565;2330;6235
2707503;Porto Real do Colégio;1970;12737;3667;9070
2707602;Quebrangulo;1970;15168;4490;10678
2707701;Rio Largo;1970;37415;21648;15767
2707800;Roteiro;1970;1635;1252;383
2707909;Santa Luzia do Norte;1970;2377;1715;662
2708006;Santana do Ipanema;1970;34225;11709;22516
2708105;Santana do Mundaú;1970;15096;2099;12997
2708204;São Brás;1970;6231;2471;3760
2708303;São José da Laje;1970;26946;6695;20251
2708402;São José da Tapera;1970;19757;1444;18313
2708501;São Luís do Quitunde;1970;16121;5230;10891
2708600;São Miguel dos Campos;1970;29721;10229;19492
2708709;São Miguel dos Milagres;1970;3995;881;3114
2708808;São Sebastião;1970;11723;764;10959
2708907;Satuba;1970;5008;2254;2754
2709004;Tanque d'Arca;1970;6056;907;5149
2709103;Taquarana;1970;11761;1038;10723
2709202;Traipu;1970;15497;2483;13014
2709301;União dos Palmares;1970;51532;16753;34779
2709400;Viçosa;1970;28734;9155;19579
2800100;Amparo de São Francisco;1970;1886;920;966
2800209;Aquidabã;1970;15910;4205;11705
2800308;Aracaju;1970;183670;179286;4384
2800407;Arauá;1970;6533;1914;4619
2800506;Areia Branca;1970;3772;988;2784
2800605;Barra dos Coqueiros;1970;5568;3604;1964
2800670;Boquim;1970;14127;4966;9161
2800704;Brejo Grande;1970;7981;3106;4875
2801009;Campo do Brito;1970;11233;2405;8828
2801108;Canhoba;1970;4734;1216;3518
2801207;Canindé de São Francisco;1970;2837;376;2461
2801306;Capela;1970;20114;6923;13191
2801405;Carira;1970;12384;2239;10145
2801504;Carmópolis;1970;4037;2396;1641
2801603;Cedro de São João;1970;5454;2905;2549
2801702;Cristinápolis;1970;5778;2078;3700
2801900;Cumbe;1970;3615;1442;2173
2802007;Divina Pastora;1970;2391;1141;1250
2802106;Estância;1970;28045;20257;7788
2802205;Feira Nova;1970;4383;929;3454
2802304;Frei Paulo;1970;8736;2627;6109
2802403;Gararu;1970;10689;1705;8984
2802502;General Maynard;1970;1870;1013;857
2802601;Gracho Cardoso;1970;5763;1244;4519
2802700;Ilha das Flores;1970;6632;3033;3599
2802809;Indiaroba;1970;6709;2234;4475
2802908;Itabaiana;1970;41640;16380;25260
2803005;Itabaianinha;1970;21686;3962;17724
2803104;Itabi;1970;5025;2078;2947
2803203;Itaporanga d'Ajuda;1970;13872;3735;10137
2803302;Japaratuba;1970;9243;3084;6159
2803401;Japoatã;1970;6978;2263;4715
2803500;Lagarto;1970;51131;12605;38526
2803609;Laranjeiras;1970;10627;4574;6053
2803708;Macambira;1970;4674;883;3791
2803807;Malhada dos Bois;1970;2632;1076;1556
2803906;Malhador;1970;6259;2019;4240
2804003;Maruim;1970;9233;6238;2995
2804102;Moita Bonita;1970;8136;570;7566
2804201;Monte Alegre de Sergipe;1970;6730;1413;5317
2804300;Muribeca;1970;5459;2188;3271
2804409;Neópolis;1970;16311;7254;9057
2804458;Nossa Senhora Aparecida;1970;8074;318;7756
2804508;Nossa Senhora da Glória;1970;13716;3116;10600
2804607;Nossa Senhora das Dores;1970;16177;5680;10497
2804706;Nossa Senhora de Lourdes;1970;3971;843;3128
2804805;Nossa Senhora do Socorro;1970;9346;1555;7791
2804904;Pacatuba;1970;9469;785;8684
2805000;Pedra Mole;1970;1311;350;961
2805109;Pedrinhas;1970;3955;1848;2107
2805208;Pinhão;1970;3368;772;2596
2805307;Pirambu;1970;2897;978;1919
2805406;Poço Redondo;1970;9298;784;8514
2805505;Poço Verde;1970;11012;1942;9070
2805604;Porto da Folha;1970;15924;4085;11839
2805703;Propriá;1970;21309;18326;2983
2805802;Riachão do Dantas;1970;16640;2057;14583
2805901;Riachuelo;1970;5939;3089;2850
2806008;Ribeirópolis;1970;10088;3179;6909
2806107;Rosário do Catete;1970;3914;1980;1934
2806206;Salgado;1970;8463;1868;6595
2806305;Santa Luzia do Itanhy;1970;6938;1120;5818
2806503;Santa Rosa de Lima;1970;3122;1510;1612
2806602;Santo Amaro das Brotas;1970;5415;2457;2958
2806701;São Cristóvão;1970;20409;10200;10209
2806800;São Domingos;1970;4930;845;4085
2806909;São Francisco;1970;1983;1386;597
2807006;São Miguel do Aleixo;1970;3245;654;2591
2807105;Simão Dias;1970;27904;6531;21373
2807204;Siriri;1970;5155;1276;3879
2807303;Telha;1970;1945;650;1295
2807402;Tobias Barreto;1970;24832;6635;18197
2807501;Tomar do Geru;1970;9701;887;8814
2807600;Umbaúba;1970;5742;2180;3562
2900108;Abaíra;1970;8475;1778;6697
2900207;Abaré;1970;6873;970;5903
2900306;Acajutiba;1970;9870;5896;3974
2900405;Água Fria;1970;11529;1503;10026
2900504;Érico Cardoso;1970;5504;876;4628
2900603;Aiquara;1970;6978;1369;5609
2900702;Alagoinhas;1970;77963;56062;21901
2900801;Alcobaça;1970;32323;4018;28305
2900900;Almadina;1970;7720;3606;4114
2901007;Amargosa;1970;24443;8417;16026
2901106;Amélia Rodrigues;1970;14981;7186;7795
2901205;Anagé;1970;21528;1597;19931
2901304;Andaraí;1970;20047;3756;16291
2901403;Angical;1970;11310;1698;9612
2901502;Anguera;1970;7299;1703;5596
2901601;Antas;1970;15978;2617;13361
2901700;Antônio Cardoso;1970;12289;600;11689
2901809;Antônio Gonçalves;1970;6838;1549;5289
2901908;Aporá;1970;12163;1512;10651
2902005;Aracatu;1970;13637;1307;12330
2902104;Araci;1970;23661;2986;20675
2902203;Aramari;1970;7543;2713;4830
2902302;Aratuípe;1970;8167;2973;5194
2902401;Aurelino Leal;1970;12300;5297;7003
2902500;Baianópolis;1970;8698;891;7807
2902609;Baixa Grande;1970;16918;2129;14789
2902708;Barra;1970;46330;10879;35451
2902807;Barra da Estiva;1970;10153;1247;8906
2902906;Barra do Choça;1970;8904;1445;7459
2903003;Barra do Mendes;1970;9531;2398;7133
2903102;Barra do Rocha;1970;8132;2126;6006
2903201;Barreiras;1970;20864;9760;11104
2903300;Barro Preto;1970;5978;1916;4062
2903409;Belmonte;1970;21070;8126;12944
2903508;Belo Campo;1970;9969;1733;8236
2903607;Biritinga;1970;10047;868;9179
2903706;Boa Nova;1970;22837;2076;20761
2903805;Boa Vista do Tupim;1970;17881;1715;16166
2903904;Bom Jesus da Lapa;1970;40776;15531;25245
2904001;Boninal;1970;9125;1313;7812
2904100;Boquira;1970;16130;4036;12094
2904209;Botuporã;1970;17274;2259;15015
2904308;Brejões;1970;9920;1871;8049
2904407;Brejolândia;1970;8127;693;7434
2904506;Brotas de Macaúbas;1970;12484;1356;11128
2904605;Brumado;1970;38304;16586;21718
2904704;Buerarema;1970;18889;7160;11729
2904803;Caatiba;1970;13292;1605;11687
2904902;Cachoeira;1970;27382;13613;13769
2905008;Caculé;1970;12608;4980;7628
2905107;Caém;1970;8900;1010;7890
2905206;Caetité;1970;40200;8699;31501
2905305;Cafarnaum;1970;16270;4954;11316
2905404;Cairu;1970;9144;5617;3527
2905503;Caldeirão Grande;1970;11234;2909;8325
2905602;Camacan;1970;22644;8502;14142
2905701;Camaçari;1970;33273;20137;13136
2905800;Camamu;1970;25502;5342;20160
2905909;Campo Alegre de Lourdes;1970;16767;1742;15025
2906006;Campo Formoso;1970;37263;5483;31780
2906105;Canápolis;1970;8198;977;7221
2906204;Canarana;1970;21278;3591;17687
2906303;Canavieiras;1970;33460;12270;21190
2906402;Candeal;1970;9718;1338;8380
2906501;Candeias;1970;34195;25771;8424
2906600;Candiba;1970;11436;1725;9711
2906709;Cândido Sales;1970;15110;5793;9317
2906808;Cansanção;1970;18790;2231;16559
2906907;Caravelas;1970;26027;6609;19418
2907004;Cardeal da Silva;1970;2961;576;2385
2907103;Carinhanha;1970;19390;3121;16269
2907202;Casa Nova;1970;37036;5481;31555
2907301;Castro Alves;1970;46716;11647;35069
2907400;Catolândia;1970;1940;365;1575
2907509;Catu;1970;27893;14330;13563
2907608;Central;1970;13864;3766;10098
2907707;Chorrochó;1970;10242;875;9367
2907806;Cícero Dantas;1970;34529;5734;28795
2907905;Cipó;1970;6402;3240;3162
2908002;Coaraci;1970;21759;13898;7861
2908101;Cocos;1970;13239;2174;11065
2908200;Conceição da Feira;1970;12417;4216;8201
2908309;Conceição do Almeida;1970;21854;6450;15404
2908408;Conceição do Coité;1970;35111;7770;27341
2908507;Conceição do Jacuípe;1970;15163;7101;8062
2908606;Conde;1970;17216;3734;13482
2908705;Condeúba;1970;22458;2182;20276
2908804;Contendas do Sincorá;1970;6535;2486;4049
2908903;Coração de Maria;1970;18933;2895;16038
2909000;Cordeiros;1970;8207;842;7365
2909109;Coribe;1970;18575;1183;17392
2909208;Coronel João Sá;1970;12742;1006;11736
2909307;Correntina;1970;30365;2942;27423
2909406;Cotegipe;1970;20085;4353;15732
2909505;Cravolândia;1970;4714;1495;3219
2909604;Crisópolis;1970;11638;1007;10631
2909703;Cristópolis;1970;7606;536;7070
2909802;Cruz das Almas;1970;28814;17298;11516
2909901;Curaçá;1970;17791;2841;14950
2910008;Dário Meira;1970;11137;2063;9074
2910107;Dom Basílio;1970;7744;529;7215
2910206;Dom Macedo Costa;1970;5140;515;4625
2910305;Elísio Medrado;1970;8628;948;7680
2910404;Encruzilhada;1970;24512;2171;22341
2910503;Entre Rios;1970;19188;4748;14440
2910602;Esplanada;1970;16671;5969;10702
2910701;Euclides da Cunha;1970;41588;6418;35170
2910800;Feira de Santana;1970;187290;131720;55570
2910909;Firmino Alves;1970;5961;2678;3283
2911006;Floresta Azul;1970;15428;5680;9748
2911105;Formosa do Rio Preto;1970;8979;1304;7675
2911204;Gandu;1970;18038;6753;11285
2911303;Gentio do Ouro;1970;9328;2555;6773
2911402;Glória;1970;8396;941;7455
2911501;Gongogi;1970;9643;4701;4942
2911600;Governador Mangabeira;1970;12941;2562;10379
2911709;Guanambi;1970;31174;11258;19916
2911808;Guaratinga;1970;33118;3720;29398
2911907;Iaçu;1970;19261;6981;12280
2912004;Ibiassucê;1970;9857;1078;8779
2912103;Ibicaraí;1970;26152;15095;11057
2912202;Ibicoara;1970;5401;318;5083
2912301;Ibicuí;1970;16297;5289;11008
2912400;Ibipeba;1970;9036;1772;7264
2912509;Ibipitanga;1970;10635;823;9812
2912608;Ibiquera;1970;6499;1396;5103
2912707;Ibirapitanga;1970;13323;2890;10433
2912806;Ibirapuã;1970;18458;4262;14196
2912905;Ibirataia;1970;14428;6070;8358
2913002;Ibitiara;1970;19179;1047;18132
2913101;Ibititá;1970;11737;1560;10177
2913200;Ibotirama;1970;10630;4584;6046
2913309;Ichu;1970;4771;791;3980
2913408;Igaporã;1970;10310;2377;7933
2913507;Iguaí;1970;23696;5723;17973
2913606;Ilhéus;1970;107971;66046;41925
2913705;Inhambupe;1970;19417;4026;15391
2913804;Ipecaetá;1970;17333;885;16448
2913903;Ipiaú;1970;27622;18232;9390
2914000;Ipirá;1970;56860;6640;50220
2914109;Ipupiara;1970;6621;2662;3959
2914208;Irajuba;1970;8323;933;7390
2914307;Iramaia;1970;9419;2754;6665
2914406;Iraquara;1970;11972;1694;10278
2914505;Irará;1970;16575;2980;13595
2914604;Irecê;1970;62313;19199;43114
2914703;Itaberaba;1970;33629;15981;17648
2914802;Itabuna;1970;112721;94827;17894
2914901;Itacaré;1970;14104;2656;11448
2915007;Itaeté;1970;16924;1823;15101
2915106;Itagi;1970;11468;3819;7649
2915205;Itagibá;1970;15970;2910;13060
2915304;Itagimirim;1970;10811;3453;7358
2915403;Itaju do Colônia;1970;9915;2342;7573
2915502;Itajuípe;1970;19828;10682;9146
2915601;Itamaraju;1970;63938;12050;51888
2915700;Itamari;1970;5325;1644;3681
2915809;Itambé;1970;27814;11277;16537
2915908;Itanagra;1970;3608;694;2914
2916005;Itanhém;1970;34745;13164;21581
2916104;Itaparica;1970;8391;5158;3233
2916203;Itapé;1970;12690;3492;9198
2916302;Itapebi;1970;13786;3487;10299
2916401;Itapetinga;1970;46112;32659;13453
2916500;Itapicuru;1970;16942;2085;14857
2916609;Itapitanga;1970;9550;3733;5817
2916708;Itaquara;1970;6882;1995;4887
2916807;Itarantim;1970;20841;5965;14876
2916906;Itiruçu;1970;8698;3283;5415
2917003;Itiúba;1970;26033;3689;22344
2917102;Itororó;1970;19347;7730;11617
2917201;Ituaçu;1970;13310;1587;11723
2917300;Ituberá;1970;15933;5956;9977
2917409;Jacaraci;1970;13809;1489;12320
2917508;Jacobina;1970;76519;25307;51212
2917607;Jaguaquara;1970;25973;8225;17748
2917706;Jaguarari;1970;17538;3261;14277
2917805;Jaguaripe;1970;10147;3370;6777
2917904;Jandaíra;1970;6714;2290;4424
2918001;Jequié;1970;100174;64628;35546
2918100;Jeremoabo;1970;28625;5676;22949
2918209;Jiquiriçá;1970;8604;1355;7249
2918308;Jitaúna;1970;13167;3712;9455
2918407;Juazeiro;1970;61648;39083;22565
2918506;Jussara;1970;8468;4022;4446
2918605;Jussiape;1970;8159;2327;5832
2918704;Lafaiete Coutinho;1970;4950;1292;3658
2918803;Laje;1970;14635;2200;12435
2918902;Lajedão;1970;7092;1734;5358
2919009;Lajedinho;1970;6628;671;5957
2919108;Lamarão;1970;6251;1093;5158
2919207;Lauro de Freitas;1970;10007;3908;6099
2919306;Lençóis;1970;5131;2580;2551
2919405;Licínio de Almeida;1970;11876;2613;9263
2919504;Livramento de Nossa Senhora;1970;25263;6366;18897
2919603;Macajuba;1970;8727;1749;6978
2919702;Macarani;1970;14381;4514;9867
2919801;Macaúbas;1970;26639;3722;22917
2919900;Macururé;1970;7192;983;6209
2920007;Maiquinique;1970;7944;2870;5074
2920106;Mairi;1970;30301;3424;26877
2920205;Malhada;1970;16522;2903;13619
2920304;Malhada de Pedras;1970;6809;784;6025
2920403;Manoel Vitorino;1970;14566;2122;12444
2920502;Maracás;1970;21831;3281;18550
2920601;Maragogipe;1970;41038;19390;21648
2920700;Maraú;1970;11875;2237;9638
2920809;Marcionílio Souza;1970;7502;1129;6373
2920908;Mascote;1970;10567;1093;9474
2921005;Mata de São João;1970;27188;13878;13310
2921104;Medeiros Neto;1970;29336;14571;14765
2921203;Miguel Calmon;1970;23009;7193;15816
2921302;Milagres;1970;8864;5005;3859
2921401;Mirangaba;1970;10678;2548;8130
2921500;Monte Santo;1970;36130;2416;33714
2921609;Morpará;1970;6468;2307;4161
2921708;Morro do Chapéu;1970;23433;5248;18185
2921807;Mortugaba;1970;8595;1474;7121
2921906;Mucugê;1970;6759;995;5764
2922003;Mucuri;1970;16766;2262;14504
2922102;Mundo Novo;1970;20708;5408;15300
2922201;Muniz Ferreira;1970;6007;1472;4535
2922300;Muritiba;1970;28133;12205;15928
2922409;Mutuípe;1970;15009;2686;12323
2922508;Nazaré;1970;21780;16213;5567
2922607;Nilo Peçanha;1970;6878;1319;5559
2922706;Nova Canaã;1970;15925;4096;11829
2922805;Nova Itarana;1970;5841;786;5055
2922904;Nova Soure;1970;18234;2688;15546
2923001;Nova Viçosa;1970;17073;3807;13266
2923100;Olindina;1970;12813;3942;8871
2923209;Oliveira dos Brejinhos;1970;16331;2100;14231
2923308;Ouriçangas;1970;6885;850;6035
2923407;Palmas de Monte Alto;1970;13574;1737;11837
2923506;Palmeiras;1970;6387;2369;4018
2923605;Paramirim;1970;20599;2875;17724
2923704;Paratinga;1970;18409;3356;15053
2923803;Paripiranga;1970;32208;4307;27901
2923902;Pau Brasil;1970;15135;5680;9455
2924009;Paulo Afonso;1970;46126;38346;7780
2924108;Pedrão;1970;7589;736;6853
2924207;Pedro Alexandre;1970;9073;716;8357
2924306;Piatã;1970;15169;1489;13680
2924405;Pilão Arcado;1970;24803;2532;22271
2924504;Pindaí;1970;12839;1182;11657
2924603;Pindobaçu;1970;26100;1801;24299
2924702;Piripá;1970;8011;793;7218
2924801;Piritiba;1970;15144;4734;10410
2924900;Planaltino;1970;8791;1719;7072
2925006;Planalto;1970;19719;4255;15464
2925105;Poções;1970;39448;11062;28386
2925204;Pojuca;1970;12070;6266;5804
2925303;Porto Seguro;1970;33108;3588;29520
2925402;Potiraguá;1970;13622;3685;9937
2925501;Prado;1970;31210;5145;26065
2925600;Presidente Dutra;1970;11286;4429;6857
2925709;Presidente Jânio Quadros;1970;15311;957;14354
2925808;Queimadas;1970;22830;4851;17979
2925907;Quijingue;1970;16001;494;15507
2926004;Remanso;1970;23588;7069;16519
2926103;Retirolândia;1970;9019;1075;7944
2926202;Riachão das Neves;1970;14693;3060;11633
2926301;Riachão do Jacuípe;1970;49864;5496;44368
2926400;Riacho de Santana;1970;29387;3400;25987
2926509;Ribeira do Amparo;1970;19276;1358;17918
2926608;Ribeira do Pombal;1970;38968;7447;31521
2926707;Rio de Contas;1970;12749;3035;9714
2926806;Rio do Antônio;1970;8838;1395;7443
2926905;Rio do Pires;1970;10801;1508;9293
2927002;Rio Real;1970;15873;4394;11479
2927101;Rodelas;1970;4002;1743;2259
2927200;Ruy Barbosa;1970;30948;11607;19341
2927309;Salinas da Margarida;1970;6366;3062;3304
2927408;Salvador;1970;1007195;1004673;2522
2927507;Santa Bárbara;1970;14789;1893;12896
2927606;Santa Brígida;1970;6599;1548;5051
2927705;Santa Cruz Cabrália;1970;27171;1761;25410
2927804;Santa Cruz da Vitória;1970;8238;4466;3772
2927903;Santa Inês;1970;5836;4200;1636
2928000;Santaluz;1970;16312;4787;11525
2928109;Santa Maria da Vitória;1970;31216;7740;23476
2928208;Santana;1970;19118;6186;12932
2928307;Santanópolis;1970;10598;602;9996
2928406;Santa Rita de Cássia;1970;20627;4216;16411
2928505;Santa Terezinha;1970;16879;1055;15824
2928604;Santo Amaro;1970;46411;30614;15797
2928703;Santo Antônio de Jesus;1970;39726;21693;18033
2928802;Santo Estêvão;1970;25410;4628;20782
2928901;São Desidério;1970;12790;2152;10638
2929008;São Félix;1970;13253;5828;7425
2929107;São Felipe;1970;19205;3681;15524
2929206;São Francisco do Conde;1970;20738;5736;15002
2929305;São Gonçalo dos Campos;1970;21858;6670;15188
2929404;São Miguel das Matas;1970;10441;1303;9138
2929503;São Sebastião do Passé;1970;24871;12024;12847
2929602;Sapeaçu;1970;12629;3688;8941
2929701;Sátiro Dias;1970;10649;976;9673
2929800;Saúde;1970;7873;2126;5747
2929909;Seabra;1970;21881;3989;17892
2930006;Sebastião Laranjeiras;1970;5859;1022;4837
2930105;Senhor do Bonfim;1970;46665;25806;20859
2930204;Sento Sé;1970;22419;6058;16361
2930303;Serra Dourada;1970;14885;1260;13625
2930402;Serra Preta;1970;19233;438;18795
2930501;Serrinha;1970;47172;16478;30694
2930600;Serrolândia;1970;19812;2373;17439
2930709;Simões Filho;1970;22019;5981;16038
2930808;Souto Soares;1970;9150;663;8487
2930907;Tabocas do Brejo Velho;1970;8017;1094;6923
2931004;Tanhaçu;1970;14132;2100;12032
2931103;Tanquinho;1970;7355;2817;4538
2931202;Taperoá;1970;8758;3889;4869
2931301;Tapiramutá;1970;6039;1731;4308
2931400;Teodoro Sampaio;1970;10272;5058;5214
2931509;Teofilândia;1970;12382;904;11478
2931608;Teolândia;1970;7997;976;7021
2931707;Terra Nova;1970;11192;6534;4658
2931806;Tremedal;1970;30369;1550;28819
2931905;Tucano;1970;31753;5487;26266
2932002;Uauá;1970;17297;2668;14629
2932101;Ubaíra;1970;16883;4022;12861
2932200;Ubaitaba;1970;11260;4903;6357
2932309;Ubatã;1970;17374;12582;4792
2932408;Uibaí;1970;11547;3605;7942
2932507;Una;1970;22344;4177;18167
2932606;Urandi;1970;12371;1670;10701
2932705;Uruçuca;1970;15123;5477;9646
2932804;Utinga;1970;9290;2182;7108
2932903;Valença;1970;48038;21321;26717
2933000;Valente;1970;16993;3559;13434
2933109;Várzea do Poço;1970;8504;2200;6304
2933208;Vera Cruz;1970;12003;5826;6177
2933307;Vitória da Conquista;1970;125573;84053;41520
2933406;Wagner;1970;4920;1932;2988
2933505;Wenceslau Guimarães;1970;15235;1228;14007
2933604;Xique-Xique;1970;30879;12873;18006
3100104;Abadia dos Dourados;1970;10077;2103;7974
3100203;Abaeté;1970;20039;11245;8794
3100302;Abre Campo;1970;20013;3889;16124
3100401;Acaiaca;1970;3324;1276;2048
3100500;Açucena;1970;28085;8562;19523
3100609;Água Boa;1970;24765;2414;22351
3100708;Água Comprida;1970;3234;765;2469
3100807;Aguanil;1970;2838;633;2205
3100906;Águas Formosas;1970;25038;7539;17499
3101003;Águas Vermelhas;1970;12276;1024;11252
3101102;Aimorés;1970;38060;17752;20308
3101201;Aiuruoca;1970;7314;1630;5684
3101300;Alagoa;1970;3153;647;2506
3101409;Albertina;1970;1953;628;1325
3101508;Além Paraíba;1970;28442;22221;6221
3101607;Alfenas;1970;28331;21067;7264
3101706;Almenara;1970;40463;18031;22432
3101805;Alpercata;1970;9715;1491;8224
3101904;Alpinópolis;1970;15930;5740;10190
3102001;Alterosa;1970;8060;3294;4766
3102100;Alto Rio Doce;1970;15411;2971;12440
3102209;Alvarenga;1970;8613;1559;7054
3102308;Alvinópolis;1970;15547;6625;8922
3102407;Alvorada de Minas;1970;4023;841;3182
3102506;Amparo do Serra;1970;7081;1264;5817
3102605;Andradas;1970;20009;7809;12200
3102704;Cachoeira de Pajeú;1970;8171;1303;6868
3102803;Andrelândia;1970;13231;5850;7381
3102902;Antônio Carlos;1970;9065;2944;6121
3103009;Antônio Dias;1970;11666;2181;9485
3103108;Antônio Prado de Minas;1970;2525;546;1979
3103207;Araçaí;1970;1828;1242;586
3103306;Aracitaba;1970;2825;975;1850
3103405;Araçuaí;1970;30280;9934;20346
3103504;Araguari;1970;63368;49809;13559
3103603;Arantina;1970;2590;1421;1169
3103702;Araponga;1970;6354;967;5387
3103801;Arapuá;1970;4502;1014;3488
3103900;Araújos;1970;4564;2514;2050
3104007;Araxá;1970;35676;31583;4093
3104106;Arceburgo;1970;6822;2891;3931
3104205;Arcos;1970;16962;9661;7301
3104304;Areado;1970;8049;3727;4322
3104403;Argirita;1970;4217;1487;2730
3104502;Arinos;1970;9295;988;8307
3104601;Astolfo Dutra;1970;11119;5708;5411
3104700;Ataléia;1970;33933;5130;28803
3104809;Augusto de Lima;1970;6118;1129;4989
3104908;Baependi;1970;15561;5894;9667
3105004;Baldim;1970;9362;3301;6061
3105103;Bambuí;1970;20637;10722;9915
3105202;Bandeira;1970;7507;1717;5790
3105301;Bandeira do Sul;1970;2723;1396;1327
3105400;Barão de Cocais;1970;11966;8668;3298
3105509;Barão de Monte Alto;1970;7357;2740;4617
3105608;Barbacena;1970;73898;59502;14396
3105707;Barra Longa;1970;11037;1684;9353
3105905;Barroso;1970;10940;9941;999
3106002;Bela Vista de Minas;1970;7584;5376;2208
3106101;Belmiro Braga;1970;5328;830;4498
3106200;Belo Horizonte;1970;1235030;1228326;6704
3106309;Belo Oriente;1970;9978;3494;6484
3106408;Belo Vale;1970;8746;2383;6363
3106507;Berilo;1970;15686;994;14692
3106606;Bertópolis;1970;13005;2055;10950
3106705;Betim;1970;37815;17526;20289
3106804;Bias Fortes;1970;5591;1320;4271
3106903;Bicas;1970;10389;8458;1931
3107000;Biquinhas;1970;5179;934;4245
3107109;Boa Esperança;1970;20518;12041;8477
3107208;Bocaina de Minas;1970;5727;1314;4413
3107307;Bocaiúva;1970;35392;11635;23757
3107406;Bom Despacho;1970;27298;20051;7247
3107505;Bom Jardim de Minas;1970;5378;2944;2434
3107604;Bom Jesus da Penha;1970;2653;679;1974
3107703;Bom Jesus do Amparo;1970;4057;1178;2879
3107802;Bom Jesus do Galho;1970;21841;5367;16474
3107901;Bom Repouso;1970;6138;918;5220
3108008;Bom Sucesso;1970;15963;8582;7381
3108107;Bonfim;1970;8180;1718;6462
3108206;Bonfinópolis de Minas;1970;13296;1407;11889
3108305;Borda da Mata;1970;12520;4669;7851
3108404;Botelhos;1970;12654;5173;7481
3108503;Botumirim;1970;7063;718;6345
3108602;Brasília de Minas;1970;38363;9163;29200
3108701;Brás Pires;1970;5725;750;4975
3108800;Braúnas;1970;9405;1191;8214
3108909;Brazópolis;1970;15054;5493;9561
3109006;Brumadinho;1970;17874;7161;10713
3109105;Bueno Brandão;1970;9982;2554;7428
3109204;Buenópolis;1970;8593;3968;4625
3109303;Buritis;1970;9810;2157;7653
3109402;Buritizeiro;1970;12215;4466;7749
3109501;Cabo Verde;1970;10580;3436;7144
3109600;Cachoeira da Prata;1970;2451;2204;247
3109709;Cachoeira de Minas;1970;8640;2157;6483
3109808;Cachoeira Dourada;1970;4305;2125;2180
3109907;Caetanópolis;1970;5357;3957;1400
3110004;Caeté;1970;25166;19669;5497
3110103;Caiana;1970;3687;1003;2684
3110202;Cajuri;1970;4175;1170;3005
3110301;Caldas;1970;14613;4358;10255
3110400;Camacho;1970;3028;728;2300
3110509;Camanducaia;1970;10849;3036;7813
3110608;Cambuí;1970;15717;6162;9555
3110707;Cambuquira;1970;10142;6679;3463
3110806;Campanário;1970;14723;5470;9253
3110905;Campanha;1970;10030;6437;3593
3111002;Campestre;1970;15578;3953;11625
3111101;Campina Verde;1970;21940;8243;13697
3111200;Campo Belo;1970;28619;20342;8277
3111309;Campo do Meio;1970;8125;3886;4239
3111408;Campo Florido;1970;4881;1781;3100
3111507;Campos Altos;1970;8687;6023;2664
3111606;Campos Gerais;1970;19333;6798;12535
3111705;Canaã;1970;6034;814;5220
3111804;Canápolis;1970;9777;3355;6422
3111903;Cana Verde;1970;4524;1331;3193
3112000;Candeias;1970;13252;4088;9164
3112109;Caparaó;1970;5545;761;4784
3112208;Capela Nova;1970;5286;1445;3841
3112307;Capelinha;1970;19634;4426;15208
3112406;Capetinga;1970;6528;2513;4015
3112505;Capim Branco;1970;4147;1788;2359
3112604;Capinópolis;1970;14280;6826;7454
3112703;Capitão Enéas;1970;11234;4920;6314
3112802;Capitólio;1970;5778;2028;3750
3112901;Caputira;1970;6989;1312;5677
3113008;Caraí;1970;19006;2530;16476
3113107;Caranaíba;1970;4716;611;4105
3113206;Carandaí;1970;13129;5955;7174
3113305;Carangola;1970;34121;17762;16359
3113404;Caratinga;1970;109772;41782;67990
3113503;Carbonita;1970;6959;922;6037
3113602;Careaçu;1970;5119;2342;2777
3113701;Carlos Chagas;1970;32655;11121;21534
3113800;Carmésia;1970;3059;671;2388
3113909;Carmo da Cachoeira;1970;7294;2745;4549
3114006;Carmo da Mata;1970;9525;4702;4823
3114105;Carmo de Minas;1970;9774;3216;6558
3114204;Carmo do Cajuru;1970;10855;4550;6305
3114303;Carmo do Paranaíba;1970;25978;11099;14879
3114402;Carmo do Rio Claro;1970;13763;6049;7714
3114501;Carmópolis de Minas;1970;9999;3425;6574
3114600;Carrancas;1970;4881;1078;3803
3114709;Carvalhópolis;1970;2152;801;1351
3114808;Carvalhos;1970;5278;1169;4109
3114907;Casa Grande;1970;2105;521;1584
3115003;Cascalho Rico;1970;3403;739;2664
3115102;Cássia;1970;16378;8587;7791
3115201;Conceição da Barra de Minas;1970;3937;1450;2487
3115300;Cataguases;1970;43846;34102;9744
3115409;Catas Altas da Noruega;1970;3104;667;2437
3115508;Caxambu;1970;14315;13387;928
3115607;Cedro do Abaeté;1970;2282;1103;1179
3115706;Central de Minas;1970;10566;2322;8244
3115805;Centralina;1970;8281;5419;2862
3115904;Chácara;1970;3514;784;2730
3116001;Chalé;1970;6120;1217;4903
3116100;Chapada do Norte;1970;14073;727;13346
3116209;Chiador;1970;4735;992;3743
3116308;Cipotânea;1970;6269;1194;5075
3116407;Claraval;1970;4300;881;3419
3116506;Claro dos Poções;1970;8567;2465;6102
3116605;Cláudio;1970;13610;5520;8090
3116704;Coimbra;1970;5090;1764;3326
3116803;Coluna;1970;11054;1695;9359
3116902;Comendador Gomes;1970;3671;657;3014
3117009;Comercinho;1970;9767;1460;8307
3117108;Conceição da Aparecida;1970;7520;2892;4628
3117207;Conceição das Pedras;1970;2384;521;1863
3117306;Conceição das Alagoas;1970;12024;5421;6603
3117405;Conceição de Ipanema;1970;7420;1357;6063
3117504;Conceição do Mato Dentro;1970;20609;6993;13616
3117603;Conceição do Pará;1970;4347;666;3681
3117702;Conceição do Rio Verde;1970;9444;5408;4036
3117801;Conceição dos Ouros;1970;6341;2018;4323
3117900;Congonhal;1970;5612;1695;3917
3118007;Congonhas;1970;20374;12993;7381
3118106;Congonhas do Norte;1970;3820;936;2884
3118205;Conquista;1970;7682;3205;4477
3118304;Conselheiro Lafaiete;1970;50960;45502;5458
3118403;Conselheiro Pena;1970;41338;19632;21706
3118502;Consolação;1970;2060;585;1475
3118601;Contagem;1970;111235;108021;3214
3118700;Coqueiral;1970;7223;2654;4569
3118809;Coração de Jesus;1970;30140;7114;23026
3118908;Cordisburgo;1970;8092;3292;4800
3119005;Cordislândia;1970;2682;1318;1364
3119104;Corinto;1970;24238;16014;8224
3119203;Coroaci;1970;11650;3500;8150
3119302;Coromandel;1970;20098;7622;12476
3119401;Coronel Fabriciano;1970;41120;37547;3573
3119500;Coronel Murta;1970;8247;2275;5972
3119609;Coronel Pacheco;1970;3925;1247;2678
3119708;Coronel Xavier Chaves;1970;2879;906;1973
3119807;Córrego Danta;1970;7108;1869;5239
3119906;Córrego do Bom Jesus;1970;4098;623;3475
3120003;Córrego Novo;1970;9810;928;8882
3120102;Couto de Magalhães de Minas;1970;3313;1769;1544
3120201;Cristais;1970;8049;2670;5379
3120300;Cristália;1970;4760;357;4403
3120409;Cristiano Otoni;1970;3361;1394;1967
3120508;Cristina;1970;10124;3268;6856
3120607;Crucilândia;1970;4917;1525;3392
3120706;Cruzeiro da Fortaleza;1970;2975;1556;1419
3120805;Cruzília;1970;9196;4839;4357
3120904;Curvelo;1970;45423;31223;14200
3121001;Datas;1970;3993;1551;2442
3121100;Delfim Moreira;1970;10017;1673;8344
3121209;Delfinópolis;1970;7500;3224;4276
3121308;Descoberto;1970;4464;1266;3198
3121407;Desterro de Entre Rios;1970;7103;1133;5970
3121506;Desterro do Melo;1970;4014;676;3338
3121605;Diamantina;1970;34672;23829;10843
3121704;Diogo de Vasconcelos;1970;4997;897;4100
3121803;Dionísio;1970;12305;3891;8414
3121902;Divinésia;1970;4375;1116;3259
3122009;Divino;1970;18129;3773;14356
3122108;Divino das Laranjeiras;1970;10402;2584;7818
3122207;Divinolândia de Minas;1970;5024;3348;1676
3122306;Divinópolis;1970;80344;70686;9658
3122405;Divisa Nova;1970;3555;1440;2115
3122504;Dom Cavati;1970;6523;3560;2963
3122603;Dom Joaquim;1970;7454;2571;4883
3122702;Dom Silvério;1970;12859;4037;8822
3122801;Dom Viçoso;1970;2821;678;2143
3122900;Dona Eusébia;1970;4132;1513;2619
3123007;Dores de Campos;1970;5594;4045;1549
3123106;Dores de Guanhães;1970;6278;858;5420
3123205;Dores do Indaiá;1970;15707;12431;3276
3123304;Dores do Turvo;1970;5335;1196;4139
3123403;Doresópolis;1970;1901;535;1366
3123502;Douradoquara;1970;3194;872;2322
3123601;Elói Mendes;1970;14697;6798;7899
3123700;Engenheiro Caldas;1970;10687;3387;7300
3123809;Engenheiro Navarro;1970;5285;1393;3892
3123908;Entre Rios de Minas;1970;10316;3647;6669
3124005;Ervália;1970;13183;3272;9911
3124104;Esmeraldas;1970;15698;4099;11599
3124203;Espera Feliz;1970;10637;3239;7398
3124302;Espinosa;1970;29351;5167;24184
3124401;Espírito Santo do Dourado;1970;3580;545;3035
3124500;Estiva;1970;10030;2268;7762
3124609;Estrela Dalva;1970;3328;1302;2026
3124708;Estrela do Indaiá;1970;6351;2739;3612
3124807;Estrela do Sul;1970;8524;3143;5381
3124906;Eugenópolis;1970;10419;3142;7277
3125002;Ewbank da Câmara;1970;3294;1589;1705
3125101;Extrema;1970;8910;2427;6483
3125200;Fama;1970;2028;663;1365
3125309;Faria Lemos;1970;4410;1735;2675
3125408;Felício dos Santos;1970;4679;604;4075
3125507;São Gonçalo do Rio Preto;1970;2799;796;2003
3125606;Felisburgo;1970;4545;1753;2792
3125705;Felixlândia;1970;9870;3726;6144
3125804;Fernandes Tourinho;1970;5870;1493;4377
3125903;Ferros;1970;20016;4843;15173
3126000;Florestal;1970;4430;1641;2789
3126109;Formiga;1970;46864;29982;16882
3126208;Formoso;1970;4172;549;3623
3126307;Fortaleza de Minas;1970;3784;1286;2498
3126406;Fortuna de Minas;1970;2169;897;1272
3126505;Francisco Badaró;1970;14491;1521;12970
3126604;Francisco Dumont;1970;4328;863;3465
3126703;Francisco Sá;1970;26736;5739;20997
3126802;Frei Gaspar;1970;9656;835;8821
3126901;Frei Inocêncio;1970;9899;2513;7386
3127008;Fronteira;1970;5322;2675;2647
3127057;Fronteira dos Vales;1970;5967;1669;4298
3127107;Frutal;1970;30669;17735;12934
3127206;Funilândia;1970;2598;634;1964
3127305;Galiléia;1970;16195;4814;11381
3127404;Gonçalves;1970;4715;577;4138
3127503;Gonzaga;1970;5366;1523;3843
3127602;Gouveia;1970;8556;3777;4779
3127701;Governador Valadares;1970;162020;129565;32455
3127800;Grão Mogol;1970;20323;2021;18302
3127909;Grupiara;1970;2173;716;1457
3128006;Guanhães;1970;22426;10351;12075
3128105;Guapé;1970;9746;2779;6967
3128204;Guaraciaba;1970;11685;1455;10230
3128303;Guaranésia;1970;11176;5370;5806
3128402;Guarani;1970;10063;3956;6107
3128501;Guarará;1970;2868;1809;1059
3128600;Guarda-Mor;1970;4525;874;3651
3128709;Guaxupé;1970;24273;17300;6973
3128808;Guidoval;1970;10158;2463;7695
3128907;Guimarânia;1970;5417;2170;3247
3129004;Guiricema;1970;13933;2295;11638
3129103;Gurinhatã;1970;14120;1095;13025
3129202;Heliodora;1970;4928;1930;2998
3129301;Iapu;1970;16673;3360;13313
3129400;Ibertioga;1970;4458;1395;3063
3129509;Ibiá;1970;16782;10541;6241
3129608;Ibiaí;1970;4088;769;3319
3129707;Ibiraci;1970;8400;2902;5498
3129806;Ibirité;1970;19508;3812;15696
3129905;Ibitiúra de Minas;1970;2624;968;1656
3130002;Ibituruna;1970;2632;1240;1392
3130101;Igarapé;1970;7675;3460;4215
3130200;Igaratinga;1970;3762;1271;2491
3130309;Iguatama;1970;7920;3726;4194
3130408;Ijaci;1970;3442;1518;1924
3130507;Ilicínea;1970;6984;3008;3976
3130606;Inconfidentes;1970;5217;1477;3740
3130705;Indianópolis;1970;3891;1208;2683
3130804;Ingaí;1970;2589;690;1899
3130903;Inhapim;1970;40200;6423;33777
3131000;Inhaúma;1970;3761;1426;2335
3131109;Inimutaba;1970;5140;2191;2949
3131208;Ipanema;1970;20624;6277;14347
3131307;Ipatinga;1970;47882;44721;3161
3131406;Ipiaçu;1970;6865;2378;4487
3131505;Ipuiúna;1970;6432;2014;4418
3131604;Iraí de Minas;1970;3580;515;3065
3131703;Itabira;1970;56352;41272;15080
3131802;Itabirinha;1970;13336;3171;10165
3131901;Itabirito;1970;22470;17820;4650
3132008;Itacambira;1970;8245;406;7839
3132107;Itacarambi;1970;13132;2567;10565
3132206;Itaguara;1970;9030;3294;5736
3132305;Itaipé;1970;14203;1621;12582
3132404;Itajubá;1970;51716;42611;9105
3132503;Itamarandiba;1970;27020;3797;23223
3132602;Itamarati de Minas;1970;3262;1075;2187
3132701;Itambacuri;1970;29431;10427;19004
3132800;Itambé do Mato Dentro;1970;4066;277;3789
3132909;Itamogi;1970;7326;2834;4492
3133006;Itamonte;1970;7752;2384;5368
3133105;Itanhandu;1970;9132;5261;3871
3133204;Itanhomi;1970;25585;5068;20517
3133303;Itaobim;1970;15487;6858;8629
3133402;Itapagipe;1970;13644;2960;10684
3133501;Itapecerica;1970;21825;10828;10997
3133600;Itapeva;1970;4480;855;3625
3133709;Itatiaiuçu;1970;5330;1559;3771
3133808;Itaúna;1970;37648;32683;4965
3133907;Itaverava;1970;6998;1356;5642
3134004;Itinga;1970;22710;2886;19824
3134103;Itueta;1970;9646;2001;7645
3134202;Ituiutaba;1970;64656;47021;17635
3134301;Itumirim;1970;4795;2109;2686
3134400;Iturama;1970;42644;6419;36225
3134509;Itutinga;1970;4539;1902;2637
3134608;Jaboticatubas;1970;12159;2668;9491
3134707;Jacinto;1970;14164;3959;10205
3134806;Jacuí;1970;6379;1462;4917
3134905;Jacutinga;1970;10519;4787;5732
3135001;Jaguaraçu;1970;2477;694;1783
3135100;Janaúba;1970;31587;9990;21597
3135209;Januária;1970;62546;16088;46458
3135308;Japaraíba;1970;3217;466;2751
3135407;Jeceaba;1970;6259;1898;4361
3135506;Jequeri;1970;18194;3571;14623
3135605;Jequitaí;1970;8030;2318;5712
3135704;Jequitibá;1970;5468;870;4598
3135803;Jequitinhonha;1970;22986;9566;13420
3135902;Jesuânia;1970;4036;1604;2432
3136009;Joaíma;1970;19124;5893;13231
3136108;Joanésia;1970;8234;1713;6521
3136207;João Monlevade;1970;39988;38660;1328
3136306;João Pinheiro;1970;41502;10804;30698
3136405;Joaquim Felício;1970;3912;1181;2731
3136504;Jordânia;1970;10547;4407;6140
3136603;Nova União;1970;3958;669;3289
3136702;Juiz de Fora;1970;238510;220390;18120
3136801;Juramento;1970;7797;1688;6109
3136900;Juruaia;1970;5272;828;4444
3137007;Ladainha;1970;17022;3310;13712
3137106;Lagamar;1970;11216;1529;9687
3137205;Lagoa da Prata;1970;18275;12546;5729
3137304;Lagoa dos Patos;1970;3277;762;2515
3137403;Lagoa Dourada;1970;7541;2440;5101
3137502;Lagoa Formosa;1970;19180;4268;14912
3137601;Lagoa Santa;1970;14053;10632;3421
3137700;Lajinha;1970;15379;4338;11041
3137809;Lambari;1970;13021;8206;4815
3137908;Lamim;1970;3741;635;3106
3138005;Laranjal;1970;6503;2026;4477
3138104;Lassance;1970;6367;1155;5212
3138203;Lavras;1970;44449;35430;9019
3138302;Leandro Ferreira;1970;4277;1030;3247
3138401;Leopoldina;1970;41306;24070;17236
3138500;Liberdade;1970;6355;1883;4472
3138609;Lima Duarte;1970;14578;6421;8157
3138708;Luminárias;1970;5503;1543;3960
3138807;Luz;1970;14069;7717;6352
3138906;Machacalis;1970;6071;3741;2330
3139003;Machado;1970;21556;11491;10065
3139102;Madre de Deus de Minas;1970;3946;1671;2275
3139201;Malacacheta;1970;42262;7466;34796
3139300;Manga;1970;24504;4307;20197
3139409;Manhuaçu;1970;48230;17997;30233
3139508;Manhumirim;1970;23509;10820;12689
3139607;Mantena;1970;47646;15856;31790
3139706;Maravilhas;1970;4523;1829;2694
3139805;Mar de Espanha;1970;8901;4574;4327
3139904;Maria da Fé;1970;10085;3783;6302
3140001;Mariana;1970;24786;14287;10499
3140100;Marilac;1970;5986;2668;3318
3140209;Maripá de Minas;1970;2361;807;1554
3140308;Marliéria;1970;4450;655;3795
3140407;Marmelópolis;1970;3243;1152;2091
3140506;Martinho Campos;1970;11629;5240;6389
3140605;Materlândia;1970;4439;922;3517
3140704;Mateus Leme;1970;11929;5985;5944
3140803;Matias Barbosa;1970;8788;5675;3113
3140902;Matipó;1970;11070;4422;6648
3141009;Mato Verde;1970;13973;3978;9995
3141108;Matozinhos;1970;8674;7236;1438
3141207;Matutina;1970;5078;1608;3470
3141306;Medeiros;1970;3017;770;2247
3141405;Medina;1970;19857;7985;11872
3141504;Mendes Pimentel;1970;22332;3912;18420
3141603;Mercês;1970;9637;3235;6402
3141702;Mesquita;1970;14237;4010;10227
3141801;Minas Novas;1970;25012;2477;22535
3141900;Minduri;1970;3775;2351;1424
3142007;Mirabela;1970;13137;3839;9298
3142106;Miradouro;1970;9232;2284;6948
3142205;Miraí;1970;14269;5746;8523
3142304;Moeda;1970;4668;1528;3140
3142403;Moema;1970;4147;2658;1489
3142502;Monjolos;1970;4015;1378;2637
3142601;Monsenhor Paulo;1970;5114;1610;3504
3142700;Montalvânia;1970;25566;5300;20266
3142809;Monte Alegre de Minas;1970;14687;5750;8937
3142908;Monte Azul;1970;27444;6165;21279
3143005;Monte Belo;1970;11873;3858;8015
3143104;Monte Carmelo;1970;20417;13579;6838
3143203;Monte Santo de Minas;1970;16501;6507;9994
3143302;Montes Claros;1970;116486;85147;31339
3143401;Monte Sião;1970;8630;2637;5993
3143500;Morada Nova de Minas;1970;8233;3120;5113
3143609;Morro da Garça;1970;3442;951;2491
3143708;Morro do Pilar;1970;4160;1557;2603
3143807;Munhoz;1970;4038;1118;2920
3143906;Muriaé;1970;58153;37336;20817
3144003;Mutum;1970;32910;6496;26414
3144102;Muzambinho;1970;15206;7137;8069
3144201;Nacip Raydan;1970;5963;2079;3884
3144300;Nanuque;1970;48903;37516;11387
3144409;Natércia;1970;4516;1314;3202
3144508;Nazareno;1970;4591;2449;2142
3144607;Nepomuceno;1970;19371;6407;12964
3144706;Nova Era;1970;14080;9284;4796
3144805;Nova Lima;1970;33992;27381;6611
3144904;Nova Módica;1970;8135;1754;6381
3145000;Nova Ponte;1970;6261;2315;3946
3145109;Nova Resende;1970;8789;2608;6181
3145208;Nova Serrana;1970;6538;2797;3741
3145307;Novo Cruzeiro;1970;31422;4522;26900
3145406;Olaria;1970;2508;465;2043
3145505;Olímpio Noronha;1970;2118;844;1274
3145604;Oliveira;1970;26502;19276;7226
3145703;Oliveira Fortes;1970;2866;858;2008
3145802;Onça de Pitangui;1970;2485;397;2088
3145901;Ouro Branco;1970;6329;2415;3914
3146008;Ouro Fino;1970;19606;9800;9806
3146107;Ouro Preto;1970;46165;31999;14166
3146206;Ouro Verde de Minas;1970;11000;2655;8345
3146305;Padre Paraíso;1970;12724;5231;7493
3146404;Paineiras;1970;7553;1826;5727
3146503;Pains;1970;9560;4343;5217
3146602;Paiva;1970;2143;1068;1075
3146701;Palma;1970;9203;3825;5378
3146909;Papagaios;1970;6304;3168;3136
3147006;Paracatu;1970;36821;17472;19349
3147105;Pará de Minas;1970;30995;25044;5951
3147204;Paraguaçu;1970;12390;7242;5148
3147303;Paraisópolis;1970;13165;7214;5951
3147402;Paraopeba;1970;9919;6453;3466
3147501;Passabém;1970;2272;373;1899
3147600;Passa Quatro;1970;11365;6665;4700
3147709;Passa Tempo;1970;8542;3245;5297
3147808;Passa Vinte;1970;3373;1089;2284
3147907;Passos;1970;54879;39138;15741
3148004;Patos de Minas;1970;76211;44958;31253
3148103;Patrocínio;1970;35578;21432;14146
3148202;Patrocínio do Muriaé;1970;5240;2069;3171
3148301;Paula Cândido;1970;8051;1657;6394
3148400;Paulistas;1970;5847;1376;4471
3148509;Pavão;1970;14794;3803;10991
3148608;Peçanha;1970;25104;5494;19610
3148707;Pedra Azul;1970;18838;11190;7648
3148806;Pedra do Anta;1970;5502;783;4719
3148905;Pedra do Indaiá;1970;4749;928;3821
3149002;Pedra Dourada;1970;1562;368;1194
3149101;Pedralva;1970;9821;2439;7382
3149200;Pedrinópolis;1970;2472;850;1622
3149309;Pedro Leopoldo;1970;20670;14328;6342
3149408;Pedro Teixeira;1970;1802;321;1481
3149507;Pequeri;1970;2699;1978;721
3149606;Pequi;1970;3083;1533;1550
3149705;Perdigão;1970;4733;1983;2750
3149804;Perdizes;1970;9973;1468;8505
3149903;Perdões;1970;12956;7529;5427
3150000;Pescador;1970;5139;1943;3196
3150109;Piau;1970;3931;1002;2929
3150208;Piedade de Ponte Nova;1970;4306;1732;2574
3150307;Piedade do Rio Grande;1970;5540;1596;3944
3150406;Piedade dos Gerais;1970;4558;680;3878
3150505;Pimenta;1970;5209;2718;2491
3150604;Piracema;1970;7080;1463;5617
3150703;Pirajuba;1970;2151;1431;720
3150802;Piranga;1970;16575;2996;13579
3150901;Piranguçu;1970;5136;969;4167
3151008;Piranguinho;1970;5544;1166;4378
3151107;Pirapetinga;1970;7309;3404;3905
3151206;Pirapora;1970;20282;18947;1335
3151305;Piraúba;1970;10274;3353;6921
3151404;Pitangui;1970;13983;8728;5255
3151503;Piumhi;1970;17141;11754;5387
3151602;Planura;1970;7372;5089;2283
3151701;Poço Fundo;1970;12752;4205;8547
3151800;Poços de Caldas;1970;57565;51777;5788
3151909;Pocrane;1970;16832;4227;12605
3152006;Pompéu;1970;17037;8372;8665
3152105;Ponte Nova;1970;45694;29924;15770
3152204;Porteirinha;1970;41741;5004;36737
3152303;Porto Firme;1970;9746;1894;7852
3152402;Poté;1970;15666;3724;11942
3152501;Pouso Alegre;1970;38072;29224;8848
3152600;Pouso Alto;1970;6353;2010;4343
3152709;Prados;1970;6514;3032;3482
3152808;Prata;1970;18501;7937;10564
3152907;Pratápolis;1970;17199;12179;5020
3153004;Pratinha;1970;3359;964;2395
3153103;Presidente Bernardes;1970;8071;738;7333
3153202;Presidente Juscelino;1970;6173;769;5404
3153301;Presidente Kubitschek;1970;2395;968;1427
3153400;Presidente Olegário;1970;27250;2988;24262
3153509;Alto Jequitibá;1970;6055;2257;3798
3153608;Prudente de Morais;1970;3578;2099;1479
3153707;Quartel Geral;1970;4056;1757;2299
3153806;Queluzito;1970;2395;267;2128
3153905;Raposos;1970;10133;9179;954
3154002;Raul Soares;1970;38858;12581;26277
3154101;Recreio;1970;12531;7663;4868
3154200;Resende Costa;1970;8686;3085;5601
3154309;Resplendor;1970;27013;11830;15183
3154408;Ressaquinha;1970;8867;2495;6372
3154507;Riacho dos Machados;1970;9676;749;8927
3154606;Ribeirão das Neves;1970;9707;5538;4169
3154705;Ribeirão Vermelho;1970;4101;3208;893
3154804;Rio Acima;1970;5118;3392;1726
3154903;Rio Casca;1970;18389;6581;11808
3155009;Rio Doce;1970;4033;1367;2666
3155108;Rio do Prado;1970;15852;4558;11294
3155207;Rio Espera;1970;8683;2033;6650
3155306;Rio Manso;1970;5214;742;4472
3155405;Rio Novo;1970;11039;5572;5467
3155504;Rio Paranaíba;1970;7590;1886;5704
3155603;Rio Pardo de Minas;1970;37559;2481;35078
3155702;Rio Piracicaba;1970;13232;7758;5474
3155801;Rio Pomba;1970;14588;8117;6471
3155900;Rio Preto;1970;9034;3245;5789
3156007;Rio Vermelho;1970;16238;2326;13912
3156106;Ritápolis;1970;5656;2691;2965
3156205;Rochedo de Minas;1970;1825;686;1139
3156304;Rodeiro;1970;4308;892;3416
3156403;Romaria;1970;1963;1143;820
3156502;Rubelita;1970;14752;981;13771
3156601;Rubim;1970;13708;6598;7110
3156700;Sabará;1970;45149;29049;16100
3156809;Sabinópolis;1970;15761;5472;10289
3156908;Sacramento;1970;22811;9217;13594
3157005;Salinas;1970;45925;9671;36254
3157104;Salto da Divisa;1970;10188;5171;5017
3157203;Santa Bárbara;1970;16246;9332;6914
3157302;Santa Bárbara do Tugúrio;1970;4641;604;4037
3157401;Santa Cruz do Escalvado;1970;10666;1531;9135
3157500;Santa Efigênia de Minas;1970;4363;816;3547
3157609;Santa Fé de Minas;1970;5282;927;4355
3157708;Santa Juliana;1970;5508;2244;3264
3157807;Santa Luzia;1970;25301;19402;5899
3157906;Santa Margarida;1970;9907;2401;7506
3158003;Santa Maria de Itabira;1970;10198;2438;7760
3158102;Santa Maria do Salto;1970;5409;1890;3519
3158201;Santa Maria do Suaçuí;1970;26482;7888;18594
3158300;Santana da Vargem;1970;5309;1178;4131
3158409;Santana de Cataguases;1970;4298;1034;3264
3158508;Santana de Pirapama;1970;12731;1577;11154
3158607;Santana do Deserto;1970;3586;434;3152
3158706;Santana do Garambéu;1970;1677;343;1334
3158805;Santana do Jacaré;1970;3396;2613;783
3158904;Santana do Manhuaçu;1970;7481;1418;6063
3159001;Santana do Riacho;1970;4179;708;3471
3159100;Santana dos Montes;1970;4785;1191;3594
3159209;Santa Rita de Caldas;1970;9654;3312;6342
3159308;Santa Rita de Jacutinga;1970;5408;2394;3014
3159407;Santa Rita de Ibitipoca;1970;5050;987;4063
3159506;Santa Rita do Itueto;1970;8284;564;7720
3159605;Santa Rita do Sapucaí;1970;18920;11566;7354
3159704;Santa Rosa da Serra;1970;4957;1391;3566
3159803;Santa Vitória;1970;19635;5443;14192
3159902;Santo Antônio do Amparo;1970;9060;4423;4637
3160009;Santo Antônio do Aventureiro;1970;4676;692;3984
3160108;Santo Antônio do Grama;1970;5062;1706;3356
3160207;Santo Antônio do Itambé;1970;5029;521;4508
3160306;Santo Antônio do Jacinto;1970;13385;2116;11269
3160405;Santo Antônio do Monte;1970;16560;7118;9442
3160504;Santo Antônio do Rio Abaixo;1970;2284;535;1749
3160603;Santo Hipólito;1970;4136;1808;2328
3160702;Santos Dumont;1970;37985;28469;9516
3160801;São Bento Abade;1970;1491;720;771
3160900;São Brás do Suaçuí;1970;2492;1485;1007
3161007;São Domingos do Prata;1970;21161;5628;15533
3161106;São Francisco;1970;58254;7145;51109
3161205;São Francisco de Paula;1970;4985;1448;3537
3161304;São Francisco de Sales;1970;6774;1424;5350
3161403;São Francisco do Glória;1970;5356;1426;3930
3161502;São Geraldo;1970;9758;3589;6169
3161601;São Geraldo da Piedade;1970;4410;514;3896
3161700;São Gonçalo do Abaeté;1970;11966;2536;9430
3161809;São Gonçalo do Pará;1970;6329;3849;2480
3161908;São Gonçalo do Rio Abaixo;1970;7865;1847;6018
3162005;São Gonçalo do Sapucaí;1970;16067;10663;5404
3162104;São Gotardo;1970;18223;8416;9807
3162203;São João Batista do Glória;1970;4980;2111;2869
3162302;São João da Mata;1970;2151;558;1593
3162401;São João da Ponte;1970;33394;5041;28353
3162500;São João del Rei;1970;55230;47142;8088
3162609;São João do Oriente;1970;8024;2675;5349
3162708;São João do Paraíso;1970;22727;951;21776
3162807;São João Evangelista;1970;15706;4359;11347
3162906;São João Nepomuceno;1970;18156;13060;5096
3163003;São José da Safira;1970;5584;1618;3966
3163102;São José da Varginha;1970;2355;617;1738
3163201;São José do Alegre;1970;3318;1084;2234
3163300;São José do Divino;1970;7733;1881;5852
3163409;São José do Goiabal;1970;9795;1913;7882
3163508;São José do Jacuri;1970;11230;1398;9832
3163607;São José do Mantimento;1970;2522;507;2015
3163706;São Lourenço;1970;19269;18111;1158
3163805;São Miguel do Anta;1970;6088;1733;4355
3163904;São Pedro da União;1970;4904;1114;3790
3164001;São Pedro dos Ferros;1970;13958;5034;8924
3164100;São Pedro do Suaçuí;1970;9525;1596;7929
3164209;São Romão;1970;11648;1525;10123
3164308;São Roque de Minas;1970;7143;1696;5447
3164407;São Sebastião da Bela Vista;1970;3004;845;2159
3164506;São Sebastião do Maranhão;1970;15082;2553;12529
3164605;São Sebastião do Oeste;1970;6170;578;5592
3164704;São Sebastião do Paraíso;1970;28538;19879;8659
3164803;São Sebastião do Rio Preto;1970;2743;505;2238
3164902;São Sebastião do Rio Verde;1970;2496;712;1784
3165008;São Tiago;1970;9400;3764;5636
3165107;São Tomás de Aquino;1970;6879;2556;4323
3165206;São Thomé das Letras;1970;6796;638;6158
3165305;São Vicente de Minas;1970;5545;3153;2392
3165404;Sapucaí-Mirim;1970;4398;1147;3251
3165503;Sardoá;1970;3581;642;2939
3165602;Senador Cortes;1970;2096;373;1723
3165701;Senador Firmino;1970;6754;2390;4364
3165800;Senador José Bento;1970;2424;425;1999
3165909;Senador Modestino Gonçalves;1970;5613;580;5033
3166006;Senhora de Oliveira;1970;4739;1327;3412
3166105;Senhora do Porto;1970;5766;1118;4648
3166204;Senhora dos Remédios;1970;8873;1174;7699
3166303;Sericita;1970;4778;1047;3731
3166402;Seritinga;1970;1835;823;1012
3166501;Serra Azul de Minas;1970;3676;604;3072
3166600;Serra da Saudade;1970;2160;687;1473
3166709;Serra dos Aimorés;1970;10424;6976;3448
3166808;Serra do Salitre;1970;5660;1727;3933
3166907;Serrania;1970;4544;2377;2167
3167004;Serranos;1970;2386;991;1395
3167103;Serro;1970;17579;6243;11336
3167202;Sete Lagoas;1970;66585;61119;5466
3167301;Silveirânia;1970;2699;475;2224
3167400;Silvianópolis;1970;6927;2646;4281
3167509;Simão Pereira;1970;2830;710;2120
3167608;Simonésia;1970;12865;1769;11096
3167707;Sobrália;1970;10217;2730;7487
3167806;Soledade de Minas;1970;5978;2799;3179
3167905;Tabuleiro;1970;5356;1690;3666
3168002;Taiobeiras;1970;14023;4831;9192
3168101;Tapira;1970;3206;609;2597
3168200;Tapiraí;1970;3443;966;2477
3168309;Taquaraçu de Minas;1970;4034;549;3485
3168408;Tarumirim;1970;31881;5773;26108
3168507;Teixeiras;1970;8709;2887;5822
3168606;Teófilo Otoni;1970;133017;67094;65923
3168705;Timóteo;1970;32760;29923;2837
3168804;Tiradentes;1970;5518;4047;1471
3168903;Tiros;1970;12844;2727;10117
3169000;Tocantins;1970;14346;4049;10297
3169109;Toledo;1970;4394;780;3614
3169208;Tombos;1970;10181;4581;5600
3169307;Três Corações;1970;35180;25623;9557
3169356;Três Marias;1970;9789;6101;3688
3169406;Três Pontas;1970;27514;14417;13097
3169505;Tumiritinga;1970;8343;2940;5403
3169604;Tupaciguara;1970;25127;13488;11639
3169703;Turmalina;1970;16490;2664;13826
3169802;Turvolândia;1970;2930;779;2151
3169901;Ubá;1970;44503;29856;14647
3170008;Ubaí;1970;12621;1203;11418
3170107;Uberaba;1970;124490;108313;16177
3170206;Uberlândia;1970;124706;111480;13226
3170305;Umburatiba;1970;4524;1875;2649
3170404;Unaí;1970;52303;14046;38257
3170503;Urucânia;1970;7668;1428;6240
3170602;Vargem Bonita;1970;2566;793;1773
3170701;Varginha;1970;43628;36372;7256
3170800;Várzea da Palma;1970;13358;6493;6865
3170909;Varzelândia;1970;27204;3707;23497
3171006;Vazante;1970;10014;2933;7081
3171105;Veríssimo;1970;4110;859;3251
3171204;Vespasiano;1970;12429;5255;7174
3171303;Viçosa;1970;25777;17044;8733
3171402;Vieiras;1970;4572;993;3579
3171501;Mathias Lobato;1970;3339;1882;1457
3171600;Virgem da Lapa;1970;13612;2293;11319
3171709;Virgínia;1970;8534;1622;6912
3171808;Virginópolis;1970;10349;3260;7089
3171907;Virgolândia;1970;10558;2892;7666
3172004;Visconde do Rio Branco;1970;25206;13867;11339
3172103;Volta Grande;1970;4920;2220;2700
3172202;Wenceslau Braz;1970;3116;1108;2008
3200102;Afonso Cláudio;1970;47383;7386;39997
3200201;Alegre;1970;40312;12238;28074
3200300;Alfredo Chaves;1970;10290;2208;8082
3200409;Anchieta;1970;11361;2264;9097
3200508;Apiacá;1970;7366;3009;4357
3200607;Aracruz;1970;26507;8210;18297
3200706;Atílio Vivacqua;1970;7112;1118;5994
3200805;Baixo Guandu;1970;26958;13112;13846
3200904;Barra de São Francisco;1970;54069;13923;40146
3201001;Boa Esperança;1970;10534;1103;9431
3201100;Bom Jesus do Norte;1970;5190;3829;1361
3201209;Cachoeiro de Itapemirim;1970;100010;63070;36940
3201308;Cariacica;1970;101422;69200;32222
3201407;Castelo;1970;25759;8499;17260
3201506;Colatina;1970;105096;52819;52277
3201605;Conceição da Barra;1970;32078;6825;25253
3201704;Conceição do Castelo;1970;14992;2271;12721
3201803;Divino de São Lourenço;1970;3933;374;3559
3201902;Domingos Martins;1970;24453;3657;20796
3202009;Dores do Rio Preto;1970;3721;570;3151
3202108;Ecoporanga;1970;47501;6663;40838
3202207;Fundão;1970;8170;3807;4363
3202306;Guaçuí;1970;16715;9363;7352
3202405;Guarapari;1970;24105;11262;12843
3202504;Ibiraçu;1970;17064;7762;9302
3202603;Iconha;1970;7604;1344;6260
3202702;Itaguaçu;1970;12015;3028;8987
3202801;Itapemirim;1970;28558;7395;21163
3202900;Itarana;1970;8760;1822;6938
3203007;Iúna;1970;31876;6851;25025
3203106;Jerônimo Monteiro;1970;7268;2473;4795
3203205;Linhares;1970;92329;28068;64261
3203304;Mantenópolis;1970;12105;2953;9152
3203403;Mimoso do Sul;1970;23778;7274;16504
3203502;Montanha;1970;13363;9436;3927
3203601;Mucurici;1970;19825;1346;18479
3203700;Muniz Freire;1970;18799;3215;15584
3203809;Muqui;1970;12666;4655;8011
3203908;Nova Venécia;1970;47480;10872;36608
3204005;Pancas;1970;28117;4593;23524
3204104;Pinheiros;1970;21153;10513;10640
3204203;Piúma;1970;3583;2257;1326
3204302;Presidente Kennedy;1970;10789;480;10309
3204401;Rio Novo do Sul;1970;9161;3120;6041
3204500;Santa Leopoldina;1970;21911;1513;20398
3204609;Santa Teresa;1970;25330;4140;21190
3204708;São Gabriel da Palha;1970;35439;10464;24975
3204807;São José do Calçado;1970;9588;3572;6016
3204906;São Mateus;1970;41150;12815;28335
3205002;Serra;1970;17286;7967;9319
3205101;Viana;1970;10529;1620;8909
3205200;Vila Velha;1970;123742;121850;1892
3205309;Vitória;1970;133019;132036;983
3300100;Angra dos Reis;1970;40276;19134;21142
3300209;Araruama;1970;40031;10237;29794
3300308;Barra do Piraí;1970;59076;46522;12554
3300407;Barra Mansa;1970;101660;80181;21479
3300506;Bom Jardim;1970;17095;4556;12539
3300605;Bom Jesus do Itabapoana;1970;29418;13106;16312
3300704;Cabo Frio;1970;44379;37738;6641
3300803;Cachoeiras de Macacu;1970;33793;10402;23391
3300902;Cambuci;1970;24424;6805;17619
3301009;Campos dos Goytacazes;1970;318806;176082;142724
3301108;Cantagalo;1970;18590;6563;12027
3301207;Carmo;1970;11787;4244;7543
3301306;Casimiro de Abreu;1970;16799;3994;12805
3301405;Conceição de Macabu;1970;11560;7333;4227
3301504;Cordeiro;1970;12859;8835;4024
3301603;Duas Barras;1970;7874;1488;6386
3301702;Duque de Caxias;1970;431397;404464;26933
3301801;Engenheiro Paulo de Frontin;1970;11556;5062;6494
3301900;Itaboraí;1970;65912;14110;51802
3302007;Itaguaí;1970;55839;17500;38339
3302106;Itaocara;1970;22264;5669;16595
3302205;Itaperuna;1970;60622;30127;30495
3302304;Laje do Muriaé;1970;8538;1935;6603
3302403;Macaé;1970;65318;39802;25516
3302502;Magé;1970;113023;83668;29355
3302601;Mangaratiba;1970;12338;6161;6177
3302700;Maricá;1970;23664;6457;17207
3302809;Mendes;1970;12748;7694;5054
3302908;Miguel Pereira;1970;13652;7330;6322
3303005;Miracema;1970;21187;13846;7341
3303104;Natividade;1970;20154;7081;13073
3303203;Nilópolis;1970;128011;128011;0
3303302;Niterói;1970;324246;292051;32195
3303401;Nova Friburgo;1970;90420;74794;15626
3303500;Nova Iguaçu;1970;727140;724306;2834
3303609;Paracambi;1970;25368;22144;3224
3303708;Paraíba do Sul;1970;26736;15602;11134
3303807;Paraty;1970;15934;4174;11760
3303906;Petrópolis;1970;189140;154545;34595
3304003;Piraí;1970;24150;10991;13159
3304102;Porciúncula;1970;12395;5669;6726
3304201;Resende;1970;66907;49366;17541
3304300;Rio Bonito;1970;34434;17747;16687
3304409;Rio Claro;1970;14251;3349;10902
3304508;Rio das Flores;1970;7183;2243;4940
3304557;Rio de Janeiro;1970;4251918;4251918;0
3304607;Santa Maria Madalena;1970;12452;3228;9224
3304706;Santo Antônio de Pádua;1970;31151;13254;17897
3304805;São Fidélis;1970;35143;11788;23355
3304904;São Gonçalo;1970;430271;430271;0
3305000;São João da Barra;1970;55619;9725;45894
3305109;São João de Meriti;1970;302394;302394;0
3305208;São Pedro da Aldeia;1970;27721;6360;21361
3305307;São Sebastião do Alto;1970;10073;1481;8592
3305406;Sapucaia;1970;16042;7788;8254
3305505;Saquarema;1970;24378;10880;13498
3305604;Silva Jardim;1970;17190;3647;13543
3305703;Sumidouro;1970;11003;1331;9672
3305802;Teresópolis;1970;73128;53626;19502
3305901;Trajano de Moraes;1970;12738;2885;9853
3306008;Três Rios;1970;55871;37595;18276
3306107;Valença;1970;48313;29246;19067
3306206;Vassouras;1970;41148;15459;25689
3306305;Volta Redonda;1970;125295;120624;4671
3500105;Adamantina;1970;31798;21999;9799
3500204;Adolfo;1970;3969;1190;2779
3500303;Aguaí;1970;13171;9626;3545
3500402;Águas da Prata;1970;5876;2618;3258
3500501;Águas de Lindóia;1970;6732;5364;1368
3500550;Águas de Santa Bárbara;1970;4723;1897;2826
3500600;Águas de São Pedro;1970;830;830;0
3500709;Agudos;1970;18543;12783;5760
3500808;Alfredo Marcondes;1970;6867;2009;4858
3500907;Altair;1970;2527;1008;1519
3501004;Altinópolis;1970;10819;5240;5579
3501103;Alto Alegre;1970;7473;1819;5654
3501202;Álvares Florence;1970;8334;1553;6781
3501301;Álvares Machado;1970;17305;6480;10825
3501400;Álvaro de Carvalho;1970;4200;1156;3044
3501509;Alvinlândia;1970;3020;1209;1811
3501608;Americana;1970;66316;62320;3996
3501707;Américo Brasiliense;1970;5368;3782;1586
3501806;Américo de Campos;1970;6148;2151;3997
3501905;Amparo;1970;31908;20749;11159
3502002;Analândia;1970;2612;1071;1541
3502101;Andradina;1970;51688;43489;8199
3502200;Angatuba;1970;15170;4297;10873
3502309;Anhembi;1970;3517;1301;2216
3502408;Anhumas;1970;5609;1025;4584
3502507;Aparecida;1970;24669;23075;1594
3502606;Aparecida d'Oeste;1970;7919;2922;4997
3502705;Apiaí;1970;19635;5412;14223
3502804;Araçatuba;1970;108512;86829;21683
3502903;Araçoiaba da Serra;1970;6557;1881;4676
3503000;Aramina;1970;5042;1501;3541
3503109;Arandu;1970;5239;915;4324
3503208;Araraquara;1970;100438;84459;15979
3503307;Araras;1970;53422;40875;12547
3503406;Arealva;1970;6519;2654;3865
3503505;Areias;1970;4107;1108;2999
3503604;Areiópolis;1970;5725;1477;4248
3503703;Ariranha;1970;5094;2409;2685
3503802;Artur Nogueira;1970;10171;3188;6983
3503901;Arujá;1970;9571;7126;2445
3504008;Assis;1970;57220;47627;9593
3504107;Atibaia;1970;36838;20318;16520
3504206;Auriflama;1970;13266;5759;7507
3504305;Avaí;1970;5252;1693;3559
3504404;Avanhandava;1970;5974;3695;2279
3504503;Avaré;1970;37854;30103;7751
3504602;Bady Bassitt;1970;2669;472;2197
3504701;Balbinos;1970;1114;284;830
3504800;Bálsamo;1970;5746;2748;2998
3504909;Bananal;1970;12889;3185;9704
3505005;Barão de Antonina;1970;4345;698;3647
3505104;Barbosa;1970;4871;2442;2429
3505203;Bariri;1970;17497;11516;5981
3505302;Barra Bonita;1970;17328;14147;3181
3505401;Barra do Turvo;1970;3980;414;3566
3505500;Barretos;1970;65574;53380;12194
3505609;Barrinha;1970;8430;6843;1587
3505708;Barueri;1970;37808;36382;1426
3505807;Bastos;1970;9657;6444;3213
3505906;Batatais;1970;29262;20813;8449
3506003;Bauru;1970;131936;121060;10876
3506102;Bebedouro;1970;37816;29492;8324
3506201;Bento de Abreu;1970;2529;1030;1499
3506300;Bernardino de Campos;1970;10243;5961;4282
3506409;Bilac;1970;5976;2529;3447
3506508;Birigui;1970;34976;27185;7791
3506607;Biritiba Mirim;1970;9033;3256;5777
3506706;Boa Esperança do Sul;1970;6363;2390;3973
3506805;Bocaina;1970;6896;3386;3510
3506904;Bofete;1970;5327;1658;3669
3507001;Boituva;1970;8976;5692;3284
3507100;Bom Jesus dos Perdões;1970;3834;2321;1513
3507209;Borá;1970;1270;126;1144
3507308;Boracéia;1970;2643;912;1731
3507407;Borborema;1970;9530;3761;5769
3507506;Botucatu;1970;51954;43199;8755
3507605;Bragança Paulista;1970;63676;41386;22290
3507704;Braúna;1970;5038;1986;3052
3507803;Brodowski;1970;8328;5274;3054
3507902;Brotas;1970;11962;5422;6540
3508009;Buri;1970;8976;3504;5472
3508108;Buritama;1970;10019;5537;4482
3508207;Buritizal;1970;5569;1788;3781
3508306;Cabrália Paulista;1970;3259;1535;1724
3508405;Cabreúva;1970;7679;1332;6347
3508504;Caçapava;1970;30712;24634;6078
3508603;Cachoeira Paulista;1970;17336;12958;4378
3508702;Caconde;1970;15248;6685;8563
3508801;Cafelândia;1970;17592;8520;9072
3508900;Caiabu;1970;7012;1231;5781
3509007;Caieiras;1970;15563;8724;6839
3509106;Caiuá;1970;5271;1242;4029
3509205;Cajamar;1970;10355;4175;6180
3509304;Cajobi;1970;6741;2912;3829
3509403;Cajuru;1970;13725;7470;6255
3509502;Campinas;1970;375864;335469;40395
3509601;Campo Limpo Paulista;1970;9156;6841;2315
3509700;Campos do Jordão;1970;18706;15528;3178
3509809;Campos Novos Paulista;1970;4148;1214;2934
3509908;Cananéia;1970;6080;1963;4117
3510005;Cândido Mota;1970;23583;9382;14201
3510104;Cândido Rodrigues;1970;2243;877;1366
3510203;Capão Bonito;1970;30326;11444;18882
3510302;Capela do Alto;1970;4872;1854;3018
3510401;Capivari;1970;18986;12941;6045
3510500;Caraguatatuba;1970;15073;13121;1952
3510609;Carapicuíba;1970;54873;54873;0
3510708;Cardoso;1970;17296;8802;8494
3510807;Casa Branca;1970;18170;12425;5745
3510906;Cássia dos Coqueiros;1970;2568;581;1987
3511003;Castilho;1970;15329;8269;7060
3511102;Catanduva;1970;58251;49340;8911
3511201;Catiguá;1970;5244;1492;3752
3511300;Cedral;1970;6527;1838;4689
3511409;Cerqueira César;1970;9564;5904;3660
3511508;Cerquilho;1970;6960;3982;2978
3511607;Cesário Lange;1970;5755;1685;4070
3511706;Charqueada;1970;7924;3151;4773
3511904;Clementina;1970;5247;1534;3713
3512001;Colina;1970;11650;6841;4809
3512100;Colômbia;1970;4224;1557;2667
3512209;Conchal;1970;7833;4466;3367
3512308;Conchas;1970;10046;5590;4456
3512407;Cordeirópolis;1970;7970;4433;3537
3512506;Coroados;1970;6592;1935;4657
3512605;Coronel Macedo;1970;5782;942;4840
3512704;Corumbataí;1970;2842;957;1885
3512803;Cosmópolis;1970;12110;7030;5080
3512902;Cosmorama;1970;10231;2109;8122
3513009;Cotia;1970;30924;29476;1448
3513108;Cravinhos;1970;14230;9938;4292
3513207;Cristais Paulista;1970;4974;1131;3843
3513306;Cruzália;1970;7478;492;6986
3513405;Cruzeiro;1970;45672;42362;3310
3513504;Cubatão;1970;50906;37164;13742
3513603;Cunha;1970;21952;4266;17686
3513702;Descalvado;1970;15510;9685;5825
3513801;Diadema;1970;78914;68515;10399
3513900;Divinolândia;1970;12363;3972;8391
3514007;Dobrada;1970;2773;1352;1421
3514106;Dois Córregos;1970;13417;9293;4124
3514205;Dolcinópolis;1970;3265;1085;2180
3514304;Dourado;1970;5634;2447;3187
3514403;Dracena;1970;35347;25131;10216
3514502;Duartina;1970;10840;6038;4802
3514601;Dumont;1970;3054;1712;1342
3514700;Echaporã;1970;7684;2260;5424
3514809;Eldorado;1970;10845;2588;8257
3514908;Elias Fausto;1970;6151;2922;3229
3515004;Embu das Artes;1970;18141;4342;13799
3515103;Embu-Guaçu;1970;10280;5332;4948
3515186;Espírito Santo do Pinhal;1970;27299;18200;9099
3515202;Estrela d'Oeste;1970;10873;4147;6726
3515301;Estrela do Norte;1970;3322;486;2836
3515400;Fartura;1970;12477;4434;8043
3515509;Fernandópolis;1970;39050;28335;10715
3515608;Fernando Prestes;1970;4417;1435;2982
3515707;Ferraz de Vasconcelos;1970;25134;24815;319
3515806;Flora Rica;1970;4561;932;3629
3515905;Floreal;1970;4683;1433;3250
3516002;Flórida Paulista;1970;17741;6431;11310
3516101;Florínea;1970;5649;1653;3996
3516200;Franca;1970;93638;86868;6770
3516309;Francisco Morato;1970;11231;9010;2221
3516408;Franco da Rocha;1970;36303;19939;16364
3516507;Gabriel Monteiro;1970;3344;649;2695
3516606;Gália;1970;12628;4722;7906
3516705;Garça;1970;37358;22613;14745
3516804;Gastão Vidigal;1970;4423;1764;2659
3516903;General Salgado;1970;16591;3470;13121
3517000;Getulina;1970;12067;5016;7051
3517109;Glicério;1970;5153;1923;3230
3517208;Guaiçara;1970;5174;2019;3155
3517307;Guaimbê;1970;5037;1813;3224
3517406;Guaíra;1970;26883;16922;9961
3517505;Guapiaçu;1970;5193;1519;3674
3517604;Guapiara;1970;14224;1823;12401
3517703;Guará;1970;12765;9585;3180
3517802;Guaraçaí;1970;10239;3489;6750
3517901;Guaraci;1970;7377;4590;2787
3518008;Guarani d'Oeste;1970;7966;1171;6795
3518107;Guarantã;1970;5771;2135;3636
3518206;Guararapes;1970;23324;14234;9090
3518305;Guararema;1970;12638;3291;9347
3518404;Guaratinguetá;1970;68869;54862;14007
3518503;Guareí;1970;7509;1472;6037
3518602;Guariba;1970;11448;9131;2317
3518701;Guarujá;1970;94021;90568;3453
3518800;Guarulhos;1970;236811;221605;15206
3518909;Guzolândia;1970;7605;1290;6315
3519006;Herculândia;1970;7587;2734;4853
3519105;Iacanga;1970;7171;3835;3336
3519204;Iacri;1970;8150;1467;6683
3519303;Ibaté;1970;7475;4244;3231
3519402;Ibirá;1970;7286;3892;3394
3519501;Ibirarema;1970;5507;2311;3196
3519600;Ibitinga;1970;23968;14972;8996
3519709;Ibiúna;1970;24391;6520;17871
3519808;Icém;1970;5981;4124;1857
3519907;Iepê;1970;12586;4530;8056
3520004;Igaraçu do Tietê;1970;8861;6706;2155
3520103;Igarapava;1970;21202;12397;8805
3520202;Igaratá;1970;3686;561;3125
3520301;Iguape;1970;19211;8884;10327
3520400;Ilhabela;1970;5707;5434;273
3520509;Indaiatuba;1970;30537;22333;8204
3520608;Indiana;1970;5156;2182;2974
3520707;Indiaporã;1970;5842;1651;4191
3520806;Inúbia Paulista;1970;5238;1584;3654
3520905;Ipaussu;1970;12122;6807;5315
3521002;Iperó;1970;6439;3173;3266
3521101;Ipeúna;1970;2097;700;1397
3521200;Iporanga;1970;3917;530;3387
3521309;Ipuã;1970;9977;5140;4837
3521408;Iracemápolis;1970;6907;4132;2775
3521507;Irapuã;1970;6081;2184;3897
3521606;Irapuru;1970;12058;4878;7180
3521705;Itaberá;1970;14585;2935;11650
3521804;Itaí;1970;13470;3889;9581
3521903;Itajobi;1970;11579;3047;8532
3522000;Itaju;1970;3236;538;2698
3522109;Itanhaém;1970;14515;12175;2340
3522208;Itapecerica da Serra;1970;25314;17718;7596
3522307;Itapetininga;1970;63606;43182;20424
3522406;Itapeva;1970;49122;25407;23715
3522505;Itapevi;1970;27569;27569;0
3522604;Itapira;1970;39036;26545;12491
3522703;Itápolis;1970;20711;10073;10638
3522802;Itaporanga;1970;14600;5290;9310
3522901;Itapuí;1970;6728;4088;2640
3523008;Itapura;1970;4273;3101;1172
3523107;Itaquaquecetuba;1970;29114;22144;6970
3523206;Itararé;1970;30507;15723;14784
3523305;Itariri;1970;7315;2473;4842
3523404;Itatiba;1970;28376;20767;7609
3523503;Itatinga;1970;9486;4632;4854
3523602;Itirapina;1970;6968;4522;2446
3523701;Itirapuã;1970;4684;1993;2691
3523800;Itobi;1970;5497;2105;3392
3523909;Itu;1970;49091;35958;13133
3524006;Itupeva;1970;7095;788;6307
3524105;Ituverava;1970;27380;18704;8676
3524204;Jaborandi;1970;5792;3296;2496
3524303;Jaboticabal;1970;38779;29609;9170
3524402;Jacareí;1970;61216;48529;12687
3524501;Jaci;1970;4000;683;3317
3524600;Jacupiranga;1970;16270;6722;9548
3524709;Jaguariúna;1970;10391;3835;6556
3524808;Jales;1970;38436;23380;15056
3524907;Jambeiro;1970;2857;809;2048
3525003;Jandira;1970;12499;12499;0
3525102;Jardinópolis;1970;16992;10940;6052
3525201;Jarinu;1970;5143;819;4324
3525300;Jaú;1970;56301;42267;14034
3525409;Jeriquara;1970;1709;741;968
3525508;Joanópolis;1970;7362;1974;5388
3525607;João Ramalho;1970;2797;553;2244
3525706;José Bonifácio;1970;20738;8253;12485
3525805;Júlio Mesquita;1970;4661;1161;3500
3525904;Jundiaí;1970;169076;145700;23376
3526001;Junqueirópolis;1970;22638;8681;13957
3526100;Juquiá;1970;12649;3664;8985
3526209;Juquitiba;1970;7267;1525;5742
3526308;Lagoinha;1970;5590;1111;4479
3526407;Laranjal Paulista;1970;13107;8722;4385
3526506;Lavínia;1970;8372;3087;5285
3526605;Lavrinhas;1970;3047;1093;1954
3526704;Leme;1970;31229;23457;7772
3526803;Lençóis Paulista;1970;22423;14054;8369
3526902;Limeira;1970;90963;77169;13794
3527009;Lindóia;1970;2242;1533;709
3527108;Lins;1970;45555;38144;7411
3527207;Lorena;1970;46463;40972;5491
3527306;Louveira;1970;6430;1878;4552
3527405;Lucélia;1970;20472;11159;9313
3527504;Lucianópolis;1970;2213;637;1576
3527603;Luís Antônio;1970;3083;624;2459
3527702;Luiziânia;1970;4461;1197;3264
3527801;Lupércio;1970;4588;1004;3584
3527900;Lutécia;1970;4416;1107;3309
3528007;Macatuba;1970;7729;1757;5972
3528106;Macaubal;1970;6996;2711;4285
3528205;Macedônia;1970;5475;1102;4373
3528304;Magda;1970;4217;1004;3213
3528403;Mairinque;1970;18858;5714;13144
3528502;Mairiporã;1970;19584;5512;14072
3528601;Manduri;1970;5083;1831;3252
3528700;Marabá Paulista;1970;7041;1077;5964
3528809;Maracaí;1970;11454;3381;8073
3528908;Mariápolis;1970;7543;1522;6021
3529005;Marília;1970;98176;76062;22114
3529104;Marinópolis;1970;2701;795;1906
3529203;Martinópolis;1970;23072;9548;13524
3529302;Matão;1970;21953;14284;7669
3529401;Mauá;1970;101700;101542;158
3529500;Mendonça;1970;4205;800;3405
3529609;Meridiano;1970;5795;1321;4474
3529708;Miguelópolis;1970;18396;8352;10044
3529807;Mineiros do Tietê;1970;5096;3241;1855
3529906;Miracatu;1970;14138;2239;11899
3530003;Mira Estrela;1970;4084;1036;3048
3530102;Mirandópolis;1970;23549;12342;11207
3530201;Mirante do Paranapanema;1970;21909;7175;14734
3530300;Mirassol;1970;20579;16714;3865
3530409;Mirassolândia;1970;2953;483;2470
3530508;Mococa;1970;34819;22667;12152
3530607;Mogi das Cruzes;1970;138751;110249;28502
3530706;Mogi Guaçu;1970;42710;30088;12622
3530805;Mogi Mirim;1970;36301;28384;7917
3530904;Mombuca;1970;3010;569;2441
3531001;Monções;1970;2500;929;1571
3531100;Mongaguá;1970;5213;4658;555
3531209;Monte Alegre do Sul;1970;4762;1427;3335
3531308;Monte Alto;1970;21520;14058;7462
3531407;Monte Aprazível;1970;17005;9460;7545
3531506;Monte Azul Paulista;1970;10431;6820;3611
3531605;Monte Castelo;1970;6376;1725;4651
3531704;Monteiro Lobato;1970;3180;603;2577
3531803;Monte Mor;1970;7960;3789;4171
3531902;Morro Agudo;1970;16609;8017;8592
3532009;Morungaba;1970;5032;2834;2198
3532108;Murutinga do Sul;1970;5384;2107;3277
3532207;Narandiba;1970;4008;732;3276
3532306;Natividade da Serra;1970;9957;1376;8581
3532405;Nazaré Paulista;1970;10009;2122;7887
3532504;Neves Paulista;1970;8199;4067;4132
3532603;Nhandeara;1970;10996;4490;6506
3532702;Nipoã;1970;3046;1033;2013
3532801;Nova Aliança;1970;4577;1518;3059
3532900;Nova Europa;1970;3822;1169;2653
3533007;Nova Granada;1970;12032;5889;6143
3533106;Nova Guataporanga;1970;2375;1062;1313
3533205;Nova Independência;1970;2042;709;1333
3533304;Nova Luzitânia;1970;2678;551;2127
3533403;Nova Odessa;1970;8336;6233;2103
3533502;Novo Horizonte;1970;23098;13315;9783
3533601;Nuporanga;1970;5676;2618;3058
3533700;Ocauçu;1970;5955;1232;4723
3533809;Óleo;1970;4406;946;3460
3533908;Olímpia;1970;29079;20320;8759
3534005;Onda Verde;1970;2180;686;1494
3534104;Oriente;1970;8781;2088;6693
3534203;Orindiúva;1970;2443;715;1728
3534302;Orlândia;1970;18275;15104;3171
3534401;Osasco;1970;283073;283073;0
3534500;Oscar Bressane;1970;4197;1065;3132
3534609;Osvaldo Cruz;1970;23377;13898;9479
3534708;Ourinhos;1970;49221;40773;8448
3534807;Ouro Verde;1970;7706;2555;5151
3534906;Pacaembu;1970;17211;5933;11278
3535002;Palestina;1970;12129;4446;7683
3535101;Palmares Paulista;1970;3105;1490;1615
3535200;Palmeira d'Oeste;1970;15345;5160;10185
3535309;Palmital;1970;20066;8345;11721
3535408;Panorama;1970;6568;3385;3183
3535507;Paraguaçu Paulista;1970;21892;13849;8043
3535606;Paraibuna;1970;13845;4981;8864
3535705;Paraíso;1970;3422;995;2427
3535804;Paranapanema;1970;9984;2286;7698
3535903;Paranapuã;1970;9190;2629;6561
3536000;Parapuã;1970;11198;4624;6574
3536109;Pardinho;1970;3098;888;2210
3536208;Pariquera-Açu;1970;7806;2043;5763
3536307;Patrocínio Paulista;1970;8635;3690;4945
3536406;Paulicéia;1970;3385;1234;2151
3536505;Paulínia;1970;10708;3690;7018
3536604;Paulo de Faria;1970;9463;4893;4570
3536703;Pederneiras;1970;18399;11853;6546
3536802;Pedra Bela;1970;5230;636;4594
3536901;Pedranópolis;1970;4495;883;3612
3537008;Pedregulho;1970;14780;4609;10171
3537107;Pedreira;1970;15053;12071;2982
3537206;Pedro de Toledo;1970;6095;1821;4274
3537305;Penápolis;1970;34263;24710;9553
3537404;Pereira Barreto;1970;52413;19647;32766
3537503;Pereiras;1970;4834;1457;3377
3537602;Peruíbe;1970;6966;6069;897
3537701;Piacatu;1970;5352;1921;3431
3537800;Piedade;1970;27640;6928;20712
3537909;Pilar do Sul;1970;10265;4568;5697
3538006;Pindamonhangaba;1970;48222;29346;18876
3538105;Pindorama;1970;9045;4730;4315
3538204;Pinhalzinho;1970;4912;1352;3560
3538303;Piquerobi;1970;5351;1098;4253
3538501;Piquete;1970;14316;12607;1709
3538600;Piracaia;1970;12883;4918;7965
3538709;Piracicaba;1970;152505;127776;24729
3538808;Piraju;1970;20336;13563;6773
3538907;Pirajuí;1970;20344;11768;8576
3539004;Pirangi;1970;6210;2910;3300
3539103;Pirapora do Bom Jesus;1970;3694;1762;1932
3539202;Pirapozinho;1970;15922;8796;7126
3539301;Pirassununga;1970;37577;26261;11316
3539400;Piratininga;1970;10232;5001;5231
3539509;Pitangueiras;1970;15813;9402;6411
3539608;Planalto;1970;7250;1755;5495
3539707;Platina;1970;2966;666;2300
3539806;Poá;1970;32373;31722;651
3539905;Poloni;1970;5105;2904;2201
3540002;Pompéia;1970;17877;9583;8294
3540101;Pongaí;1970;3283;1329;1954
3540200;Pontal;1970;13728;7318;6410
3540309;Pontes Gestal;1970;3447;1003;2444
3540408;Populina;1970;8066;2901;5165
3540507;Porangaba;1970;7577;2810;4767
3540606;Porto Feliz;1970;22152;13895;8257
3540705;Porto Ferreira;1970;19216;15967;3249
3540804;Potirendaba;1970;9880;3884;5996
3540903;Pradópolis;1970;5796;3024;2772
3541000;Praia Grande;1970;19694;19662;32
3541109;Presidente Alves;1970;5117;1508;3609
3541208;Presidente Bernardes;1970;25590;8163;17427
3541307;Presidente Epitácio;1970;26428;17389;9039
3541406;Presidente Prudente;1970;105707;92601;13106
3541505;Presidente Venceslau;1970;25976;18477;7499
3541604;Promissão;1970;20544;15609;4935
3541703;Quatá;1970;11581;3234;8347
3541802;Queiroz;1970;3372;1025;2347
3541901;Queluz;1970;5919;3864;2055
3542008;Quintana;1970;6488;2433;4055
3542107;Rafard;1970;5118;2270;2848
3542206;Rancharia;1970;22041;14478;7563
3542305;Redenção da Serra;1970;5135;1210;3925
3542404;Regente Feijó;1970;10366;6203;4163
3542503;Reginópolis;1970;4472;1993;2479
3542602;Registro;1970;24281;12632;11649
3542701;Restinga;1970;5456;1343;4113
3542800;Ribeira;1970;7174;1296;5878
3542909;Ribeirão Bonito;1970;6856;3400;3456
3543006;Ribeirão Branco;1970;10113;1096;9017
3543105;Ribeirão Corrente;1970;2193;756;1437
3543204;Ribeirão do Sul;1970;3619;964;2655
3543303;Ribeirão Pires;1970;29048;24086;4962
3543402;Ribeirão Preto;1970;212879;196458;16421
3543501;Riversul;1970;9143;1984;7159
3543600;Rifaina;1970;6180;2814;3366
3543709;Rincão;1970;6538;4162;2376
3543808;Rinópolis;1970;14420;4546;9874
3543907;Rio Claro;1970;78040;69644;8396
3544004;Rio das Pedras;1970;8917;5019;3898
3544103;Rio Grande da Serra;1970;8397;7296;1101
3544202;Riolândia;1970;9640;4190;5450
3544301;Roseira;1970;3492;1777;1715
3544400;Rubiácea;1970;3376;796;2580
3544509;Rubinéia;1970;4849;1796;3053
3544608;Sabino;1970;5044;1984;3060
3544707;Sagres;1970;4083;534;3549
3544806;Sales;1970;4053;982;3071
3544905;Sales Oliveira;1970;7108;3261;3847
3545001;Salesópolis;1970;9557;3272;6285
3545100;Salmourão;1970;4954;889;4065
3545209;Salto;1970;21772;19030;2742
3545308;Salto de Pirapora;1970;9001;4257;4744
3545407;Salto Grande;1970;7123;4004;3119
3545506;Sandovalina;1970;3090;977;2113
3545605;Santa Adélia;1970;8857;4459;4398
3545704;Santa Albertina;1970;9734;3897;5837
3545803;Santa Bárbara d'Oeste;1970;31018;22434;8584
3546009;Santa Branca;1970;6831;3304;3527
3546108;Santa Clara d'Oeste;1970;3913;1042;2871
3546207;Santa Cruz da Conceição;1970;2184;555;1629
3546306;Santa Cruz das Palmeiras;1970;13000;8552;4448
3546405;Santa Cruz do Rio Pardo;1970;34412;17199;17213
3546504;Santa Ernestina;1970;2903;1366;1537
3546603;Santa Fé do Sul;1970;16939;12970;3969
3546702;Santa Gertrudes;1970;6010;4097;1913
3546801;Santa Isabel;1970;17161;9237;7924
3546900;Santa Lúcia;1970;4347;1884;2463
3547007;Santa Maria da Serra;1970;2144;1303;841
3547106;Santa Mercedes;1970;4903;1212;3691
3547205;Santana da Ponte Pensa;1970;3906;682;3224
3547304;Santana de Parnaíba;1970;5390;2233;3157
3547403;Santa Rita d'Oeste;1970;6561;1219;5342
3547502;Santa Rita do Passa Quatro;1970;19064;10342;8722
3547601;Santa Rosa de Viterbo;1970;11840;6863;4977
3547700;Santo Anastácio;1970;25332;14821;10511
3547809;Santo André;1970;418826;417264;1562
3547908;Santo Antônio da Alegria;1970;4462;1649;2813
3548005;Santo Antônio de Posse;1970;7799;4144;3655
3548104;Santo Antônio do Jardim;1970;4833;1417;3416
3548203;Santo Antônio do Pinhal;1970;5479;1262;4217
3548302;Santo Expedito;1970;4148;1254;2894
3548401;Santópolis do Aguapeí;1970;3596;1856;1740
3548500;Santos;1970;345630;343476;2154
3548609;São Bento do Sapucaí;1970;9365;3187;6178
3548708;São Bernardo do Campo;1970;201662;189237;12425
3548807;São Caetano do Sul;1970;150130;150130;0
3548906;São Carlos;1970;85425;75712;9713
3549003;São Francisco;1970;6595;1273;5322
3549102;São João da Boa Vista;1970;44471;33003;11468
3549201;São João das Duas Pontes;1970;4026;1302;2724
3549300;São João do Pau d'Alho;1970;3733;951;2782
3549409;São Joaquim da Barra;1970;24359;19688;4671
3549508;São José da Bela Vista;1970;6781;3568;3213
3549607;São José do Barreiro;1970;5438;1221;4217
3549706;São José do Rio Pardo;1970;31662;16249;15413
3549805;São José do Rio Preto;1970;122134;110175;11959
3549904;São José dos Campos;1970;148332;132467;15865
3550001;São Luiz do Paraitinga;1970;11655;3092;8563
3550100;São Manuel;1970;27402;13814;13588
3550209;São Miguel Arcanjo;1970;13864;5216;8648
3550308;São Paulo;1970;5924612;5872318;52294
3550407;São Pedro;1970;10141;6144;3997
3550506;São Pedro do Turvo;1970;9455;2160;7295
3550605;São Roque;1970;37049;19129;17920
3550704;São Sebastião;1970;12016;11259;757
3550803;São Sebastião da Grama;1970;11772;3289;8483
3550902;São Simão;1970;12728;7682;5046
3551009;São Vicente;1970;116485;115889;596
3551108;Sarapuí;1970;5013;1388;3625
3551207;Sarutaiá;1970;3047;1010;2037
3551306;Sebastianópolis do Sul;1970;3002;442;2560
3551405;Serra Azul;1970;4735;2843;1892
3551504;Serrana;1970;8995;6698;2297
3551603;Serra Negra;1970;13650;6522;7128
3551702;Sertãozinho;1970;31066;22815;8251
3551801;Sete Barras;1970;9223;1785;7438
3551900;Severínia;1970;6787;2578;4209
3552007;Silveiras;1970;5442;1150;4292
3552106;Socorro;1970;20688;8271;12417
3552205;Sorocaba;1970;175677;169571;6106
3552304;Sud Mennucci;1970;8766;1246;7520
3552403;Sumaré;1970;23074;15335;7739
3552502;Suzano;1970;55460;33788;21672
3552601;Tabapuã;1970;11230;3458;7772
3552700;Tabatinga;1970;6875;2798;4077
3552809;Taboão da Serra;1970;40945;40945;0
3552908;Taciba;1970;7101;884;6217
3553005;Taguaí;1970;5618;1337;4281
3553104;Taiaçu;1970;2935;1335;1600
3553203;Taiúva;1970;4065;1894;2171
3553302;Tambaú;1970;12201;8057;4144
3553401;Tanabi;1970;20437;9461;10976
3553500;Tapiraí;1970;5265;726;4539
3553609;Tapiratiba;1970;9283;2348;6935
3553708;Taquaritinga;1970;27518;18510;9008
3553807;Taquarituba;1970;13964;6351;7613
3553906;Tarabai;1970;3599;1543;2056
3554003;Tatuí;1970;39760;31150;8610
3554102;Taubaté;1970;110585;99969;10616
3554201;Tejupá;1970;5093;333;4760
3554300;Teodoro Sampaio;1970;26114;5419;20695
3554409;Terra Roxa;1970;5818;2697;3121
3554508;Tietê;1970;17283;11102;6181
3554607;Timburi;1970;4281;926;3355
3554706;Torrinha;1970;6501;3674;2827
3554805;Tremembé;1970;11689;7297;4392
3554904;Três Fronteiras;1970;12039;2956;9083
3555000;Tupã;1970;52537;36273;16264
3555109;Tupi Paulista;1970;15720;7913;7807
3555208;Turiúba;1970;4993;1223;3770
3555307;Turmalina;1970;3713;417;3296
3555406;Ubatuba;1970;15203;9083;6120
3555505;Ubirajara;1970;4883;1437;3446
3555604;Uchoa;1970;7403;3544;3859
3555703;União Paulista;1970;1725;301;1424
3555802;Urânia;1970;16829;5159;11670
3555901;Uru;1970;1474;335;1139
3556008;Urupês;1970;10417;5088;5329
3556107;Valentim Gentil;1970;5744;2683;3061
3556206;Valinhos;1970;30775;19995;10780
3556305;Valparaíso;1970;14608;9516;5092
3556404;Vargem Grande do Sul;1970;13369;9567;3802
3556503;Várzea Paulista;1970;9894;8463;1431
3556602;Vera Cruz;1970;11699;5749;5950
3556701;Vinhedo;1970;12338;7453;4885
3556800;Viradouro;1970;8743;5695;3048
3556909;Vista Alegre do Alto;1970;2375;839;1536
3557006;Votorantim;1970;26932;22975;3957
3557105;Votuporanga;1970;39443;30327;9116
3557204;Chavantes;1970;14091;7031;7060
4100103;Abatiá;1970;15497;1760;13737
4100202;Adrianópolis;1970;11540;832;10708
4100301;Agudos do Sul;1970;5432;770;4662
4100400;Almirante Tamandaré;1970;15299;4264;11035
4100509;Altônia;1970;43042;4025;39017
4100608;Alto Paraná;1970;19593;5661;13932
4100707;Alto Piquiri;1970;40439;7219;33220
4100806;Alvorada do Sul;1970;19209;3308;15901
4100905;Amaporã;1970;4848;1633;3215
4101002;Ampére;1970;13246;2403;10843
4101101;Andirá;1970;20146;10242;9904
4101200;Antonina;1970;16448;11509;4939
4101309;Antônio Olinto;1970;7177;224;6953
4101408;Apucarana;1970;69302;43846;25456
4101507;Arapongas;1970;51210;36553;14657
4101606;Arapoti;1970;13650;1983;11667
4101705;Araruna;1970;23326;4175;19151
4101804;Araucária;1970;17117;5353;11764
4101903;Assaí;1970;29090;8590;20500
4102000;Assis Chateaubriand;1970;78600;11239;67361
4102109;Astorga;1970;25018;10729;14289
4102208;Atalaia;1970;6542;1421;5121
4102307;Balsa Nova;1970;4704;1235;3469
4102406;Bandeirantes;1970;38773;14591;24182
4102505;Barbosa Ferraz;1970;37455;5905;31550
4102604;Barracão;1970;16205;2049;14156
4102703;Barra do Jacaré;1970;6661;881;5780
4102802;Bela Vista do Paraíso;1970;18097;9172;8925
4102901;Bituruna;1970;9104;1468;7636
4103008;Boa Esperança;1970;14124;1135;12989
4103107;Bocaiúva do Sul;1970;10697;1485;9212
4103206;Bom Sucesso;1970;16045;3093;12952
4103305;Borrazópolis;1970;24137;4063;20074
4103404;Cafeara;1970;4882;1075;3807
4103503;Califórnia;1970;11562;2995;8567
4103602;Cambará;1970;25631;11154;14477
4103701;Cambé;1970;35621;13460;22161
4103800;Cambira;1970;20236;2263;17973
4103909;Campina da Lagoa;1970;38661;4905;33756
4104006;Campina Grande do Sul;1970;7891;319;7572
4104105;Campo do Tenente;1970;4411;939;3472
4104204;Campo Largo;1970;34405;15961;18444
4104303;Campo Mourão;1970;77118;27911;49207
4104402;Cândido de Abreu;1970;14547;996;13551
4104501;Capanema;1970;21717;3746;17971
4104600;Capitão Leônidas Marques;1970;23256;3454;19802
4104709;Carlópolis;1970;15569;4467;11102
4104808;Cascavel;1970;89921;34950;54971
4104907;Castro;1970;37536;13006;24530
4105003;Catanduvas;1970;25726;2187;23539
4105102;Centenário do Sul;1970;19543;5821;13722
4105201;Cerro Azul;1970;18363;1635;16728
4105300;Céu Azul;1970;23219;4175;19044
4105409;Chopinzinho;1970;27042;2376;24666
4105508;Cianorte;1970;52532;23540;28992
4105607;Cidade Gaúcha;1970;13042;3052;9990
4105706;Clevelândia;1970;13636;8225;5411
4105805;Colombo;1970;19258;1091;18167
4105904;Colorado;1970;16088;5099;10989
4106001;Congonhinhas;1970;18472;3148;15324
4106100;Conselheiro Mairinck;1970;6551;895;5656
4106209;Contenda;1970;7224;1137;6087
4106308;Corbélia;1970;39672;3014;36658
4106407;Cornélio Procópio;1970;49796;25775;24021
4106506;Coronel Vivida;1970;22413;3607;18806
4106605;Cruzeiro do Oeste;1970;37663;13164;24499
4106704;Cruzeiro do Sul;1970;8088;1415;6673
4106803;Cruz Machado;1970;13560;675;12885
4106902;Curitiba;1970;609026;584598;24428
4107009;Curiúva;1970;17724;1343;16381
4107108;Diamante do Norte;1970;7643;1874;5769
4107207;Dois Vizinhos;1970;37153;4109;33044
4107306;Doutor Camargo;1970;9223;2457;6766
4107405;Enéas Marques;1970;13882;1163;12719
4107504;Engenheiro Beltrão;1970;25239;3524;21715
4107603;Faxinal;1970;33851;4563;29288
4107702;Fênix;1970;14799;2883;11916
4107801;Floraí;1970;11022;3523;7499
4107900;Floresta;1970;8303;1285;7018
4108007;Florestópolis;1970;9774;2737;7037
4108106;Flórida;1970;2976;845;2131
4108205;Formosa do Oeste;1970;44278;3976;40302
4108304;Foz do Iguaçu;1970;33966;20064;13902
4108403;Francisco Beltrão;1970;36807;13470;23337
4108502;General Carneiro;1970;6810;786;6024
4108601;Goioerê;1970;73854;13469;60385
4108700;Grandes Rios;1970;36588;1729;34859
4108809;Guaíra;1970;32875;11261;21614
4108908;Guairaçá;1970;7922;945;6977
4109005;Guapirama;1970;5134;1409;3725
4109104;Guaporema;1970;5975;880;5095
4109203;Guaraci;1970;7678;2716;4962
4109302;Guaraniaçu;1970;28649;3430;25219
4109401;Guarapuava;1970;110903;43403;67500
4109500;Guaraqueçaba;1970;7648;1362;6286
4109609;Guaratuba;1970;9734;5736;3998
4109708;Ibaiti;1970;31537;7863;23674
4109807;Ibiporã;1970;27193;13028;14165
4109906;Icaraíma;1970;24857;4017;20840
4110003;Iguaraçu;1970;9855;1728;8127
4110102;Imbituva;1970;20332;4674;15658
4110201;Inácio Martins;1970;7647;1009;6638
4110300;Inajá;1970;4373;1466;2907
4110409;Indianópolis;1970;11612;1676;9936
4110508;Ipiranga;1970;9523;1740;7783
4110607;Iporã;1970;72115;13122;58993
4110706;Irati;1970;36471;15803;20668
4110805;Iretama;1970;15042;1706;13336
4110904;Itaguajé;1970;8563;3269;5294
4111001;Itambaracá;1970;11618;2411;9207
4111100;Itambé;1970;15044;2863;12181
4111209;Itapejara d'Oeste;1970;10075;2146;7929
4111308;Itaúna do Sul;1970;4604;1092;3512
4111407;Ivaí;1970;10107;1045;9062
4111506;Ivaiporã;1970;67598;16240;51358
4111605;Ivatuba;1970;13921;1789;12132
4111704;Jaboti;1970;5894;982;4912
4111803;Jacarezinho;1970;38741;19097;19644
4111902;Jaguapitã;1970;16710;4498;12212
4112009;Jaguariaíva;1970;15100;7304;7796
4112108;Jandaia do Sul;1970;21803;11505;10298
4112207;Janiópolis;1970;22698;1930;20768
4112306;Japira;1970;8306;837;7469
4112405;Japurá;1970;12918;2750;10168
4112504;Jardim Alegre;1970;34870;4207;30663
4112603;Jardim Olinda;1970;2415;765;1650
4112702;Jataizinho;1970;10826;4237;6589
4112801;Joaquim Távora;1970;12425;4529;7896
4112900;Jundiaí do Sul;1970;8501;1876;6625
4113007;Jussara;1970;10745;2539;8206
4113106;Kaloré;1970;13978;1762;12216
4113205;Lapa;1970;32122;10493;21629
4113304;Laranjeiras do Sul;1970;39651;6407;33244
4113403;Leópolis;1970;12021;1140;10881
4113502;Loanda;1970;19280;8506;10774
4113601;Lobato;1970;6178;1502;4676
4113700;Londrina;1970;228101;163353;64748
4113809;Lupionópolis;1970;5898;2574;3324
4113908;Mallet;1970;9950;2672;7278
4114005;Mamborê;1970;34277;4692;29585
4114104;Mandaguaçu;1970;16662;4491;12171
4114203;Mandaguari;1970;30410;11490;18920
4114302;Mandirituba;1970;11036;1346;9690
4114401;Mangueirinha;1970;15430;1140;14290
4114500;Manoel Ribas;1970;12552;705;11847
4114609;Marechal Cândido Rondon;1970;43776;7166;36610
4114708;Maria Helena;1970;41270;1806;39464
4114807;Marialva;1970;37496;9574;27922
4114906;Marilândia do Sul;1970;21949;2853;19096
4115002;Marilena;1970;6945;1264;5681
4115101;Mariluz;1970;23082;5506;17576
4115200;Maringá;1970;121374;99898;21476
4115309;Mariópolis;1970;6866;1847;5019
4115408;Marmeleiro;1970;12651;2002;10649
4115507;Marumbi;1970;12554;2227;10327
4115606;Matelândia;1970;24561;2352;22209
4115705;Matinhos;1970;4317;3155;1162
4115804;Medianeira;1970;31142;7289;23853
4115903;Mirador;1970;3130;1067;2063
4116000;Miraselva;1970;7769;1292;6477
4116109;Moreira Sales;1970;24007;5008;18999
4116208;Morretes;1970;11836;3980;7856
4116307;Munhoz de Melo;1970;7376;1360;6016
4116406;Nossa Senhora das Graças;1970;6288;1423;4865
4116505;Nova Aliança do Ivaí;1970;1945;550;1395
4116604;Nova América da Colina;1970;6891;977;5914
4116703;Nova Aurora;1970;30588;2831;27757
4116802;Nova Cantu;1970;15116;1927;13189
4116901;Nova Esperança;1970;29379;13810;15569
4117008;Nova Fátima;1970;12503;3640;8863
4117107;Nova Londrina;1970;10679;6269;4410
4117206;Nova Olímpia;1970;9475;4775;4700
4117305;Ortigueira;1970;36689;1802;34887
4117404;Ourizona;1970;8272;1645;6627
4117503;Paiçandu;1970;12093;3393;8700
4117602;Palmas;1970;25811;10017;15794
4117701;Palmeira;1970;20030;8166;11864
4117800;Palmital;1970;29420;1579;27841
4117909;Palotina;1970;43005;5214;37791
4118006;Paraíso do Norte;1970;11716;5172;6544
4118105;Paranacity;1970;11642;3023;8619
4118204;Paranaguá;1970;62327;52044;10283
4118303;Paranapoema;1970;4036;715;3321
4118402;Paranavaí;1970;57387;39232;18155
4118501;Pato Branco;1970;33808;15455;18353
4118600;Paula Freitas;1970;4695;587;4108
4118709;Paulo Frontin;1970;5312;806;4506
4118808;Peabiru;1970;24046;6681;17365
4118907;Pérola;1970;26942;3755;23187
4119004;Pérola d'Oeste;1970;15273;1496;13777
4119103;Piên;1970;5353;128;5225
4119202;Pinhalão;1970;7976;1793;6183
4119301;Pinhão;1970;20356;3194;17162
4119400;Piraí do Sul;1970;15013;7147;7866
4119509;Piraquara;1970;21253;12155;9098
4119608;Pitanga;1970;64014;5790;58224
4119707;Planaltina do Paraná;1970;8547;2378;6169
4119806;Planalto;1970;17195;2212;14983
4119905;Ponta Grossa;1970;126940;113019;13921
4120002;Porecatu;1970;22277;7216;15061
4120101;Porto Amazonas;1970;2904;2177;727
4120200;Porto Rico;1970;6192;1042;5150
4120309;Porto Vitória;1970;3104;690;2414
4120408;Presidente Castelo Branco;1970;5786;705;5081
4120507;Primeiro de Maio;1970;25738;6059;19679
4120606;Prudentópolis;1970;34314;6196;28118
4120705;Quatiguá;1970;6096;2296;3800
4120804;Quatro Barras;1970;4066;1102;2964
4120903;Quedas do Iguaçu;1970;11268;669;10599
4121000;Querência do Norte;1970;14232;2319;11913
4121109;Quinta do Sol;1970;15891;1769;14122
4121208;Quitandinha;1970;10853;1232;9621
4121307;Rancho Alegre;1970;7499;1949;5550
4121406;Realeza;1970;16737;3316;13421
4121505;Rebouças;1970;11130;3038;8092
4121604;Renascença;1970;9280;1665;7615
4121703;Reserva;1970;20917;2217;18700
4121802;Ribeirão Claro;1970;14706;4716;9990
4121901;Ribeirão do Pinhal;1970;19086;5321;13765
4122008;Rio Azul;1970;9681;1818;7863
4122107;Rio Bom;1970;10272;1583;8689
4122206;Rio Branco do Sul;1970;25133;5026;20107
4122305;Rio Negro;1970;18436;12689;5747
4122404;Rolândia;1970;47964;20859;27105
4122503;Roncador;1970;13468;1086;12382
4122602;Rondon;1970;22005;3618;18387
4122701;Sabáudia;1970;8323;1398;6925
4122800;Salgado Filho;1970;12305;904;11401
4122909;Salto do Itararé;1970;7383;1689;5694
4123006;Salto do Lontra;1970;31448;2246;29202
4123105;Santa Amélia;1970;7065;1532;5533
4123204;Santa Cecília do Pavão;1970;13313;3163;10150
4123303;Santa Cruz de Monte Castelo;1970;13180;3160;10020
4123402;Santa Fé;1970;11527;2992;8535
4123501;Santa Helena;1970;26834;2108;24726
4123600;Santa Inês;1970;4862;669;4193
4123709;Santa Isabel do Ivaí;1970;21191;5600;15591
4123808;Santa Izabel do Oeste;1970;14903;2550;12353
4123907;Santa Mariana;1970;22793;8314;14479
4124004;Santana do Itararé;1970;7525;1293;6232
4124103;Santo Antônio da Platina;1970;38627;13765;24862
4124202;Santo Antônio do Caiuá;1970;7243;2472;4771
4124301;Santo Antônio do Paraíso;1970;7132;1004;6128
4124400;Santo Antônio do Sudoeste;1970;29533;5036;24497
4124509;Santo Inácio;1970;8353;2258;6095
4124608;São Carlos do Ivaí;1970;7575;2439;5136
4124707;São Jerônimo da Serra;1970;24460;2138;22322
4124806;São João;1970;15454;1728;13726
4124905;São João do Caiuá;1970;10266;3785;6481
4125001;São João do Ivaí;1970;47762;4518;43244
4125100;São João do Triunfo;1970;10296;1159;9137
4125209;São Jorge d'Oeste;1970;12036;2565;9471
4125308;São Jorge do Ivaí;1970;17912;3220;14692
4125407;São José da Boa Vista;1970;8500;993;7507
4125506;São José dos Pinhais;1970;34124;21529;12595
4125605;São Mateus do Sul;1970;23635;6104;17531
4125704;São Miguel do Iguaçu;1970;25242;2214;23028
4125803;São Pedro do Ivaí;1970;19378;3485;15893
4125902;São Pedro do Paraná;1970;6378;761;5617
4126009;São Sebastião da Amoreira;1970;12809;1813;10996
4126108;São Tomé;1970;9298;1732;7566
4126207;Sapopema;1970;8622;786;7836
4126306;Sengés;1970;11754;1883;9871
4126405;Sertaneja;1970;14295;3575;10720
4126504;Sertanópolis;1970;21877;5922;15955
4126603;Siqueira Campos;1970;15643;6075;9568
4126702;Tamboara;1970;9793;2370;7423
4126801;Tapejara;1970;22220;3643;18577
4126900;Tapira;1970;21313;3119;18194
4127007;Teixeira Soares;1970;12879;2608;10271
4127106;Telêmaco Borba;1970;37238;22932;14306
4127205;Terra Boa;1970;19673;5360;14313
4127304;Terra Rica;1970;18004;4583;13421
4127403;Terra Roxa;1970;38237;6137;32100
4127502;Tibagi;1970;20386;3465;16921
4127601;Tijucas do Sul;1970;7848;389;7459
4127700;Toledo;1970;68885;15040;53845
4127809;Tomazina;1970;20027;2349;17678
4127908;Tuneiras do Oeste;1970;19838;2531;17307
4128005;Ubiratã;1970;39940;6564;33376
4128104;Umuarama;1970;113697;33280;80417
4128203;União da Vitória;1970;29750;22928;6822
4128302;Uniflor;1970;4169;694;3475
4128401;Uraí;1970;18401;6638;11763
4128500;Wenceslau Braz;1970;15688;6332;9356
4128609;Verê;1970;12709;1080;11629
4128708;Vitorino;1970;7622;1230;6392
4128807;Xambrê;1970;19851;1581;18270
4200101;Abelardo Luz;1970;18253;1651;16602
4200200;Agrolândia;1970;5766;973;4793
4200309;Agronômica;1970;4775;500;4275
4200408;Água Doce;1970;8563;904;7659
4200507;Águas de Chapecó;1970;6803;409;6394
4200606;Águas Mornas;1970;4675;95;4580
4200705;Alfredo Wagner;1970;9756;1705;8051
4200804;Anchieta;1970;5604;1212;4392
4200903;Angelina;1970;7555;608;6947
4201000;Anita Garibaldi;1970;18486;3075;15411
4201109;Anitápolis;1970;4623;490;4133
4201208;Antônio Carlos;1970;5624;499;5125
4201307;Araquari;1970;9374;2068;7306
4201406;Araranguá;1970;26211;12511;13700
4201505;Armazém;1970;7117;997;6120
4201604;Arroio Trinta;1970;2642;622;2020
4201703;Ascurra;1970;3970;1409;2561
4201802;Atalanta;1970;3474;554;2920
4201901;Aurora;1970;5610;268;5342
4202008;Balneário Camboriú;1970;10839;7740;3099
4202107;Barra Velha;1970;11118;3453;7665
4202206;Benedito Novo;1970;11637;1638;9999
4202305;Biguaçu;1970;15337;6230;9107
4202404;Blumenau;1970;100275;86492;13783
4202503;Bom Jardim da Serra;1970;6500;1815;4685
4202602;Bom Retiro;1970;7782;1982;5800
4202701;Botuverá;1970;3762;407;3355
4202800;Braço do Norte;1970;10540;3846;6694
4202909;Brusque;1970;35200;32376;2824
4203006;Caçador;1970;32892;18734;14158
4203105;Caibi;1970;5414;482;4932
4203204;Camboriú;1970;9862;2109;7753
4203303;Campo Alegre;1970;7133;1386;5747
4203402;Campo Belo do Sul;1970;13810;1430;12380
4203501;Campo Erê;1970;16959;1069;15890
4203600;Campos Novos;1970;43135;10107;33028
4203709;Canelinha;1970;7434;1951;5483
4203808;Canoinhas;1970;35458;16273;19185
4203907;Capinzal;1970;7791;3601;4190
4204004;Catanduvas;1970;7975;810;7165
4204103;Caxambu do Sul;1970;8584;914;7670
4204202;Chapecó;1970;49865;20452;29413
4204301;Concórdia;1970;45465;10726;34739
4204400;Coronel Freitas;1970;16185;1482;14703
4204509;Corupá;1970;8312;3431;4881
4204608;Criciúma;1970;81452;55399;26053
4204707;Cunha Porã;1970;13083;1393;11690
4204806;Curitibanos;1970;30977;18663;12314
4204905;Descanso;1970;13369;1175;12194
4205001;Dionísio Cerqueira;1970;12802;1857;10945
4205100;Dona Emma;1970;3882;164;3718
4205209;Erval Velho;1970;5774;1544;4230
4205308;Faxinal dos Guedes;1970;6594;1159;5435
4205407;Florianópolis;1970;138337;121028;17309
4205506;Fraiburgo;1970;10148;3755;6393
4205605;Galvão;1970;6609;1421;5188
4205704;Garopaba;1970;7458;1851;5607
4205803;Garuva;1970;6504;2290;4214
4205902;Gaspar;1970;18417;4445;13972
4206009;Governador Celso Ramos;1970;7521;3957;3564
4206108;Grão Pará;1970;7025;1541;5484
4206207;Gravatal;1970;8438;1018;7420
4206306;Guabiruba;1970;6279;3544;2735
4206405;Guaraciaba;1970;10046;883;9163
4206504;Guaramirim;1970;10102;2299;7803
4206603;Guarujá do Sul;1970;3837;685;3152
4206702;Herval d'Oeste;1970;13125;7054;6071
4206801;Ibicaré;1970;4642;664;3978
4206900;Ibirama;1970;21008;4186;16822
4207007;Içara;1970;17098;3357;13741
4207106;Ilhota;1970;8535;1212;7323
4207205;Imaruí;1970;21041;2981;18060
4207304;Imbituba;1970;20498;12217;8281
4207403;Imbuia;1970;2709;539;2170
4207502;Indaial;1970;22349;7126;15223
4207601;Ipira;1970;4917;697;4220
4207700;Ipumirim;1970;7403;634;6769
4207809;Irani;1970;6190;264;5926
4207908;Irineópolis;1970;8999;1464;7535
4208005;Itá;1970;7242;742;6500
4208104;Itaiópolis;1970;24102;1969;22133
4208203;Itajaí;1970;63139;54054;9085
4208302;Itapema;1970;3492;2796;696
4208401;Itapiranga;1970;20277;1859;18418
4208500;Ituporanga;1970;15134;3304;11830
4208609;Jaborá;1970;5042;464;4578
4208708;Jacinto Machado;1970;13689;1572;12117
4208807;Jaguaruna;1970;14397;3155;11242
4208906;Jaraguá do Sul;1970;30246;14747;15499
4209003;Joaçaba;1970;20794;13755;7039
4209102;Joinville;1970;126058;112131;13927
4209201;Lacerdópolis;1970;3122;831;2291
4209300;Lages;1970;128728;89754;38974
4209409;Laguna;1970;35042;17462;17580
4209508;Laurentino;1970;3981;1003;2978
4209607;Lauro Müller;1970;15574;5898;9676
4209706;Lebon Régis;1970;9187;2380;6807
4209805;Leoberto Leal;1970;4389;232;4157
4209904;Lontras;1970;7006;1686;5320
4210001;Luiz Alves;1970;7651;549;7102
4210100;Mafra;1970;36021;19918;16103
4210209;Major Gercino;1970;4554;747;3807
4210308;Major Vieira;1970;7358;303;7055
4210407;Maracajá;1970;4079;1028;3051
4210506;Maravilha;1970;17657;3630;14027
4210605;Massaranduba;1970;11874;795;11079
4210704;Matos Costa;1970;5695;1219;4476
4210803;Meleiro;1970;11306;1464;9842
4210902;Modelo;1970;12356;554;11802
4211009;Mondaí;1970;19023;2669;16354
4211108;Monte Castelo;1970;7237;1415;5822
4211207;Morro da Fumaça;1970;4758;2167;2591
4211306;Navegantes;1970;10050;5490;4560
4211405;Nova Erechim;1970;2557;487;2070
4211504;Nova Trento;1970;10035;3327;6708
4211603;Nova Veneza;1970;8135;1497;6638
4211702;Orleans;1970;15773;4442;11331
4211801;Ouro;1970;6117;1129;4988
4211900;Palhoça;1970;20652;6380;14272
4212007;Palma Sola;1970;4573;845;3728
4212106;Palmitos;1970;14165;2794;11371
4212205;Papanduva;1970;11468;2457;9011
4212304;Paulo Lopes;1970;5711;453;5258
4212403;Pedras Grandes;1970;5912;699;5213
4212502;Penha;1970;7502;5472;2030
4212601;Peritiba;1970;2652;323;2329
4212700;Petrolândia;1970;6944;758;6186
4212809;Balneário Piçarras;1970;4416;1797;2619
4212908;Pinhalzinho;1970;8044;1354;6690
4213005;Pinheiro Preto;1970;1901;379;1522
4213104;Piratuba;1970;5426;1471;3955
4213203;Pomerode;1970;12070;4137;7933
4213302;Ponte Alta;1970;5945;2249;3696
4213401;Ponte Serrada;1970;9285;1406;7879
4213500;Porto Belo;1970;7298;2643;4655
4213609;Porto União;1970;22796;14647;8149
4213708;Pouso Redondo;1970;10666;1483;9183
4213807;Praia Grande;1970;8140;1466;6674
4213906;Presidente Castello Branco;1970;1906;295;1611
4214003;Presidente Getúlio;1970;9399;2456;6943
4214102;Presidente Nereu;1970;4088;578;3510
4214201;Quilombo;1970;15914;1323;14591
4214300;Rancho Queimado;1970;2371;652;1719
4214409;Rio das Antas;1970;6245;1370;4875
4214508;Rio do Campo;1970;6078;564;5514
4214607;Rio do Oeste;1970;8440;1506;6934
4214706;Rio dos Cedros;1970;9718;1593;8125
4214805;Rio do Sul;1970;27538;21474;6064
4214904;Rio Fortuna;1970;4440;487;3953
4215000;Rio Negrinho;1970;13123;9296;3827
4215109;Rodeio;1970;7954;2144;5810
4215208;Romelândia;1970;5525;687;4838
4215307;Salete;1970;4879;1237;3642
4215406;Salto Veloso;1970;2959;865;2094
4215505;Santa Cecília;1970;14717;3290;11427
4215604;Santa Rosa de Lima;1970;1772;44;1728
4215703;Santo Amaro da Imperatriz;1970;10362;2573;7789
4215802;São Bento do Sul;1970;16656;9454;7202
4215901;São Bonifácio;1970;3403;341;3062
4216008;São Carlos;1970;10358;1878;8480
4216107;São Domingos;1970;10787;1545;9242
4216206;São Francisco do Sul;1970;19057;15519;3538
4216305;São João Batista;1970;10386;4595;5791
4216404;São João do Sul;1970;8577;1047;7530
4216503;São Joaquim;1970;26640;9071;17569
4216602;São José;1970;42535;29380;13155
4216701;São José do Cedro;1970;12500;1927;10573
4216800;São José do Cerrito;1970;15039;974;14065
4216909;São Lourenço do Oeste;1970;16753;3360;13393
4217006;São Ludgero;1970;4597;909;3688
4217105;São Martinho;1970;3470;338;3132
4217204;São Miguel do Oeste;1970;22355;7816;14539
4217303;Saudades;1970;8787;873;7914
4217402;Schroeder;1970;3364;665;2699
4217501;Seara;1970;13374;2241;11133
4217600;Siderópolis;1970;13341;4544;8797
4217709;Sombrio;1970;18049;3745;14304
4217808;Taió;1970;18711;4089;14622
4217907;Tangará;1970;13313;2933;10380
4218004;Tijucas;1970;12774;6476;6298
4218103;Timbé do Sul;1970;6300;624;5676
4218202;Timbó;1970;11829;6743;5086
4218301;Três Barras;1970;6461;1999;4462
4218400;Treze de Maio;1970;6326;499;5827
4218509;Treze Tílias;1970;3591;768;2823
4218608;Trombudo Central;1970;7331;1711;5620
4218707;Tubarão;1970;66876;51134;15742
4218806;Turvo;1970;11159;2425;8734
4218905;Urubici;1970;12539;4575;7964
4219002;Urussanga;1970;15651;4658;10993
4219101;Vargeão;1970;2317;492;1825
4219200;Vidal Ramos;1970;9271;597;8674
4219309;Videira;1970;21864;10915;10949
4219408;Witmarsum;1970;3694;258;3436
4219507;Xanxerê;1970;24859;9110;15749
4219606;Xavantina;1970;5507;436;5071
4219705;Xaxim;1970;20075;4271;15804
4300109;Agudo;1970;14186;1681;12505
4300208;Ajuricaba;1970;11649;1056;10593
4300307;Alecrim;1970;15412;473;14939
4300406;Alegrete;1970;65030;45727;19303
4300505;Alpestre;1970;13499;1156;12343
4300604;Alvorada;1970;40322;39656;666
4300703;Anta Gorda;1970;8375;525;7850
4300802;Antônio Prado;1970;14751;4453;10298
4300901;Aratiba;1970;13905;1608;12297
4301008;Arroio do Meio;1970;19515;3186;16329
4301107;Arroio dos Ratos;1970;7904;5594;2310
4301206;Arroio do Tigre;1970;16105;1199;14906
4301305;Arroio Grande;1970;18210;9175;9035
4301404;Arvorezinha;1970;14475;1743;12732
4301503;Augusto Pestana;1970;9232;1053;8179
4301602;Bagé;1970;90280;59731;30549
4301701;Barão de Cotegipe;1970;8665;1745;6920
4301800;Barracão;1970;8635;975;7660
4301909;Barra do Ribeiro;1970;9382;4668;4714
4302006;Barros Cassal;1970;15502;1280;14222
4302105;Bento Gonçalves;1970;41979;23759;18220
4302204;Boa Vista do Buricá;1970;8747;788;7959
4302303;Bom Jesus;1970;24023;7120;16903
4302402;Bom Retiro do Sul;1970;8914;2377;6537
4302501;Bossoroca;1970;7043;1119;5924
4302600;Braga;1970;6700;549;6151
4302709;Butiá;1970;21947;17676;4271
4302808;Caçapava do Sul;1970;33829;13457;20372
4302907;Cacequi;1970;18676;11754;6922
4303004;Cachoeira do Sul;1970;94261;52044;42217
4303103;Cachoeirinha;1970;31002;29955;1047
4303202;Cacique Doble;1970;6497;812;5685
4303301;Caibaté;1970;7893;684;7209
4303400;Caiçara;1970;9045;922;8123
4303509;Camaquã;1970;57288;23819;33469
4303608;Cambará do Sul;1970;8578;1734;6844
4303707;Campina das Missões;1970;7801;488;7313
4303806;Campinas do Sul;1970;10136;1648;8488
4303905;Campo Bom;1970;16617;14771;1846
4304002;Campo Novo;1970;10332;2321;8011
4304200;Candelária;1970;26559;3966;22593
4304309;Cândido Godói;1970;7690;435;7255
4304408;Canela;1970;13909;8381;5528
4304507;Canguçu;1970;62451;5154;57297
4304606;Canoas;1970;153730;149183;4547
4304705;Carazinho;1970;42504;29498;13006
4304804;Carlos Barbosa;1970;12374;3821;8553
4304903;Casca;1970;15539;1946;13593
4305009;Catuípe;1970;15594;2960;12634
4305108;Caxias do Sul;1970;144871;114015;30856
4305207;Cerro Largo;1970;18002;6032;11970
4305306;Chapada;1970;10573;1924;8649
4305405;Chiapetta;1970;4405;567;3838
4305504;Ciríaco;1970;7587;866;6721
4305603;Colorado;1970;5558;961;4597
4305702;Condor;1970;5911;729;5182
4305801;Constantina;1970;15521;1437;14084
4305900;Coronel Bicaco;1970;8437;1418;7019
4306007;Crissiumal;1970;19275;2971;16304
4306106;Cruz Alta;1970;57930;44430;13500
4306205;Cruzeiro do Sul;1970;8771;1447;7324
4306304;David Canabarro;1970;6281;165;6116
4306403;Dois Irmãos;1970;13803;2760;11043
4306502;Dom Feliciano;1970;14409;660;13749
4306601;Dom Pedrito;1970;32801;20585;12216
4306700;Dona Francisca;1970;3473;1059;2414
4306809;Encantado;1970;18605;5962;12643
4306908;Encruzilhada do Sul;1970;34548;7710;26838
4307005;Erechim;1970;48677;33916;14761
4307104;Herval;1970;7954;2195;5759
4307203;Erval Grande;1970;10512;979;9533
4307302;Erval Seco;1970;13496;1074;12422
4307401;Esmeralda;1970;8672;1795;6877
4307500;Espumoso;1970;34965;10784;24181
4307609;Estância Velha;1970;8916;7732;1184
4307708;Esteio;1970;34597;32895;1702
4307807;Estrela;1970;30752;10516;20236
4307906;Farroupilha;1970;19318;6958;12360
4308003;Faxinal do Soturno;1970;9058;2645;6413
4308102;Feliz;1970;12727;1524;11203
4308201;Flores da Cunha;1970;14626;3782;10844
4308300;Fontoura Xavier;1970;15312;677;14635
4308409;Formigueiro;1970;9706;970;8736
4308508;Frederico Westphalen;1970;25567;9230;16337
4308607;Garibaldi;1970;20812;8053;12759
4308706;Gaurama;1970;14787;3118;11669
4308805;General Câmara;1970;13242;4380;8862
4308904;Getúlio Vargas;1970;27189;8409;18780
4309001;Giruá;1970;25425;5032;20393
4309100;Gramado;1970;12378;4467;7911
4309209;Gravataí;1970;52462;36237;16225
4309308;Guaíba;1970;33680;20153;13527
4309407;Guaporé;1970;25227;8367;16860
4309506;Guarani das Missões;1970;10416;2327;8089
4309605;Horizontina;1970;20996;4568;16428
4309704;Humaitá;1970;11262;1722;9540
4309803;Ibiaçá;1970;7323;1122;6201
4309902;Ibiraiaras;1970;8495;734;7761
4310009;Ibirubá;1970;19339;6179;13160
4310108;Igrejinha;1970;7062;2970;4092
4310207;Ijuí;1970;52738;31806;20932
4310306;Ilópolis;1970;3424;724;2700
4310405;Independência;1970;9046;757;8289
4310504;Iraí;1970;13012;4967;8045
4310603;Itaqui;1970;28402;17971;10431
4310702;Itatiba do Sul;1970;8069;1054;7015
4310801;Ivoti;1970;7070;1965;5105
4310900;Jacutinga;1970;6999;771;6228
4311007;Jaguarão;1970;22451;16662;5789
4311106;Jaguari;1970;17825;5230;12595
4311205;Júlio de Castilhos;1970;24539;10418;14121
4311304;Lagoa Vermelha;1970;28791;13423;15368
4311403;Lajeado;1970;56992;18090;38902
4311502;Lavras do Sul;1970;11494;4159;7335
4311601;Liberato Salzano;1970;10149;525;9624
4311700;Machadinho;1970;10044;1507;8537
4311809;Marau;1970;26418;4844;21574
4311908;Marcelino Ramos;1970;8828;3073;5755
4312005;Mariano Moro;1970;4142;486;3656
4312104;Mata;1970;7347;1613;5734
4312203;Maximiliano de Almeida;1970;7044;1587;5457
4312302;Miraguaí;1970;8400;1393;7007
4312401;Montenegro;1970;46676;23744;22932
4312500;Mostardas;1970;14290;1564;12726
4312609;Muçum;1970;7923;2188;5735
4312658;Não-Me-Toque;1970;10968;4032;6936
4312708;Nonoai;1970;29757;2851;26906
4312807;Nova Araçá;1970;2296;471;1825
4312906;Nova Bassano;1970;6381;971;5410
4313003;Nova Bréscia;1970;9360;1116;8244
4313102;Nova Palma;1970;7995;1019;6976
4313201;Nova Petrópolis;1970;13223;2794;10429
4313300;Nova Prata;1970;20818;6679;14139
4313409;Novo Hamburgo;1970;85364;81235;4129
4313508;Osório;1970;55569;18617;36952
4313607;Paim Filho;1970;10692;1816;8876
4313706;Palmeira das Missões;1970;58658;15967;42691
4313805;Palmitinho;1970;13247;624;12623
4313904;Panambi;1970;16193;7266;8927
4314001;Paraí;1970;4167;592;3575
4314100;Passo Fundo;1970;93850;70737;23113
4314209;Pedro Osório;1970;16261;8171;8090
4314308;Pejuçara;1970;3418;579;2839
4314407;Pelotas;1970;207869;154742;53127
4314506;Pinheiro Machado;1970;14260;4372;9888
4314605;Piratini;1970;24444;2902;21542
4314704;Planalto;1970;17584;2736;14848
4314803;Portão;1970;7501;4509;2992
4314902;Porto Alegre;1970;885545;869730;15815
4315008;Porto Lucena;1970;13007;1627;11380
4315107;Porto Xavier;1970;12406;1256;11150
4315206;Putinga;1970;6841;615;6226
4315305;Quaraí;1970;19741;13366;6375
4315404;Redentora;1970;11543;1052;10491
4315503;Restinga Sêca;1970;15795;2239;13556
4315602;Rio Grande;1970;116488;103896;12592
4315701;Rio Pardo;1970;53699;20013;33686
4315800;Roca Sales;1970;10706;2000;8706
4315909;Rodeio Bonito;1970;13830;1332;12498
4316006;Rolante;1970;14866;2481;12385
4316105;Ronda Alta;1970;16028;1497;14531
4316204;Rondinha;1970;8308;719;7589
4316303;Roque Gonzales;1970;10589;843;9746
4316402;Rosário do Sul;1970;37788;24477;13311
4316501;Salvador do Sul;1970;15213;1174;14039
4316600;Sananduva;1970;13299;4798;8501
4316709;Santa Bárbara do Sul;1970;9191;3146;6045
4316808;Santa Cruz do Sul;1970;86787;32967;53820
4316907;Santa Maria;1970;156609;124716;31893
4317004;Santana da Boa Vista;1970;11643;1226;10417
4317103;Sant'Ana do Livramento;1970;63388;49099;14289
4317202;Santa Rosa;1970;39550;23726;15824
4317301;Santa Vitória do Palmar;1970;23458;11768;11690
4317400;Santiago;1970;41054;23323;17731
4317509;Santo Ângelo;1970;80754;39114;41640
4317608;Santo Antônio da Patrulha;1970;53626;15705;37921
4317707;Santo Antônio das Missões;1970;11589;2294;9295
4317806;Santo Augusto;1970;14812;3531;11281
4317905;Santo Cristo;1970;15076;1919;13157
4318002;São Borja;1970;52392;29516;22876
4318101;São Francisco de Assis;1970;27422;8998;18424
4318200;São Francisco de Paula;1970;31805;7074;24731
4318309;São Gabriel;1970;51934;28458;23476
4318408;São Jerônimo;1970;38279;17323;20956
4318507;São José do Norte;1970;18824;4669;14155
4318606;São José do Ouro;1970;14304;2359;11945
4318705;São Leopoldo;1970;64433;62990;1443
4318804;São Lourenço do Sul;1970;39886;9892;29994
4318903;São Luiz Gonzaga;1970;41061;18609;22452
4319000;São Marcos;1970;9169;4379;4790
4319109;São Martinho;1970;8763;864;7899
4319208;São Nicolau;1970;10961;1124;9837
4319307;São Paulo das Missões;1970;9354;716;8638
4319406;São Pedro do Sul;1970;21815;6019;15796
4319505;São Sebastião do Caí;1970;25252;8267;16985
4319604;São Sepé;1970;26674;8621;18053
4319703;São Valentim;1970;20216;3388;16828
4319802;São Vicente do Sul;1970;7976;2277;5699
4319901;Sapiranga;1970;16402;11336;5066
4320008;Sapucaia do Sul;1970;41742;41116;626
4320107;Sarandi;1970;17957;6412;11545
4320206;Seberi;1970;14326;2267;12059
4320305;Selbach;1970;4509;504;4005
4320404;Serafina Corrêa;1970;8065;1938;6127
4320503;Sertão;1970;10041;1796;8245
4320602;Severiano de Almeida;1970;5255;433;4822
4320701;Sobradinho;1970;28250;6570;21680
4320800;Soledade;1970;46443;9831;36612
4320909;Tapejara;1970;22566;5123;17443
4321006;Tapera;1970;8618;3356;5262
4321105;Tapes;1970;25334;6749;18585
4321204;Taquara;1970;31167;18270;12897
4321303;Taquari;1970;26786;9212;17574
4321402;Tenente Portela;1970;34227;5507;28720
4321501;Torres;1970;41129;8280;32849
4321600;Tramandaí;1970;12353;8654;3699
4321709;Três Coroas;1970;6370;2392;3978
4321808;Três de Maio;1970;31363;8452;22911
4321907;Três Passos;1970;43228;9921;33307
4322004;Triunfo;1970;14608;5916;8692
4322103;Tucunduva;1970;15289;2329;12960
4322202;Tupanciretã;1970;24835;10848;13987
4322301;Tuparendi;1970;14639;2279;12360
4322400;Uruguaiana;1970;74613;63346;11267
4322509;Vacaria;1970;57107;28034;29073
4322608;Venâncio Aires;1970;43734;11218;32516
4322707;Vera Cruz;1970;11527;2657;8870
4322806;Veranópolis;1970;23399;7161;16238
4322905;Viadutos;1970;9609;1612;7997
4323002;Viamão;1970;66443;11425;55018
4323101;Vicente Dutra;1970;9812;1240;8572
4323200;Victor Graeff;1970;4955;511;4444
5000203;Água Clara;1970;3187;646;2541
5000609;Amambai;1970;22667;5929;16738
5000708;Anastácio;1970;15371;5157;10214
5000807;Anaurilândia;1970;6029;1043;4986
5000906;Antônio João;1970;5080;1570;3510
5001003;Aparecida do Taboado;1970;14701;6440;8261
5001102;Aquidauana;1970;28725;17956;10769
5001508;Bandeirantes;1970;5690;1171;4519
5001904;Bataguassu;1970;9656;2323;7333
5002001;Batayporã;1970;14930;1896;13034
5002100;Bela Vista;1970;15028;10549;4479
5002209;Bonito;1970;7913;1566;6347
5002308;Brasilândia;1970;10400;1608;8792
5002407;Caarapó;1970;26007;5341;20666
5002605;Camapuã;1970;15829;3737;12092
5002704;Campo Grande;1970;140233;131138;9095
5002803;Caracol;1970;4025;554;3471
5002902;Cassilândia;1970;12476;6164;6312
5003108;Corguinho;1970;3791;556;3235
5003207;Corumbá;1970;81887;51199;30688
5003306;Coxim;1970;18537;4102;14435
5003702;Dourados;1970;79186;31625;47561
5003801;Fátima do Sul;1970;40913;9236;31677
5004007;Glória de Dourados;1970;41072;6421;34651
5004106;Guia Lopes da Laguna;1970;5733;3325;2408
5004304;Iguatemi;1970;25456;5380;20076
5004403;Inocência;1970;6040;921;5119
5004502;Itaporã;1970;20283;5534;14749
5004700;Ivinhema;1970;14093;2260;11833
5004908;Jaraguari;1970;4508;583;3925
5005004;Jardim;1970;10460;7052;3408
5005103;Jateí;1970;12115;587;11528
5005202;Ladário;1970;7750;6000;1750
5005400;Maracaju;1970;7319;3672;3647
5005608;Miranda;1970;18634;4212;14422
5005707;Naviraí;1970;23117;7661;15456
5005806;Nioaque;1970;7118;3007;4111
5006200;Nova Andradina;1970;12625;6845;5780
5006309;Paranaíba;1970;31038;8526;22512
5006408;Pedro Gomes;1970;9145;2370;6775
5006606;Ponta Porã;1970;33798;14305;19493
5006903;Porto Murtinho;1970;11627;4826;6801
5007109;Ribas do Rio Pardo;1970;3530;1082;2448
5007208;Rio Brilhante;1970;10269;4029;6240
5007307;Rio Negro;1970;8089;1518;6571
5007406;Rio Verde de Mato Grosso;1970;14132;4534;9598
5007505;Rochedo;1970;4642;322;4320
5007901;Sidrolândia;1970;9589;2876;6713
5008008;Terenos;1970;8204;1318;6886
5008305;Três Lagoas;1970;55513;41020;14493
5100102;Acorizal;1970;8854;1802;7052
5100300;Alto Araguaia;1970;7547;3403;4144
5100409;Alto Garças;1970;5890;3373;2517
5100508;Alto Paraguai;1970;11353;4250;7103
5101209;Araguainha;1970;1718;964;754
5101308;Arenápolis;1970;10486;3633;6853
5101407;Aripuanã;1970;2235;85;2150
5101605;Barão de Melgaço;1970;9719;1417;8302
5101704;Barra do Bugres;1970;22250;2068;20182
5101803;Barra do Garças;1970;26570;10116;16454
5102504;Cáceres;1970;85699;16791;68908
5103007;Chapada dos Guimarães;1970;16356;1545;14811
5103403;Cuiabá;1970;100860;88361;12499
5103502;Diamantino;1970;5076;1298;3778
5103601;Dom Aquino;1970;16383;4282;12101
5103908;General Carneiro;1970;3498;973;2525
5104203;Guiratinga;1970;14939;6475;8464
5104609;Itiquira;1970;3621;1135;2486
5104807;Jaciara;1970;32132;5214;26918
5105309;Luciara;1970;5008;1359;3649
5105507;Vila Bela da Santíssima Trindade;1970;9576;792;8784
5105903;Nobres;1970;5692;1645;4047
5106000;Nortelândia;1970;5938;3886;2052
5106109;Nossa Senhora do Livramento;1970;11768;1083;10685
5106505;Poconé;1970;18832;8193;10639
5106703;Ponte Branca;1970;3438;1223;2215
5106802;Porto dos Gaúchos;1970;1192;140;1052
5107008;Poxoréu;1970;27431;7343;20088
5107602;Rondonópolis;1970;62086;25126;36960
5107701;Rosário Oeste;1970;18044;3935;14109
5107800;Santo Antônio do Leverger;1970;14509;2549;11960
5108105;Tesouro;1970;5796;2689;3107
5108204;Torixoréu;1970;6300;1109;5191
5108402;Várzea Grande;1970;18053;13908;4145
5200100;Abadiânia;1970;7772;1423;6349
5200209;Água Limpa;1970;2627;680;1947
5200308;Alexânia;1970;9390;2642;6748
5200506;Aloândia;1970;3022;1174;1848
5200605;Alto Paraíso de Goiás;1970;2775;441;2334
5200803;Alvorada do Norte;1970;4113;2313;1800
5200902;Amorinópolis;1970;6607;2215;4392
5201108;Anápolis;1970;105029;90747;14282
5201207;Anhanguera;1970;1079;950;129
5201306;Anicuns;1970;22733;7599;15134
5201405;Aparecida de Goiânia;1970;7470;880;6590
5201504;Aporé;1970;3174;336;2838
5201603;Araçu;1970;4845;1792;3053
5201702;Aragarças;1970;4636;3760;876
5201801;Aragoiânia;1970;2848;941;1907
5202502;Aruanã;1970;4778;726;4052
5202601;Aurilândia;1970;6780;2830;3950
5202809;Avelinópolis;1970;2928;674;2254
5203104;Baliza;1970;2578;706;1872
5203203;Barro Alto;1970;7236;1325;5911
5203302;Bela Vista de Goiás;1970;14298;3685;10613
5203401;Bom Jardim de Goiás;1970;4257;1263;2994
5203500;Bom Jesus de Goiás;1970;10699;1930;8769
5203609;Brazabrantes;1970;3132;625;2507
5203807;Britânia;1970;2239;1234;1005
5203906;Buriti Alegre;1970;10471;6138;4333
5204003;Cabeceiras;1970;4056;784;3272
5204102;Cachoeira Alta;1970;11159;2913;8246
5204201;Cachoeira de Goiás;1970;1762;480;1282
5204300;Caçu;1970;9885;2529;7356
5204409;Caiapônia;1970;21522;4250;17272
5204508;Caldas Novas;1970;8630;2665;5965
5204607;Campestre de Goiás;1970;2724;585;2139
5204706;Campinorte;1970;5158;2378;2780
5204805;Campo Alegre de Goiás;1970;4457;607;3850
5204904;Campos Belos;1970;5886;2126;3760
5205000;Carmo do Rio Verde;1970;14264;3046;11218
5205109;Catalão;1970;27338;15407;11931
5205208;Caturaí;1970;4669;1076;3593
5205307;Cavalcante;1970;8258;976;7282
5205406;Ceres;1970;39510;11518;27992
5205703;Córrego do Ouro;1970;6011;1169;4842
5205802;Corumbá de Goiás;1970;18439;1642;16797
5205901;Corumbaíba;1970;7488;2416;5072
5206206;Cristalina;1970;11600;5612;5988
5206305;Cristianópolis;1970;1692;958;734
5206404;Crixás;1970;18304;1570;16734
5206503;Cromínia;1970;4277;1605;2672
5206602;Cumari;1970;4977;2327;2650
5206701;Damianópolis;1970;3667;430;3237
5206800;Damolândia;1970;3641;1557;2084
5206909;Davinópolis;1970;3205;531;2674
5207105;Diorama;1970;4948;1253;3695
5207402;Edéia;1970;10039;2643;7396
5207501;Estrela do Norte;1970;2836;1652;1184
5207600;Fazenda Nova;1970;9713;2979;6734
5207808;Firminópolis;1970;11375;5044;6331
5207907;Flores de Goiás;1970;2274;360;1914
5208004;Formosa;1970;28874;12859;16015
5208103;Formoso;1970;13055;1673;11382
5208301;Divinópolis de Goiás;1970;3141;739;2402
5208400;Goianápolis;1970;7340;1822;5518
5208509;Goiandira;1970;6033;3592;2441
5208608;Goianésia;1970;40769;14248;26521
5208707;Goiânia;1970;380773;363006;17767
5208806;Goianira;1970;6091;1496;4595
5208905;Goiás;1970;43242;13380;29862
5209101;Goiatuba;1970;24579;12632;11947
5209200;Guapó;1970;8804;3565;5239
5209408;Guarani de Goiás;1970;3504;497;3007
5209606;Heitoraí;1970;4715;1531;3184
5209705;Hidrolândia;1970;8014;2118;5896
5209804;Hidrolina;1970;6469;1778;4691
5209903;Iaciara;1970;3458;992;2466
5210000;Inhumas;1970;30144;16480;13664
5210109;Ipameri;1970;20518;12187;8331
5210208;Iporá;1970;17199;9766;7433
5210307;Israelândia;1970;6436;2224;4212
5210406;Itaberaí;1970;25371;8030;17341
5210604;Itaguaru;1970;7024;2935;4089
5210802;Itajá;1970;6700;1480;5220
5210901;Itapaci;1970;14093;4003;10090
5211008;Itapirapuã;1970;12641;4135;8506
5211206;Itapuranga;1970;30086;9227;20859
5211305;Itarumã;1970;6206;473;5733
5211404;Itauçu;1970;11855;4604;7251
5211503;Itumbiara;1970;64162;33867;30295
5211602;Ivolândia;1970;5895;872;5023
5211701;Jandaia;1970;9911;1909;8002
5211800;Jaraguá;1970;42130;10425;31705
5211909;Jataí;1970;41364;27155;14209
5212006;Jaupaci;1970;3696;1099;2597
5212105;Joviânia;1970;6768;2181;4587
5212204;Jussara;1970;20950;7581;13369
5212303;Leopoldo de Bulhões;1970;9109;3465;5644
5212501;Luziânia;1970;32807;9604;23203
5212600;Mairipotaba;1970;3375;784;2591
5212709;Mambaí;1970;4514;742;3772
5212808;Mara Rosa;1970;20047;1972;18075
5212907;Marzagão;1970;1044;692;352
5213004;Maurilândia;1970;5732;2637;3095
5213103;Mineiros;1970;15182;9865;5317
5213400;Moiporá;1970;4948;1417;3531
5213509;Monte Alegre de Goiás;1970;5295;675;4620
5213707;Montes Claros de Goiás;1970;7802;1074;6728
5213806;Morrinhos;1970;31672;14063;17609
5213905;Mossâmedes;1970;12771;2443;10328
5214002;Mozarlândia;1970;7393;2943;4450
5214101;Mutunópolis;1970;4347;1267;3080
5214408;Nazário;1970;6150;3219;2931
5214507;Nerópolis;1970;7735;4248;3487
5214606;Niquelândia;1970;23736;2830;20906
5214705;Nova América;1970;3339;682;2657
5214804;Nova Aurora;1970;2166;1063;1103
5214903;Nova Roma;1970;3318;610;2708
5215009;Nova Veneza;1970;5733;2693;3040
5215207;Novo Brasil;1970;6799;1145;5654
5215306;Orizona;1970;13546;2816;10730
5215405;Ouro Verde de Goiás;1970;5701;1866;3835
5215504;Ouvidor;1970;3928;727;3201
5215603;Padre Bernardo;1970;8381;1771;6610
5215702;Palmeiras de Goiás;1970;24042;5902;18140
5215801;Palmelo;1970;1506;1267;239
5215900;Palminópolis;1970;5248;1241;4007
5216007;Panamá;1970;3939;921;3018
5216304;Paranaiguara;1970;9499;3765;5734
5216403;Paraúna;1970;18545;3044;15501
5216809;Petrolina de Goiás;1970;14919;3811;11108
5216908;Pilar de Goiás;1970;10217;514;9703
5217104;Piracanjuba;1970;22842;6153;16689
5217203;Piranhas;1970;11441;2950;8491
5217302;Pirenópolis;1970;32065;4982;27083
5217401;Pires do Rio;1970;18423;13329;5094
5217609;Planaltina;1970;8972;582;8390
5217708;Pontalina;1970;19314;5464;13850
5218003;Porangatu;1970;25874;9850;16024
5218102;Portelândia;1970;1827;979;848
5218300;Posse;1970;13286;2205;11081
5218508;Quirinópolis;1970;37917;12758;25159
5218607;Rialma;1970;6011;4814;1197
5218706;Rianápolis;1970;3070;1706;1364
5218805;Rio Verde;1970;55697;26927;28770
5218904;Rubiataba;1970;23199;9308;13891
5219001;Sanclerlândia;1970;8478;2444;6034
5219100;Santa Bárbara de Goiás;1970;2748;923;1825
5219209;Santa Cruz de Goiás;1970;3594;557;3037
5219308;Santa Helena de Goiás;1970;25481;10304;15177
5219407;Santa Rita do Araguaia;1970;2309;1236;1073
5219506;Santa Rosa de Goiás;1970;4688;2015;2673
5219605;Santa Tereza de Goiás;1970;3804;1470;2334
5219704;Santa Terezinha de Goiás;1970;8644;1257;7387
5219803;São Domingos;1970;7941;952;6989
5219902;São Francisco de Goiás;1970;8299;1159;7140
5220009;São João d'Aliança;1970;3489;613;2876
5220108;São Luís de Montes Belos;1970;25246;10490;14756
5220207;São Miguel do Araguaia;1970;18759;7576;11183
5220405;São Simão;1970;7208;2381;4827
5220504;Serranópolis;1970;5179;983;4196
5220603;Silvânia;1970;20523;3599;16924
5220702;Sítio d'Abadia;1970;2724;349;2375
5221007;Taquaral de Goiás;1970;11797;2187;9610
5221304;Três Ranchos;1970;3248;1080;2168
5221403;Trindade;1970;22519;13755;8764
5221502;Turvânia;1970;6671;1930;4741
5221601;Uruaçu;1970;36304;9918;26386
5221700;Uruana;1970;14037;6270;7767
5221809;Urutaí;1970;4003;1563;2440
5221908;Varjão;1970;4727;1452;3275
5222005;Vianópolis;1970;6757;2575;4182
5300108;Brasília;1970;537492;516007;21485
1100023;Ariquemes;1980;53365;19670;33695
1100049;Cacoal;1980;67030;13601;53429
1100106;Guajará-Mirim;1980;34751;21957;12794
1100122;Ji-Paraná;1980;121714;39557;82157
1100189;Pimenta Bueno;1980;29993;10964;19029
1100205;Porto Velho;1980;133882;102593;31289
1100304;Vilhena;1980;50290;19826;30464
1200054;Assis Brasil;1980;1367;327;1040
1200104;Brasiléia;1980;13907;4841;9066
1200203;Cruzeiro do Sul;1980;50472;11547;38925
1200302;Feijó;1980;19569;4252;15317
1200336;Mâncio Lima;1980;7374;1411;5963
1200344;Manoel Urbano;1980;5936;650;5286
1200385;Plácido de Castro;1980;9253;1631;7622
1200401;Rio Branco;1980;117101;87577;29524
1200450;Senador Guiomard;1980;9707;3016;6691
1200500;Sena Madureira;1980;23541;6641;16900
1200609;Tarauacá;1980;28362;6920;21442
1200708;Xapuri;1980;14687;3117;11570
1300102;Anori;1980;15011;3826;11185
1300201;Atalaia do Norte;1980;6670;1261;5409
1300300;Autazes;1980;16061;3041;13020
1300409;Barcelos;1980;9088;2012;7076
1300508;Barreirinha;1980;15394;3102;12292
1300607;Benjamin Constant;1980;24645;6540;18105
1300706;Boca do Acre;1980;21829;7073;14756
1300805;Borba;1980;23568;6928;16640
1300904;Canutama;1980;6390;1807;4583
1301001;Carauari;1980;20028;5515;14513
1301100;Careiro;1980;34973;1371;33602
1301209;Coari;1980;42609;14805;27804
1301308;Codajás;1980;10820;4928;5892
1301407;Eirunepé;1980;14770;8123;6647
1301506;Envira;1980;14702;1385;13317
1301605;Fonte Boa;1980;13515;3256;10259
1301704;Humaitá;1980;24318;9853;14465
1301803;Ipixuna;1980;18744;852;17892
1301902;Itacoatiara;1980;52882;26996;25886
1302009;Itapiranga;1980;5608;2273;3335
1302108;Japurá;1980;2096;317;1779
1302207;Juruá;1980;6952;621;6331
1302306;Jutaí;1980;9336;2970;6366
1302405;Lábrea;1980;22026;8251;13775
1302504;Manacapuru;1980;61018;18230;42788
1302603;Manaus;1980;633383;611843;21540
1302702;Manicoré;1980;30062;9369;20693
1302801;Maraã;1980;9988;1046;8942
1302900;Maués;1980;30022;10807;19215
1303007;Nhamundá;1980;13596;1872;11724
1303106;Nova Olinda do Norte;1980;13210;3944;9266
1303205;Novo Airão;1980;3672;1188;2484
1303304;Novo Aripuanã;1980;10160;2473;7687
1303403;Parintins;1980;51381;29504;21877
1303502;Pauini;1980;9448;1251;8197
1303601;Santa Isabel do Rio Negro;1980;4981;1034;3947
1303700;Santo Antônio do Içá;1980;15061;3486;11575
1303809;São Gabriel da Cachoeira;1980;19578;3897;15681
1303908;São Paulo de Olivença;1980;19388;4313;15075
1304005;Silves;1980;6490;1099;5391
1304104;Tapauá;1980;16710;2142;14568
1304203;Tefé;1980;30736;15797;14939
1304302;Urucará;1980;8761;3458;5303
1304401;Urucurituba;1980;10848;2857;7991
1400100;Boa Vista;1980;67017;43854;23163
1400209;Caracaraí;1980;12104;4884;7220
1500107;Abaetetuba;1980;74541;33748;40793
1500206;Acará;1980;35264;3425;31839
1500305;Afuá;1980;23335;2209;21126
1500404;Alenquer;1980;44535;17753;26782
1500503;Almeirim;1980;33077;4827;28250
1500602;Altamira;1980;46496;26905;19591
1500701;Anajás;1980;11788;777;11011
1500800;Ananindeua;1980;65878;6850;59028
1500909;Augusto Corrêa;1980;26404;5944;20460
1501006;Aveiro;1980;12749;1854;10895
1501105;Bagre;1980;8304;1442;6862
1501204;Baião;1980;16258;4086;12172
1501303;Barcarena;1980;20015;6711;13304
1501402;Belém;1980;933280;824405;108875
1501501;Benevides;1980;22315;6658;15657
1501600;Bonito;1980;8488;1221;7267
1501709;Bragança;1980;85086;35949;49137
1501808;Breves;1980;55739;15783;39956
1501907;Bujaru;1980;25992;2616;23376
1502004;Cachoeira do Arari;1980;11402;4468;6934
1502103;Cametá;1980;79320;21270;58050
1502202;Capanema;1980;40102;29541;10561
1502301;Capitão Poço;1980;32774;9600;23174
1502400;Castanhal;1980;65246;53317;11929
1502509;Chaves;1980;15436;542;14894
1502608;Colares;1980;7094;1814;5280
1502707;Conceição do Araguaia;1980;111332;33189;78143
1502806;Curralinho;1980;12688;2150;10538
1502905;Curuçá;1980;24403;9622;14781
1503002;Faro;1980;12598;6581;6017
1503101;Gurupá;1980;15583;2325;13258
1503200;Igarapé-Açu;1980;23005;9520;13485
1503309;Igarapé-Miri;1980;39270;14202;25068
1503408;Inhangapi;1980;7333;615;6718
1503507;Irituia;1980;44964;2096;42868
1503606;Itaituba;1980;38573;20927;17646
1503705;Itupiranga;1980;15651;2804;12847
1503804;Jacundá;1980;14860;286;14574
1503903;Juruti;1980;22602;5048;17554
1504000;Limoeiro do Ajuru;1980;13756;1568;12188
1504109;Magalhães Barata;1980;5996;2598;3398
1504208;Marabá;1980;59881;41752;18129
1504307;Maracanã;1980;21116;8673;12443
1504406;Marapanim;1980;17721;7089;10632
1504505;Melgaço;1980;10632;947;9685
1504604;Mocajuba;1980;12801;5521;7280
1504703;Moju;1980;28644;3532;25112
1504802;Monte Alegre;1980;37904;10673;27231
1504901;Muaná;1980;18704;2339;16365
1505007;Nova Timboteua;1980;9969;3351;6618
1505106;Óbidos;1980;38009;17666;20343
1505205;Oeiras do Pará;1980;12469;2694;9775
1505304;Oriximiná;1980;29593;11995;17598
1505403;Ourém;1980;38359;4352;34007
1505502;Paragominas;1980;48112;12357;35755
1505601;Peixe-Boi;1980;7256;2152;5104
1505700;Ponta de Pedras;1980;12874;2908;9966
1505809;Portel;1980;43158;7598;35560
1505908;Porto de Moz;1980;11805;2599;9206
1506005;Prainha;1980;45354;3348;42006
1506104;Primavera;1980;26479;10422;16057
1506203;Salinópolis;1980;14349;10317;4032
1506302;Salvaterra;1980;10008;5326;4682
1506401;Santa Cruz do Arari;1980;4706;1100;3606
1506500;Santa Izabel do Pará;1980;24044;14214;9830
1506609;Santa Maria do Pará;1980;14345;5255;9090
1506708;Santana do Araguaia;1980;12605;2639;9966
1506807;Santarém;1980;191945;111493;80452
1506906;Santarém Novo;1980;4772;1052;3720
1507003;Santo Antônio do Tauá;1980;11460;4380;7080
1507102;São Caetano de Odivelas;1980;20926;8738;12188
1507201;São Domingos do Capim;1980;63548;13167;50381
1507300;São Félix do Xingu;1980;4954;1763;3191
1507409;São Francisco do Pará;1980;10522;2778;7744
1507508;São João do Araguaia;1980;35774;1313;34461
1507607;São Miguel do Guamá;1980;26675;10368;16307
1507706;São Sebastião da Boa Vista;1980;12617;3135;9482
1507805;Senador José Porfírio;1980;6391;808;5583
1507904;Soure;1980;16055;11578;4477
1508001;Tomé-Açu;1980;40473;5016;35457
1508100;Tucuruí;1980;61123;27308;33815
1508209;Vigia;1980;24825;16684;8141
1508308;Viseu;1980;57009;9347;47662
1600105;Amapá;1980;9499;3546;5953
1600204;Calçoene;1980;2846;2078;768
1600303;Macapá;1980;137452;93063;44389
1600402;Mazagão;1980;20433;2517;17916
1600501;Oiapoque;1980;5028;2515;2513
1700400;Almas;1980;7860;1406;6454
1700707;Alvorada;1980;7486;4593;2893
1701002;Ananás;1980;8196;2892;5304
1701903;Araguacema;1980;14974;2385;12589
1702000;Araguaçu;1980;13734;4318;9416
1702109;Araguaína;1980;72063;47956;24107
1702208;Araguatins;1980;18220;7724;10496
1702307;Arapoema;1980;15848;2668;13180
1702406;Arraias;1980;15749;4152;11597
1702703;Aurora do Tocantins;1980;4560;1378;3182
1702901;Axixá do Tocantins;1980;8133;3867;4266
1703008;Babaçulândia;1980;15928;5395;10533
1703701;Brejinho de Nazaré;1980;10825;3853;6972
1705508;Colinas do Tocantins;1980;18174;14125;4049
1705607;Conceição do Tocantins;1980;4123;902;3221
1706001;Couto Magalhães;1980;5153;1226;3927
1706100;Cristalândia;1980;11762;4159;7603
1707009;Dianópolis;1980;10795;5197;5598
1707207;Dois Irmãos do Tocantins;1980;8088;1657;6431
1707306;Dueré;1980;4777;1442;3335
1707702;Filadélfia;1980;18974;6089;12885
1708205;Formoso do Araguaia;1980;11529;3603;7926
1709005;Goiatins;1980;14980;1693;13287
1709302;Guaraí;1980;17801;9303;8498
1709500;Gurupi;1980;38653;30903;7750
1710508;Itacajá;1980;13940;2676;11264
1710706;Itaguatins;1980;14123;945;13178
1711100;Itaporã do Tocantins;1980;4361;1343;3018
1712405;Lizarda;1980;9511;523;8988
1713205;Miracema do Tocantins;1980;25308;9084;16224
1713304;Miranorte;1980;11214;7522;3692
1713601;Monte do Carmo;1980;5829;836;4993
1714203;Natividade;1980;15852;3777;12075
1714302;Nazaré;1980;8521;1311;7210
1715101;Novo Acordo;1980;6110;1499;4611
1716109;Paraíso do Tocantins;1980;20702;15003;5699
1716208;Paranã;1980;18099;4729;13370
1716505;Pedro Afonso;1980;10021;3767;6254
1716604;Peixe;1980;22142;5061;17081
1716703;Colméia;1980;17362;5903;11459
1717008;Pindorama do Tocantins;1980;3946;918;3028
1717503;Pium;1980;7098;1545;5553
1717800;Ponte Alta do Bom Jesus;1980;5663;1180;4483
1717909;Ponte Alta do Tocantins;1980;7987;1575;6412
1718204;Porto Nacional;1980;39327;20664;18663
1718402;Presidente Kennedy;1980;11306;1933;9373
1720309;São Sebastião do Tocantins;1980;17955;4453;13502
1720804;Sítio Novo do Tocantins;1980;7017;2477;4540
1720903;Taguatinga;1980;10063;2979;7084
1721109;Tocantínia;1980;7554;2248;5306
1721208;Tocantinópolis;1980;27976;9131;18845
1722107;Xambioá;1980;11677;7207;4470
2100105;Afonso Cunha;1980;3422;586;2836
2100204;Alcântara;1980;18509;2146;16363
2100303;Aldeias Altas;1980;18994;1582;17412
2100402;Altamira do Maranhão;1980;24722;1974;22748
2100501;Alto Parnaíba;1980;7731;2229;5502
2100600;Amarante do Maranhão;1980;17009;2870;14139
2100709;Anajatuba;1980;19200;3061;16139
2100808;Anapurus;1980;8554;1515;7039
2100907;Araioses;1980;44351;6537;37814
2101004;Arari;1980;22274;8679;13595
2101103;Axixá;1980;8906;919;7987
2101202;Bacabal;1980;81361;43062;38299
2101301;Bacuri;1980;18855;2161;16694
2101400;Balsas;1980;23703;13514;10189
2101509;Barão de Grajaú;1980;12172;4282;7890
2101608;Barra do Corda;1980;76673;20567;56106
2101707;Barreirinhas;1980;26588;4948;21640
2101806;Benedito Leite;1980;8439;764;7675
2101905;Bequimão;1980;20192;2569;17623
2102002;Bom Jardim;1980;31953;4353;27600
2102101;Brejo;1980;25561;5818;19743
2102200;Buriti;1980;22165;3260;18905
2102309;Buriti Bravo;1980;17692;6360;11332
2102408;Cajapió;1980;12287;1622;10665
2102507;Cajari;1980;16508;2284;14224
2102606;Cândido Mendes;1980;19988;4009;15979
2102705;Cantanhede;1980;17247;3034;14213
2102804;Carolina;1980;34953;15070;19883
2102903;Carutapera;1980;17843;4057;13786
2103000;Caxias;1980;125509;56718;68791
2103109;Cedral;1980;12809;966;11843
2103208;Chapadinha;1980;52646;16595;36051
2103307;Codó;1980;108966;34765;74201
2103406;Coelho Neto;1980;24470;11577;12893
2103505;Colinas;1980;31365;7711;23654
2103604;Coroatá;1980;66913;18691;48222
2103703;Cururupu;1980;38096;10274;27822
2103802;Dom Pedro;1980;18501;9039;9462
2103901;Duque Bacelar;1980;7961;1872;6089
2104008;Esperantinópolis;1980;42955;5403;37552
2104107;Fortaleza dos Nogueiras;1980;9796;1828;7968
2104206;Fortuna;1980;12254;5525;6729
2104305;Godofredo Viana;1980;11070;1691;9379
2104404;Gonçalves Dias;1980;18613;5044;13569
2104503;Governador Archer;1980;12051;3194;8857
2104602;Governador Eugênio Barros;1980;21798;1703;20095
2104701;Graça Aranha;1980;5576;2305;3271
2104800;Grajaú;1980;57940;11062;46878
2104909;Guimarães;1980;12414;2789;9625
2105005;Humberto de Campos;1980;18325;2725;15600
2105104;Icatu;1980;19493;2582;16911
2105203;Igarapé Grande;1980;15949;3483;12466
2105302;Imperatriz;1980;220079;111619;108460
2105401;Itapecuru Mirim;1980;44120;12237;31883
2105500;João Lisboa;1980;41965;5922;36043
2105609;Joselândia;1980;16490;3276;13214
2105708;Lago da Pedra;1980;44807;12006;32801
2105807;Lago do Junco;1980;18588;2924;15664
2105906;Lago Verde;1980;10472;2106;8366
2106003;Lima Campos;1980;12544;3953;8591
2106102;Loreto;1980;8068;2052;6016
2106201;Luís Domingues;1980;6080;2819;3261
2106300;Magalhães de Almeida;1980;11240;4306;6934
2106409;Mata Roma;1980;9903;1886;8017
2106508;Matinha;1980;15018;2195;12823
2106607;Matões;1980;23773;2080;21693
2106706;Mirador;1980;15493;2644;12849
2106805;Mirinzal;1980;16073;2690;13383
2106904;Monção;1980;66869;3411;63458
2107001;Montes Altos;1980;15753;2021;13732
2107100;Morros;1980;17197;2894;14303
2107209;Nina Rodrigues;1980;8037;851;7186
2107308;Nova Iorque;1980;4764;1615;3149
2107407;Olho d'Água das Cunhãs;1980;15323;4169;11154
2107506;Paço do Lumiar;1980;17216;580;16636
2107605;Palmeirândia;1980;14138;1305;12833
2107704;Paraibano;1980;13550;6749;6801
2107803;Parnarama;1980;35287;4491;30796
2107902;Passagem Franca;1980;21599;2446;19153
2108009;Pastos Bons;1980;13294;3830;9464
2108108;Paulo Ramos;1980;26265;2374;23891
2108207;Pedreiras;1980;48541;31436;17105
2108306;Penalva;1980;26094;6035;20059
2108405;Peri Mirim;1980;11395;2114;9281
2108504;Pindaré-Mirim;1980;26469;11675;14794
2108603;Pinheiro;1980;68637;19473;49164
2108702;Pio XII;1980;24128;6832;17296
2108801;Pirapemas;1980;14775;4605;10170
2108900;Poção de Pedras;1980;35856;8278;27578
2109007;Porto Franco;1980;23142;5204;17938
2109106;Presidente Dutra;1980;39769;14491;25278
2109205;Presidente Juscelino;1980;5814;1073;4741
2109304;Presidente Vargas;1980;7923;1351;6572
2109403;Primeira Cruz;1980;17568;4690;12878
2109502;Riachão;1980;24223;4108;20115
2109601;Rosário;1980;28328;11653;16675
2109700;Sambaíba;1980;5506;1133;4373
2109809;Santa Helena;1980;33026;6728;26298
2109908;Santa Inês;1980;49442;40123;9319
2110005;Santa Luzia;1980;94224;11031;83193
2110104;Santa Quitéria do Maranhão;1980;18349;3611;14738
2110203;Santa Rita;1980;16933;3375;13558
2110302;Santo Antônio dos Lopes;1980;21868;2749;19119
2110401;São Benedito do Rio Preto;1980;13130;3043;10087
2110500;São Bento;1980;23515;9609;13906
2110609;São Bernardo;1980;22574;2152;20422
2110708;São Domingos do Maranhão;1980;28875;8160;20715
2110807;São Félix de Balsas;1980;5995;445;5550
2110906;São Francisco do Maranhão;1980;13190;1346;11844
2111003;São João Batista;1980;23063;2520;20543
2111102;São João dos Patos;1980;22892;12846;10046
2111201;São José de Ribamar;1980;32309;18734;13575
2111300;São Luís;1980;449433;247392;202041
2111409;São Luís Gonzaga do Maranhão;1980;28585;2813;25772
2111508;São Mateus do Maranhão;1980;25008;13493;11515
2111607;São Raimundo das Mangabeiras;1980;12318;4724;7594
2111706;São Vicente Ferrer;1980;19164;1188;17976
2111805;Sítio Novo;1980;9881;1876;8005
2111904;Sucupira do Norte;1980;10201;1465;8736
2112001;Tasso Fragoso;1980;5213;1088;4125
2112100;Timbiras;1980;20240;3636;16604
2112209;Timon;1980;74399;55541;18858
2112308;Tuntum;1980;34699;9421;25278
2112407;Turiaçu;1980;57471;3400;54071
2112506;Tutóia;1980;39610;7860;31750
2112605;Urbano Santos;1980;19870;2902;16968
2112704;Vargem Grande;1980;33373;8834;24539
2112803;Viana;1980;43475;9770;33705
2112902;Vitória do Mearim;1980;50409;7289;43120
2113009;Vitorino Freire;1980;28215;8690;19525
2200103;Agricolândia;1980;4477;2709;1768
2200202;Água Branca;1980;15003;10223;4780
2200301;Alto Longá;1980;17755;2582;15173
2200400;Altos;1980;33228;13644;19584
2200509;Amarante;1980;14517;6847;7670
2200608;Angical do Piauí;1980;5322;2609;2713
2200707;Anísio de Abreu;1980;9285;1532;7753
2200806;Antônio Almeida;1980;3393;515;2878
2200905;Aroazes;1980;9590;1630;7960
2201002;Arraial;1980;4691;982;3709
2201101;Avelino Lopes;1980;10148;1621;8527
2201200;Barras;1980;43672;8864;34808
2201309;Barreiras do Piauí;1980;2960;536;2424
2201408;Barro Duro;1980;6691;2951;3740
2201507;Batalha;1980;21473;4335;17138
2201606;Beneditinos;1980;13365;2651;10714
2201705;Bertolínia;1980;7445;2000;5445
2201804;Bocaina;1980;3786;872;2914
2201903;Bom Jesus;1980;14370;5385;8985
2202000;Buriti dos Lopes;1980;25823;4298;21525
2202109;Campinas do Piauí;1980;6825;479;6346
2202208;Campo Maior;1980;67705;23844;43861
2202307;Canto do Buriti;1980;25526;6343;19183
2202406;Capitão de Campos;1980;8862;2724;6138
2202505;Caracol;1980;9391;2254;7137
2202604;Castelo do Piauí;1980;28529;5688;22841
2202703;Cocal;1980;24308;4308;20000
2202802;Conceição do Canindé;1980;6874;976;5898
2202901;Corrente;1980;21539;7151;14388
2203008;Cristalândia do Piauí;1980;4831;909;3922
2203107;Cristino Castro;1980;8518;2693;5825
2203206;Curimatá;1980;10491;2227;8264
2203305;Demerval Lobão;1980;10436;4972;5464
2203404;Dom Expedito Lopes;1980;4258;1974;2284
2203420;Domingos Mourão;1980;3692;417;3275
2203503;Elesbão Veloso;1980;16838;7056;9782
2203602;Eliseu Martins;1980;6521;1304;5217
2203701;Esperantina;1980;29110;12246;16864
2203800;Flores do Piauí;1980;4671;1512;3159
2203909;Floriano;1980;43129;35726;7403
2204006;Francinópolis;1980;5029;1756;3273
2204105;Francisco Ayres;1980;4498;1104;3394
2204204;Francisco Santos;1980;4917;3055;1862
2204303;Fronteiras;1980;14429;3205;11224
2204402;Gilbués;1980;8697;1546;7151
2204501;Guadalupe;1980;8586;6802;1784
2204600;Hugo Napoleão;1980;2881;1890;991
2204709;Inhuma;1980;11166;3218;7948
2204808;Ipiranga do Piauí;1980;6273;2535;3738
2204907;Isaías Coelho;1980;6936;692;6244
2205003;Itainópolis;1980;13370;1688;11682
2205102;Itaueira;1980;10225;2656;7569
2205201;Jaicós;1980;24679;3448;21231
2205300;Jerumenha;1980;7863;2211;5652
2205409;Joaquim Pires;1980;14022;1472;12550
2205508;José de Freitas;1980;25369;8770;16599
2205607;Landri Sales;1980;5928;2463;3465
2205706;Luís Correia;1980;25626;3589;22037
2205805;Luzilândia;1980;34268;8443;25825
2205904;Manoel Emídio;1980;5679;1541;4138
2206001;Marcos Parente;1980;3187;1694;1493
2206100;Matias Olímpio;1980;10801;2177;8624
2206209;Miguel Alves;1980;26636;4063;22573
2206308;Miguel Leão;1980;1481;473;1008
2206407;Monsenhor Gil;1980;9929;1803;8126
2206506;Monsenhor Hipólito;1980;4640;1568;3072
2206605;Monte Alegre do Piauí;1980;7960;1528;6432
2206704;Nazaré do Piauí;1980;7500;2267;5233
2206803;Nossa Senhora dos Remédios;1980;5528;1405;4123
2206902;Novo Oriente do Piauí;1980;7287;2325;4962
2207009;Oeiras;1980;47319;12390;34929
2207207;Padre Marcos;1980;15742;1200;14542
2207306;Paes Landim;1980;4789;1114;3675
2207405;Palmeira do Piauí;1980;4314;567;3747
2207504;Palmeirais;1980;12578;1768;10810
2207603;Parnaguá;1980;10663;1411;9252
2207702;Parnaíba;1980;102174;79256;22918
2207801;Paulistana;1980;32874;3606;29268
2207900;Pedro II;1980;38816;9608;29208
2208007;Picos;1980;71018;33129;37889
2208106;Pimenteiras;1980;9463;1789;7674
2208205;Pio IX;1980;19828;2457;17371
2208304;Piracuruca;1980;29404;10029;19375
2208403;Piripiri;1980;55095;29462;25633
2208502;Porto;1980;12403;2615;9788
2208601;Prata do Piauí;1980;2130;879;1251
2208700;Redenção do Gurguéia;1980;5331;1774;3557
2208809;Regeneração;1980;16950;7686;9264
2208908;Ribeiro Gonçalves;1980;9933;1491;8442
2209005;Rio Grande do Piauí;1980;9310;1937;7373
2209104;Santa Cruz do Piauí;1980;9435;2127;7308
2209203;Santa Filomena;1980;4657;1043;3614
2209302;Santa Luz;1980;4269;1132;3137
2209401;Santo Antônio de Lisboa;1980;5607;2263;3344
2209500;Santo Inácio do Piauí;1980;5519;823;4696
2209609;São Félix do Piauí;1980;5705;1344;4361
2209708;São Francisco do Piauí;1980;6844;1012;5832
2209807;São Gonçalo do Piauí;1980;4227;1731;2496
2209906;São João da Serra;1980;7784;1180;6604
2210003;São João do Piauí;1980;34545;6927;27618
2210102;São José do Peixe;1980;5547;1063;4484
2210201;São José do Piauí;1980;5612;1204;4408
2210300;São Julião;1980;7993;1267;6726
2210409;São Miguel do Tapuio;1980;24184;3562;20622
2210508;São Pedro do Piauí;1980;10699;4238;6461
2210607;São Raimundo Nonato;1980;57713;8771;48942
2210706;Simões;1980;18193;2362;15831
2210805;Simplício Mendes;1980;11546;3999;7547
2210904;Socorro do Piauí;1980;4795;758;4037
2211001;Teresina;1980;377771;338975;38796
2211100;União;1980;41560;9606;31954
2211209;Uruçuí;1980;14543;6049;8494
2211308;Valença do Piauí;1980;18724;7712;11012
2211407;Várzea Grande;1980;7152;1520;5632
2300101;Abaiara;1980;6542;922;5620
2300200;Acaraú;1980;71897;12924;58973
2300309;Acopiara;1980;52047;12995;39052
2300408;Aiuaba;1980;15548;1685;13863
2300507;Alcântaras;1980;9336;1411;7925
2300606;Altaneira;1980;4422;1955;2467
2300705;Alto Santo;1980;12950;3006;9944
2300804;Antonina do Norte;1980;5463;2469;2994
2300903;Apuiarés;1980;9234;2764;6470
2301000;Aquiraz;1980;45112;37722;7390
2301109;Aracati;1980;61145;23566;37579
2301208;Aracoiaba;1980;35257;5029;30228
2301307;Araripe;1980;14858;4276;10582
2301406;Aratuba;1980;12433;1076;11357
2301505;Arneiroz;1980;7023;1047;5976
2301604;Assaré;1980;29569;5125;24444
2301703;Aurora;1980;25060;7162;17898
2301802;Baixio;1980;5299;1521;3778
2301901;Barbalha;1980;30955;15031;15924
2302008;Barro;1980;19023;4242;14781
2302107;Baturité;1980;24450;12378;12072
2302206;Beberibe;1980;35466;5825;29641
2302305;Bela Cruz;1980;21871;6763;15108
2302404;Boa Viagem;1980;46562;9668;36894
2302503;Brejo Santo;1980;26501;9671;16830
2302602;Camocim;1980;46004;25046;20958
2302701;Campos Sales;1980;32121;11736;20385
2302800;Canindé;1980;58178;19367;38811
2302909;Capistrano;1980;15149;3023;12126
2303006;Caridade;1980;11903;3378;8525
2303105;Cariré;1980;18319;2947;15372
2303204;Caririaçu;1980;23530;5084;18446
2303303;Cariús;1980;18152;3415;14737
2303402;Carnaubal;1980;11219;3827;7392
2303501;Cascavel;1980;47677;36976;10701
2303600;Catarina;1980;8924;2328;6596
2303709;Caucaia;1980;94106;73304;20802
2303808;Cedro;1980;21753;8436;13317
2303907;Chaval;1980;8563;5673;2890
2304004;Coreaú;1980;17325;5448;11877
2304103;Crateús;1980;65869;32267;33602
2304202;Crato;1980;80675;58306;22369
2304301;Farias Brito;1980;17362;5223;12139
2304400;Fortaleza;1980;1307608;1307608;0
2304509;Frecheirinha;1980;9176;2608;6568
2304608;General Sampaio;1980;4753;1302;3451
2304707;Granja;1980;39653;11969;27684
2304806;Granjeiro;1980;4406;617;3789
2304905;Groaíras;1980;7237;3166;4071
2305001;Guaraciaba do Norte;1980;36972;7475;29497
2305100;Guaramiranga;1980;5423;712;4711
2305209;Hidrolândia;1980;17679;4649;13030
2305308;Ibiapina;1980;16903;3319;13584
2305407;Icó;1980;53342;16326;37016
2305506;Iguatu;1980;82946;45285;37661
2305605;Independência;1980;43842;8481;35361
2305704;Ipaumirim;1980;11112;3940;7172
2305803;Ipu;1980;44191;15328;28863
2305902;Ipueiras;1980;33322;8629;24693
2306009;Iracema;1980;21119;5890;15229
2306108;Irauçuba;1980;16396;4136;12260
2306207;Itaiçaba;1980;5311;3004;2307
2306306;Itapajé;1980;40664;15404;25260
2306405;Itapipoca;1980;103815;26729;77086
2306504;Itapiúna;1980;13222;3453;9769
2306603;Itatira;1980;15844;2060;13784
2306702;Jaguaretama;1980;17194;2896;14298
2306801;Jaguaribara;1980;8131;1720;6411
2306900;Jaguaribe;1980;28541;11910;16631
2307007;Jaguaruana;1980;24900;8244;16656
2307106;Jardim;1980;22514;4149;18365
2307205;Jati;1980;7708;2128;5580
2307304;Juazeiro do Norte;1980;135620;126032;9588
2307403;Jucás;1980;20507;4099;16408
2307502;Lavras da Mangabeira;1980;30525;11420;19105
2307601;Limoeiro do Norte;1980;32754;13571;19183
2307700;Maranguape;1980;91137;57923;33214
2307809;Marco;1980;13928;5203;8725
2307908;Martinópole;1980;6981;3816;3165
2308005;Massapê;1980;23224;10292;12932
2308104;Mauriti;1980;35747;7621;28126
2308203;Meruoca;1980;10489;1989;8500
2308302;Milagres;1980;20792;6788;14004
2308401;Missão Velha;1980;28754;8768;19986
2308500;Mombaça;1980;46457;11100;35357
2308609;Monsenhor Tabosa;1980;15852;4123;11729
2308708;Morada Nova;1980;64533;19047;45486
2308807;Moraújo;1980;7936;1829;6107
2308906;Morrinhos;1980;13581;3687;9894
2309003;Mucambo;1980;12137;3133;9004
2309102;Mulungu;1980;7429;1323;6106
2309201;Nova Olinda;1980;9769;3372;6397
2309300;Nova Russas;1980;46602;16609;29993
2309409;Novo Oriente;1980;24694;4901;19793
2309508;Orós;1980;19104;9975;9129
2309607;Pacajus;1980;46981;23935;23046
2309706;Pacatuba;1980;42106;24804;17302
2309805;Pacoti;1980;10186;2060;8126
2309904;Pacujá;1980;4301;1260;3041
2310001;Palhano;1980;7105;2006;5099
2310100;Palmácia;1980;10391;3099;7292
2310209;Paracuru;1980;28610;9044;19566
2310308;Parambu;1980;29547;6629;22918
2310407;Paramoti;1980;9802;1687;8115
2310506;Pedra Branca;1980;35770;7070;28700
2310605;Penaforte;1980;5536;1382;4154
2310704;Pentecoste;1980;32127;12548;19579
2310803;Pereiro;1980;21568;5077;16491
2310902;Piquet Carneiro;1980;15402;3433;11969
2311009;Poranga;1980;9808;2968;6840
2311108;Porteiras;1980;13768;2200;11568
2311207;Potengi;1980;7217;2560;4657
2311306;Quixadá;1980;99290;29492;69798
2311405;Quixeramobim;1980;66163;17966;48197
2311504;Quixeré;1980;12485;2905;9580
2311603;Redenção;1980;42642;12087;30555
2311702;Reriutaba;1980;29244;10583;18661
2311801;Russas;1980;38513;18558;19955
2311900;Saboeiro;1980;16894;3137;13757
2312007;Santana do Acaraú;1980;23730;6914;16816
2312106;Santana do Cariri;1980;16608;4526;12082
2312205;Santa Quitéria;1980;52263;11000;41263
2312304;São Benedito;1980;43759;10316;33443
2312403;São Gonçalo do Amarante;1980;24694;7149;17545
2312502;São João do Jaguaribe;1980;8335;1859;6476
2312601;São Luís do Curu;1980;8149;4843;3306
2312700;Senador Pompeu;1980;26900;10776;16124
2312809;Senador Sá;1980;4602;2084;2518
2312908;Sobral;1980;118024;82460;35564
2313005;Solonópole;1980;37255;6513;30742
2313104;Tabuleiro do Norte;1980;23243;8973;14270
2313203;Tamboril;1980;25923;5515;20408
2313302;Tauá;1980;46670;14461;32209
2313401;Tianguá;1980;34287;15966;18321
2313500;Trairi;1980;29919;3441;26478
2313609;Ubajara;1980;20346;6558;13788
2313708;Umari;1980;8189;1367;6822
2313807;Uruburetama;1980;35164;13371;21793
2313906;Uruoca;1980;10600;3191;7409
2314003;Várzea Alegre;1980;29785;10251;19534
2314102;Viçosa do Ceará;1980;37200;6574;30626
2400109;Acari;1980;11018;6520;4498
2400208;Açu;1980;34398;20505;13893
2400307;Afonso Bezerra;1980;8601;3951;4650
2400406;Água Nova;1980;2040;739;1301
2400505;Alexandria;1980;14337;6134;8203
2400604;Almino Afonso;1980;5721;1833;3888
2400703;Alto do Rodrigues;1980;5446;2335;3111
2400802;Angicos;1980;12757;7400;5357
2400901;Antônio Martins;1980;8751;2219;6532
2401008;Apodi;1980;27540;9180;18360
2401107;Areia Branca;1980;17228;12930;4298
2401206;Arês;1980;9958;3537;6421
2401305;Augusto Severo;1980;12143;3677;8466
2401404;Baía Formosa;1980;5155;3454;1701
2401503;Barcelona;1980;4428;1075;3353
2401602;Bento Fernandes;1980;4641;1274;3367
2401701;Bom Jesus;1980;4594;2137;2457
2401800;Brejinho;1980;6081;2302;3779
2401909;Caiçara do Rio do Vento;1980;2599;444;2155
2402006;Caicó;1980;40030;30828;9202
2402105;Campo Redondo;1980;9180;3047;6133
2402204;Canguaretama;1980;17980;7825;10155
2402303;Caraúbas;1980;18786;7439;11347
2402402;Carnaúba dos Dantas;1980;5384;2665;2719
2402501;Carnaubais;1980;12133;2466;9667
2402600;Ceará-Mirim;1980;40106;17053;23053
2402709;Cerro Corá;1980;8816;2621;6195
2402808;Coronel Ezequiel;1980;6634;1091;5543
2402907;Coronel João Pessoa;1980;4094;676;3418
2403004;Cruzeta;1980;6819;3729;3090
2403103;Currais Novos;1980;34979;25674;9305
2403202;Doutor Severiano;1980;5339;1058;4281
2403251;Parnamirim;1980;26362;19835;6527
2403301;Encanto;1980;4178;1056;3122
2403400;Equador;1980;5025;1721;3304
2403509;Espírito Santo;1980;7433;2697;4736
2403608;Extremoz;1980;8796;3350;5446
2403707;Felipe Guerra;1980;4751;1464;3287
2403806;Florânia;1980;11486;4088;7398
2403905;Francisco Dantas;1980;3531;548;2983
2404002;Frutuoso Gomes;1980;4256;1563;2693
2404101;Galinhos;1980;1272;691;581
2404200;Goianinha;1980;11903;5871;6032
2404309;Governador Dix-Sept Rosado;1980;9052;2795;6257
2404408;Grossos;1980;7894;5322;2572
2404507;Guamaré;1980;3262;971;2291
2404606;Ielmo Marinho;1980;9225;789;8436
2404705;Ipanguaçu;1980;12229;2296;9933
2404804;Ipueira;1980;1510;566;944
2404903;Itaú;1980;3347;1825;1522
2405009;Jaçanã;1980;4689;1783;2906
2405108;Jandaíra;1980;4172;1658;2514
2405207;Janduís;1980;5433;1982;3451
2405306;Januário Cicco;1980;6710;1277;5433
2405405;Japi;1980;5741;2194;3547
2405504;Jardim de Angicos;1980;2921;278;2643
2405603;Jardim de Piranhas;1980;8487;3969;4518
2405702;Jardim do Seridó;1980;10354;6422;3932
2405801;João Câmara;1980;22831;12526;10305
2405900;João Dias;1980;3250;501;2749
2406007;José da Penha;1980;5577;1718;3859
2406106;Jucurutu;1980;13277;4019;9258
2406205;Lagoa d'Anta;1980;4347;1094;3253
2406304;Lagoa de Pedras;1980;4616;982;3634
2406403;Lagoa de Velhos;1980;2249;620;1629
2406502;Lagoa Nova;1980;8148;2859;5289
2406601;Lagoa Salgada;1980;5031;1548;3483
2406700;Lajes;1980;8271;5290;2981
2406809;Lajes Pintadas;1980;3918;911;3007
2406908;Lucrécia;1980;2589;1060;1529
2407005;Luís Gomes;1980;10001;3949;6052
2407104;Macaíba;1980;31270;17029;14241
2407203;Macau;1980;24078;17560;6518
2407302;Marcelino Vieira;1980;8043;2291;5752
2407401;Martins;1980;13075;3365;9710
2407500;Maxaranguape;1980;11139;1933;9206
2407609;Messias Targino;1980;3404;1564;1840
2407708;Montanhas;1980;7798;3690;4108
2407807;Monte Alegre;1980;13819;3233;10586
2407906;Monte das Gameleiras;1980;2652;692;1960
2408003;Mossoró;1980;145981;122936;23045
2408102;Natal;1980;416892;416892;0
2408201;Nísia Floresta;1980;9982;5191;4791
2408300;Nova Cruz;1980;26044;12799;13245
2408409;Olho d'Água do Borges;1980;4849;1984;2865
2408508;Ouro Branco;1980;4543;1721;2822
2408607;Paraná;1980;2539;353;2186
2408706;Paraú;1980;3784;1621;2163
2408805;Parazinho;1980;3747;1525;2222
2408904;Parelhas;1980;14482;8974;5508
2409100;Passa e Fica;1980;5702;1881;3821
2409209;Passagem;1980;2343;894;1449
2409308;Patu;1980;11744;6591;5153
2409407;Pau dos Ferros;1980;16216;12957;3259
2409506;Pedra Grande;1980;3240;965;2275
2409605;Pedra Preta;1980;2872;316;2556
2409704;Pedro Avelino;1980;9333;3453;5880
2409803;Pedro Velho;1980;10738;3392;7346
2409902;Pendências;1980;9383;6104;3279
2410009;Pilões;1980;1917;888;1029
2410108;Poço Branco;1980;8715;4012;4703
2410207;Portalegre;1980;5866;1295;4571
2410306;Serra Caiada;1980;5020;2030;2990
2410405;Pureza;1980;5659;1917;3742
2410504;Rafael Fernandes;1980;2688;670;2018
2410603;Rafael Godeiro;1980;3549;1030;2519
2410702;Riacho da Cruz;1980;2336;1080;1256
2410801;Riacho de Santana;1980;3873;566;3307
2410900;Riachuelo;1980;6032;2628;3404
2411007;Rodolfo Fernandes;1980;4924;3093;1831
2411106;Ruy Barbosa;1980;3944;722;3222
2411205;Santa Cruz;1980;22332;13180;9152
2411403;Santana do Matos;1980;17260;5112;12148
2411429;Santana do Seridó;1980;2488;517;1971
2411502;Santo Antônio;1980;17231;6117;11114
2411601;São Bento do Norte;1980;7966;5498;2468
2411700;São Bento do Trairí;1980;3258;544;2714
2411809;São Fernando;1980;3186;731;2455
2411908;São Francisco do Oeste;1980;2332;992;1340
2412005;São Gonçalo do Amarante;1980;30797;5745;25052
2412104;São João do Sabugi;1980;4540;2525;2015
2412203;São José de Mipibu;1980;20441;9402;11039
2412302;São José do Campestre;1980;12241;7370;4871
2412401;São José do Seridó;1980;3021;1067;1954
2412500;São Miguel;1980;17800;5639;12161
2412609;São Paulo do Potengi;1980;13553;5581;7972
2412708;São Pedro;1980;7074;1721;5353
2412807;São Rafael;1980;7188;2977;4211
2412906;São Tomé;1980;11352;2957;8395
2413003;São Vicente;1980;4929;1800;3129
2413102;Senador Elói de Souza;1980;4082;753;3329
2413201;Senador Georgino Avelino;1980;1981;609;1372
2413300;Serra de São Bento;1980;6462;1841;4621
2413409;Serra Negra do Norte;1980;7811;2190;5621
2413508;Serrinha;1980;6321;884;5437
2413607;Severiano Melo;1980;6993;1117;5876
2413706;Sítio Novo;1980;4894;1172;3722
2413805;Taboleiro Grande;1980;1743;495;1248
2413904;Taipu;1980;9355;2585;6770
2414001;Tangará;1980;8661;4237;4424
2414100;Tenente Ananias;1980;9778;4108;5670
2414209;Tibau do Sul;1980;4873;858;4015
2414308;Timbaúba dos Batistas;1980;1501;766;735
2414407;Touros;1980;19817;2850;16967
2414506;Umarizal;1980;12358;7685;4673
2414605;Upanema;1980;7460;3072;4388
2414704;Várzea;1980;6871;3188;3683
2414803;Vera Cruz;1980;6178;2207;3971
2414902;Viçosa;1980;1128;640;488
2415008;Vila Flor;1980;1524;804;720
2500106;Água Branca;1980;7769;1687;6082
2500205;Aguiar;1980;7782;1473;6309
2500304;Alagoa Grande;1980;30451;14215;16236
2500403;Alagoa Nova;1980;21192;5282;15910
2500502;Alagoinha;1980;12180;4865;7315
2500601;Alhandra;1980;9179;3784;5395
2500700;São João do Rio do Peixe;1980;21115;5244;15871
2500809;Araçagi;1980;18816;3079;15737
2500908;Arara;1980;8493;4498;3995
2501005;Araruna;1980;19023;5278;13745
2501104;Areia;1980;27880;9947;17933
2501203;Areial;1980;5255;1868;3387
2501302;Aroeiras;1980;27068;3402;23666
2501401;Baía da Traição;1980;4316;2244;2072
2501500;Bananeiras;1980;25009;4160;20849
2501609;Barra de Santa Rosa;1980;15890;4067;11823
2501708;Barra de São Miguel;1980;4744;881;3863
2501807;Bayeux;1980;58921;58480;441
2501906;Belém;1980;13766;8143;5623
2502003;Belém do Brejo do Cruz;1980;8711;3083;5628
2502102;Boa Ventura;1980;5506;1531;3975
2502201;Bom Jesus;1980;1302;260;1042
2502300;Bom Sucesso;1980;7348;759;6589
2502409;Bonito de Santa Fé;1980;7742;2550;5192
2502508;Boqueirão;1980;30253;8583;21670
2502607;Igaracy;1980;5966;2130;3836
2502706;Borborema;1980;4376;1906;2470
2502805;Brejo do Cruz;1980;14012;4989;9023
2502904;Brejo dos Santos;1980;6579;2610;3969
2503001;Caaporã;1980;9997;3565;6432
2503100;Cabaceiras;1980;6133;1474;4659
2503209;Cabedelo;1980;18973;18547;426
2503308;Cachoeira dos Índios;1980;8521;1552;6969
2503407;Cacimba de Areia;1980;2841;631;2210
2503506;Cacimba de Dentro;1980;16769;4100;12669
2503605;Caiçara;1980;11021;4406;6615
2503704;Cajazeiras;1980;46448;31566;14882
2503803;Caldas Brandão;1980;4470;1582;2888
2503902;Camalaú;1980;5071;922;4149
2504009;Campina Grande;1980;247827;228182;19645
2504108;Carrapateira;1980;1451;710;741
2504207;Catingueira;1980;5848;1770;4078
2504306;Catolé do Rocha;1980;25855;12332;13523
2504405;Conceição;1980;22718;7015;15703
2504504;Condado;1980;8590;2779;5811
2504603;Conde;1980;6379;772;5607
2504702;Congo;1980;6043;1591;4452
2504801;Coremas;1980;13578;5681;7897
2504900;Cruz do Espírito Santo;1980;13192;4737;8455
2505006;Cubati;1980;6534;2822;3712
2505105;Cuité;1980;22312;8426;13886
2505204;Cuitegi;1980;5119;3626;1493
2505303;Curral Velho;1980;2518;356;2162
2505402;Desterro;1980;12110;1754;10356
2505501;Vista Serrana;1980;2301;536;1765
2505600;Diamante;1980;6513;2039;4474
2505709;Dona Inês;1980;10044;2459;7585
2505808;Duas Estradas;1980;7656;3397;4259
2505907;Emas;1980;2894;485;2409
2506004;Esperança;1980;23802;12983;10819
2506103;Fagundes;1980;12526;2678;9848
2506202;Frei Martinho;1980;2735;612;2123
2506301;Guarabira;1980;41808;32109;9699
2506400;Gurinhém;1980;13185;3425;9760
2506509;Gurjão;1980;5693;1431;4262
2506608;Ibiara;1980;6597;2297;4300
2506707;Imaculada;1980;10123;1457;8666
2506806;Ingá;1980;19498;8004;11494
2506905;Itabaiana;1980;26510;19174;7336
2507002;Itaporanga;1980;18353;8964;9389
2507101;Itapororoca;1980;12498;3441;9057
2507200;Itatuba;1980;9098;3027;6071
2507309;Jacaraú;1980;17861;2254;15607
2507408;Jericó;1980;8177;2482;5695
2507507;João Pessoa;1980;329945;326607;3338
2507606;Juarez Távora;1980;5778;3059;2719
2507705;Juazeirinho;1980;15003;4732;10271
2507804;Junco do Seridó;1980;4619;1408;3211
2507903;Juripiranga;1980;8040;5892;2148
2508000;Juru;1980;9439;1088;8351
2508109;Lagoa;1980;6005;1074;4931
2508208;Lagoa de Dentro;1980;8595;2139;6456
2508307;Lagoa Seca;1980;18915;3865;15050
2508406;Lastro;1980;3038;545;2493
2508505;Livramento;1980;5903;1220;4683
2508604;Lucena;1980;6353;1435;4918
2508703;Mãe d'Água;1980;5526;970;4556
2508802;Malta;1980;6080;3961;2119
2508901;Mamanguape;1980;41087;18492;22595
2509008;Manaíra;1980;10606;2551;8055
2509107;Mari;1980;17836;13363;4473
2509206;Massaranduba;1980;12802;1390;11412
2509305;Mataraca;1980;2482;886;1596
2509404;Mogeiro;1980;12812;2475;10337
2509503;Montadas;1980;3361;711;2650
2509602;Monte Horebe;1980;3789;1168;2621
2509701;Monteiro;1980;26852;11030;15822
2509800;Mulungu;1980;11751;3754;7997
2509909;Natuba;1980;11457;2053;9404
2510006;Nazarezinho;1980;8342;1978;6364
2510105;Nova Floresta;1980;6472;5085;1387
2510204;Nova Olinda;1980;5368;1448;3920
2510303;Nova Palmeira;1980;3041;710;2331
2510402;Olho d'Água;1980;9266;1450;7816
2510501;Olivedos;1980;3607;758;2849
2510600;Ouro Velho;1980;2997;1318;1679
2510709;Passagem;1980;4234;846;3388
2510808;Patos;1980;65162;58992;6170
2510907;Paulista;1980;10464;1110;9354
2511004;Pedra Branca;1980;3165;652;2513
2511103;Pedra Lavrada;1980;6155;1397;4758
2511202;Pedras de Fogo;1980;19875;7940;11935
2511301;Piancó;1980;14899;6255;8644
2511400;Picuí;1980;18864;7033;11831
2511509;Pilar;1980;12721;4251;8470
2511608;Pilões;1980;7743;1933;5810
2511707;Pilõezinhos;1980;5124;1302;3822
2511806;Pirpirituba;1980;9957;5258;4699
2511905;Pitimbu;1980;7873;2850;5023
2512002;Pocinhos;1980;15039;5539;9500
2512101;Pombal;1980;39948;15382;24566
2512200;Prata;1980;4374;2017;2357
2512309;Princesa Isabel;1980;19006;4836;14170
2512408;Puxinanã;1980;10394;1773;8621
2512507;Queimadas;1980;25481;5751;19730
2512606;Quixaba;1980;1896;197;1699
2512705;Remígio;1980;15812;6113;9699
2512804;Riacho dos Cavalos;1980;10073;2048;8025
2512903;Rio Tinto;1980;24548;15126;9422
2513000;Salgadinho;1980;2893;304;2589
2513109;Salgado de São Félix;1980;12689;2573;10116
2513208;Santa Cruz;1980;7995;1948;6047
2513307;Santa Helena;1980;5912;1645;4267
2513406;Santa Luzia;1980;11670;7590;4080
2513505;Santana de Mangueira;1980;6214;533;5681
2513604;Santana dos Garrotes;1980;9164;1831;7333
2513703;Santa Rita;1980;68227;54032;14195
2513802;Santa Teresinha;1980;5398;595;4803
2513901;São Bento;1980;14608;6449;8159
2514008;São João do Cariri;1980;7777;1847;5930
2514107;São João do Tigre;1980;4877;777;4100
2514206;São José da Lagoa Tapada;1980;8498;1881;6617
2514305;São José de Caiana;1980;6712;718;5994
2514404;São José de Espinharas;1980;8440;529;7911
2514503;São José de Piranhas;1980;18030;4322;13708
2514602;São José do Bonfim;1980;2956;452;2504
2514701;São José do Sabugi;1980;4337;1169;3168
2514800;São José dos Cordeiros;1980;6685;907;5778
2514909;São Mamede;1980;9224;3834;5390
2515005;São Miguel de Taipu;1980;4237;2015;2222
2515104;São Sebastião de Lagoa de Roça;1980;7267;1264;6003
2515203;São Sebastião do Umbuzeiro;1980;4589;1493;3096
2515302;Sapé;1980;50906;23372;27534
2515401;São Vicente do Seridó;1980;6530;1212;5318
2515500;Serra Branca;1980;15306;5685;9621
2515609;Serra da Raiz;1980;3532;1639;1893
2515708;Serra Grande;1980;2591;491;2100
2515807;Serra Redonda;1980;7316;1941;5375
2515906;Serraria;1980;11036;2685;8351
2516003;Solânea;1980;30365;10109;20256
2516102;Soledade;1980;9128;4240;4888
2516201;Sousa;1980;72887;41642;31245
2516300;Sumé;1980;16801;7616;9185
2516409;Tacima;1980;12328;3018;9310
2516508;Taperoá;1980;15167;5610;9557
2516607;Tavares;1980;13210;2592;10618
2516706;Teixeira;1980;16133;5082;11051
2516805;Triunfo;1980;9521;1393;8128
2516904;Uiraúna;1980;20607;6750;13857
2517001;Umbuzeiro;1980;17119;2340;14779
2517100;Várzea;1980;2656;715;1941
2600104;Afogados da Ingazeira;1980;24489;12799;11690
2600203;Afrânio;1980;11491;2027;9464
2600302;Agrestina;1980;15573;5137;10436
2600401;Água Preta;1980;37009;13030;23979
2600500;Águas Belas;1980;36647;11513;25134
2600609;Alagoinha;1980;10257;3678;6579
2600708;Aliança;1980;37654;12332;25322
2600807;Altinho;1980;24765;5054;19711
2600906;Amaraji;1980;19397;7007;12390
2601003;Angelim;1980;9284;2834;6450
2601102;Araripina;1980;47920;15975;31945
2601201;Arcoverde;1980;47205;40555;6650
2601300;Barra de Guabiraba;1980;10016;5131;4885
2601409;Barreiros;1980;32446;19619;12827
2601508;Belém de Maria;1980;10979;5061;5918
2601607;Belém do São Francisco;1980;24155;9025;15130
2601706;Belo Jardim;1980;51702;30744;20958
2601805;Betânia;1980;11858;1361;10497
2601904;Bezerros;1980;48824;25674;23150
2602001;Bodocó;1980;25806;4825;20981
2602100;Bom Conselho;1980;43644;16544;27100
2602209;Bom Jardim;1980;34922;5470;29452
2602308;Bonito;1980;33079;13701;19378
2602407;Brejão;1980;8733;1610;7123
2602506;Brejinho;1980;7053;1463;5590
2602605;Brejo da Madre de Deus;1980;24768;4908;19860
2602704;Buenos Aires;1980;12265;2401;9864
2602803;Buíque;1980;36365;6580;29785
2602902;Cabo de Santo Agostinho;1980;104155;81920;22235
2603009;Cabrobó;1980;20863;7991;12872
2603108;Cachoeirinha;1980;13443;6748;6695
2603207;Caetés;1980;17563;2086;15477
2603306;Calçado;1980;8498;1696;6802
2603405;Calumbi;1980;5710;848;4862
2603504;Camocim de São Félix;1980;10860;6515;4345
2603603;Camutanga;1980;7256;4130;3126
2603702;Canhotinho;1980;26379;8233;18146
2603801;Capoeiras;1980;18739;2423;16316
2603900;Carnaíba;1980;25468;3827;21641
2604007;Carpina;1980;57343;43886;13457
2604106;Caruaru;1980;172532;138250;34282
2604205;Catende;1980;28158;17988;10170
2604304;Cedro;1980;6507;1758;4749
2604403;Chã de Alegria;1980;9305;4885;4420
2604502;Chã Grande;1980;14414;4605;9809
2604601;Condado;1980;16216;11638;4578
2604700;Correntes;1980;18006;6559;11447
2604809;Cortês;1980;11176;6093;5083
2604908;Cumaru;1980;22402;3564;18838
2605004;Cupira;1980;18531;8239;10292
2605103;Custódia;1980;26823;8158;18665
2605202;Escada;1980;53167;31140;22027
2605301;Exu;1980;33316;7732;25584
2605400;Feira Nova;1980;17071;7771;9300
2605459;Fernando de Noronha;1980;1274;1274;0
2605509;Ferreiros;1980;10481;4426;6055
2605608;Flores;1980;22408;4051;18357
2605707;Floresta;1980;32235;8425;23810
2605806;Frei Miguelinho;1980;13749;917;12832
2605905;Gameleira;1980;16951;8497;8454
2606002;Garanhuns;1980;87038;67357;19681
2606101;Glória do Goitá;1980;27223;4929;22294
2606200;Goiana;1980;57799;36408;21391
2606309;Granito;1980;5203;524;4679
2606408;Gravatá;1980;52499;34632;17867
2606507;Iati;1980;18567;3339;15228
2606606;Ibimirim;1980;17322;7054;10268
2606705;Ibirajuba;1980;8530;981;7549
2606804;Igarassu;1980;73254;52349;20905
2606903;Iguaracy;1980;11723;3247;8476
2607000;Inajá;1980;19179;3993;15186
2607109;Ingazeira;1980;4547;1264;3283
2607208;Ipojuca;1980;39452;16923;22529
2607307;Ipubi;1980;18229;6021;12208
2607406;Itacuruba;1980;4410;1646;2764
2607505;Itaíba;1980;28348;2951;25397
2607604;Ilha de Itamaracá;1980;8254;6516;1738
2607653;Itambé;1980;28157;13262;14895
2607703;Itapetim;1980;15910;4427;11483
2607802;Itaquitinga;1980;10985;6009;4976
2607901;Jaboatão dos Guararapes;1980;330416;290471;39945
2608008;Jataúba;1980;13547;2125;11422
2608107;João Alfredo;1980;25264;4985;20279
2608206;Joaquim Nabuco;1980;14335;6304;8031
2608305;Jupi;1980;17828;3474;14354
2608404;Jurema;1980;12283;3216;9067
2608503;Lagoa de Itaenga;1980;12720;5626;7094
2608602;Lagoa do Ouro;1980;12812;2216;10596
2608701;Lagoa dos Gatos;1980;18409;5219;13190
2608800;Lajedo;1980;25687;11142;14545
2608909;Limoeiro;1980;57154;36821;20333
2609006;Macaparana;1980;18681;6558;12123
2609105;Machados;1980;8864;2597;6267
2609204;Maraial;1980;19571;7910;11661
2609303;Mirandiba;1980;11911;3156;8755
2609402;Moreno;1980;34943;26213;8730
2609501;Nazaré da Mata;1980;25448;15282;10166
2609600;Olinda;1980;282207;266753;15454
2609709;Orobó;1980;20603;2916;17687
2609808;Orocó;1980;7087;2234;4853
2609907;Ouricuri;1980;63949;14408;49541
2610004;Palmares;1980;58430;41250;17180
2610103;Palmeirina;1980;9497;2915;6582
2610202;Panelas;1980;28737;5316;23421
2610301;Paranatama;1980;11671;918;10753
2610400;Parnamirim;1980;15244;3712;11532
2610509;Passira;1980;25661;5893;19768
2610608;Paudalho;1980;36770;25705;11065
2610707;Paulista;1980;165743;96761;68982
2610806;Pedra;1980;19730;6026;13704
2610905;Pesqueira;1980;52281;32747;19534
2611002;Petrolândia;1980;23703;9761;13942
2611101;Petrolina;1980;104297;74828;29469
2611200;Poção;1980;9065;3207;5858
2611309;Pombos;1980;20915;6223;14692
2611408;Primavera;1980;8437;3765;4672
2611507;Quipapá;1980;19964;7212;12752
2611606;Recife;1980;1203887;1183363;20524
2611705;Riacho das Almas;1980;17119;2486;14633
2611804;Ribeirão;1980;36346;22353;13993
2611903;Rio Formoso;1980;31358;11268;20090
2612000;Sairé;1980;14093;1618;12475
2612109;Salgadinho;1980;5559;1115;4444
2612208;Salgueiro;1980;40439;26650;13789
2612307;Saloá;1980;15681;3217;12464
2612406;Sanharó;1980;14263;5037;9226
2612505;Santa Cruz do Capibaribe;1980;21104;18449;2655
2612604;Santa Maria da Boa Vista;1980;23876;4794;19082
2612703;Santa Maria do Cambucá;1980;10453;1489;8964
2612802;Santa Terezinha;1980;9508;2595;6913
2612901;São Benedito do Sul;1980;10543;3559;6984
2613008;São Bento do Una;1980;37587;13297;24290
2613107;São Caitano;1980;24601;10639;13962
2613206;São João;1980;17668;3114;14554
2613305;São Joaquim do Monte;1980;18214;4512;13702
2613404;São José da Coroa Grande;1980;9639;4681;4958
2613503;São José do Belmonte;1980;29258;7079;22179
2613602;São José do Egito;1980;26155;9889;16266
2613701;São Lourenço da Mata;1980;144142;127393;16749
2613800;São Vicente Férrer;1980;12908;4076;8832
2613909;Serra Talhada;1980;67156;30997;36159
2614006;Serrita;1980;18289;1873;16416
2614105;Sertânia;1980;32480;13639;18841
2614204;Sirinhaém;1980;29061;8112;20949
2614303;Moreilândia;1980;12248;3043;9205
2614402;Solidão;1980;6178;669;5509
2614501;Surubim;1980;61030;21201;39829
2614600;Tabira;1980;19405;8238;11167
2614709;Tacaimbó;1980;9896;3077;6819
2614808;Tacaratu;1980;14540;4682;9858
2615003;Taquaritinga do Norte;1980;14899;5933;8966
2615102;Terezinha;1980;7016;1202;5814
2615201;Terra Nova;1980;5216;2069;3147
2615300;Timbaúba;1980;54513;34300;20213
2615409;Toritama;1980;8616;7038;1578
2615508;Tracunhaém;1980;11197;4245;6952
2615607;Trindade;1980;13082;8189;4893
2615706;Triunfo;1980;26793;6771;20022
2615805;Tupanatinga;1980;18649;2693;15956
2615904;Tuparetama;1980;5473;3000;2473
2616001;Venturosa;1980;10070;4184;5886
2616100;Verdejante;1980;7713;887;6826
2616209;Vertentes;1980;16565;4441;12124
2616308;Vicência;1980;26021;6195;19826
2616407;Vitória de Santo Antão;1980;93198;63611;29587
2700102;Água Branca;1980;25159;2741;22418
2700201;Anadia;1980;14833;4170;10663
2700300;Arapiraca;1980;136178;87211;48967
2700409;Atalaia;1980;41766;10206;31560
2700508;Barra de Santo Antônio;1980;9696;3668;6028
2700607;Barra de São Miguel;1980;2328;1364;964
2700706;Batalha;1980;10384;5704;4680
2700805;Belém;1980;6234;1401;4833
2700904;Belo Monte;1980;5712;812;4900
2701001;Boca da Mata;1980;18164;5918;12246
2701100;Branquinha;1980;9543;2448;7095
2701209;Cacimbinhas;1980;10588;2258;8330
2701308;Cajueiro;1980;13445;7088;6357
2701407;Campo Alegre;1980;17581;4611;12970
2701506;Campo Grande;1980;9293;2740;6553
2701605;Canapi;1980;18356;1750;16606
2701704;Capela;1980;18615;6757;11858
2701803;Carneiros;1980;5447;1412;4035
2701902;Chã Preta;1980;9866;1835;8031
2702009;Coité do Nóia;1980;8963;1229;7734
2702108;Colônia Leopoldina;1980;14913;6917;7996
2702207;Coqueiro Seco;1980;3799;3471;328
2702306;Coruripe;1980;41650;8408;33242
2702405;Delmiro Gouveia;1980;26768;18539;8229
2702504;Dois Riachos;1980;7952;2379;5573
2702603;Feira Grande;1980;17542;1878;15664
2702702;Feliz Deserto;1980;2690;1729;961
2702801;Flexeiras;1980;14008;4122;9886
2702900;Girau do Ponciano;1980;22459;3596;18863
2703007;Ibateguara;1980;12086;4409;7677
2703106;Igaci;1980;24579;3081;21498
2703205;Igreja Nova;1980;19142;3643;15499
2703304;Inhapi;1980;12861;1885;10976
2703403;Jacaré dos Homens;1980;3873;1701;2172
2703502;Jacuípe;1980;7532;2027;5505
2703601;Japaratinga;1980;4227;1359;2868
2703700;Jaramataia;1980;3161;1205;1956
2703809;Joaquim Gomes;1980;17969;4105;13864
2703908;Jundiá;1980;10566;1040;9526
2704005;Junqueiro;1980;31200;10871;20329
2704104;Lagoa da Canoa;1980;12594;2974;9620
2704203;Limoeiro de Anadia;1980;18173;1151;17022
2704302;Maceió;1980;399300;392265;7035
2704401;Major Isidoro;1980;16020;5054;10966
2704500;Maragogi;1980;14953;5707;9246
2704609;Maravilha;1980;11832;2647;9185
2704708;Marechal Deodoro;1980;22695;9370;13325
2704807;Maribondo;1980;15041;7905;7136
2704906;Mar Vermelho;1980;4163;376;3787
2705002;Mata Grande;1980;23478;3033;20445
2705101;Matriz de Camaragibe;1980;17131;9915;7216
2705200;Messias;1980;7467;2545;4922
2705309;Minador do Negrão;1980;8246;1778;6468
2705408;Monteirópolis;1980;5420;1543;3877
2705507;Murici;1980;25855;9725;16130
2705606;Novo Lino;1980;14660;3893;10767
2705705;Olho d'Água das Flores;1980;13922;5844;8078
2705804;Olho d'Água do Casado;1980;4079;1890;2189
2705903;Olho d'Água Grande;1980;4620;734;3886
2706000;Olivença;1980;9523;1046;8477
2706109;Ouro Branco;1980;8768;2515;6253
2706208;Palestina;1980;2490;1390;1100
2706307;Palmeira dos Índios;1980;66930;35471;31459
2706406;Pão de Açúcar;1980;18936;7966;10970
2706505;Passo de Camaragibe;1980;11326;4228;7098
2706604;Paulo Jacinto;1980;8173;4474;3699
2706703;Penedo;1980;36658;27054;9604
2706802;Piaçabuçu;1980;11543;5983;5560
2706901;Pilar;1980;23896;14709;9187
2707008;Pindoba;1980;5215;1254;3961
2707107;Piranhas;1980;5949;1159;4790
2707206;Poço das Trincheiras;1980;10671;803;9868
2707305;Porto Calvo;1980;20496;8480;12016
2707404;Porto de Pedras;1980;9841;3689;6152
2707503;Porto Real do Colégio;1980;14389;4322;10067
2707602;Quebrangulo;1980;12645;4900;7745
2707701;Rio Largo;1980;43445;23186;20259
2707800;Roteiro;1980;5171;2446;2725
2707909;Santa Luzia do Norte;1980;3319;2540;779
2708006;Santana do Ipanema;1980;40372;15341;25031
2708105;Santana do Mundaú;1980;13580;4136;9444
2708204;São Brás;1980;7380;2872;4508
2708303;São José da Laje;1980;21959;8216;13743
2708402;São José da Tapera;1980;24790;3423;21367
2708501;São Luís do Quitunde;1980;25860;8076;17784
2708600;São Miguel dos Campos;1980;40708;18490;22218
2708709;São Miguel dos Milagres;1980;4809;951;3858
2708808;São Sebastião;1980;19764;2326;17438
2708907;Satuba;1980;6228;3347;2881
2709004;Tanque d'Arca;1980;7483;1502;5981
2709103;Taquarana;1980;13189;2318;10871
2709202;Traipu;1980;19272;5634;13638
2709301;União dos Palmares;1980;52702;22466;30236
2709400;Viçosa;1980;24658;10411;14247
2800100;Amparo de São Francisco;1980;1704;936;768
2800209;Aquidabã;1980;16125;5292;10833
2800308;Aracaju;1980;293119;287900;5219
2800407;Arauá;1980;8924;2384;6540
2800506;Areia Branca;1980;6332;1304;5028
2800605;Barra dos Coqueiros;1980;7952;5517;2435
2800670;Boquim;1980;18320;8924;9396
2800704;Brejo Grande;1980;7247;3175;4072
2801009;Campo do Brito;1980;11903;2721;9182
2801108;Canhoba;1980;4087;1288;2799
2801207;Canindé de São Francisco;1980;6157;360;5797
2801306;Capela;1980;23008;9383;13625
2801405;Carira;1980;15577;4770;10807
2801504;Carmópolis;1980;4463;3061;1402
2801603;Cedro de São João;1980;4921;3429;1492
2801702;Cristinápolis;1980;7242;3199;4043
2801900;Cumbe;1980;3401;1492;1909
2802007;Divina Pastora;1980;2188;1170;1018
2802106;Estância;1980;36825;28174;8651
2802205;Feira Nova;1980;4294;1461;2833
2802304;Frei Paulo;1980;8830;3004;5826
2802403;Gararu;1980;11284;2081;9203
2802502;General Maynard;1980;1863;1188;675
2802601;Gracho Cardoso;1980;6032;1735;4297
2802700;Ilha das Flores;1980;7743;3857;3886
2802809;Indiaroba;1980;7749;2642;5107
2802908;Itabaiana;1980;52601;26284;26317
2803005;Itabaianinha;1980;26475;7485;18990
2803104;Itabi;1980;4732;2055;2677
2803203;Itaporanga d'Ajuda;1980;16603;4737;11866
2803302;Japaratuba;1980;10471;4401;6070
2803401;Japoatã;1980;7797;2562;5235
2803500;Lagarto;1980;58328;19398;38930
2803609;Laranjeiras;1980;13275;6576;6699
2803708;Macambira;1980;4420;867;3553
2803807;Malhada dos Bois;1980;2439;1050;1389
2803906;Malhador;1980;8307;2658;5649
2804003;Maruim;1980;11366;8472;2894
2804102;Moita Bonita;1980;8622;1207;7415
2804201;Monte Alegre de Sergipe;1980;8599;2957;5642
2804300;Muribeca;1980;6071;2196;3875
2804409;Neópolis;1980;17580;8199;9381
2804458;Nossa Senhora Aparecida;1980;8753;930;7823
2804508;Nossa Senhora da Glória;1980;20432;8076;12356
2804607;Nossa Senhora das Dores;1980;17493;7161;10332
2804706;Nossa Senhora de Lourdes;1980;4183;1116;3067
2804805;Nossa Senhora do Socorro;1980;13710;1602;12108
2804904;Pacatuba;1980;9823;1223;8600
2805000;Pedra Mole;1980;1718;430;1288
2805109;Pedrinhas;1980;5404;2251;3153
2805208;Pinhão;1980;3989;1344;2645
2805307;Pirambu;1980;3311;1566;1745
2805406;Poço Redondo;1980;16741;1808;14933
2805505;Poço Verde;1980;14356;3583;10773
2805604;Porto da Folha;1980;22863;6114;16749
2805703;Propriá;1980;21309;18988;2321
2805802;Riachão do Dantas;1980;17474;2321;15153
2805901;Riachuelo;1980;5898;4082;1816
2806008;Ribeirópolis;1980;12205;4738;7467
2806107;Rosário do Catete;1980;3915;2953;962
2806206;Salgado;1980;12270;2221;10049
2806305;Santa Luzia do Itanhy;1980;8026;1430;6596
2806503;Santa Rosa de Lima;1980;2975;1484;1491
2806602;Santo Amaro das Brotas;1980;7947;5383;2564
2806701;São Cristóvão;1980;24129;11733;12396
2806800;São Domingos;1980;6316;1501;4815
2806909;São Francisco;1980;2046;1484;562
2807006;São Miguel do Aleixo;1980;3095;881;2214
2807105;Simão Dias;1980;27031;8479;18552
2807204;Siriri;1980;5406;1636;3770
2807303;Telha;1980;1763;805;958
2807402;Tobias Barreto;1980;30781;12801;17980
2807501;Tomar do Geru;1980;10537;1867;8670
2807600;Umbaúba;1980;9504;4309;5195
2900108;Abaíra;1980;8977;2277;6700
2900207;Abaré;1980;8963;1544;7419
2900306;Acajutiba;1980;11535;6648;4887
2900405;Água Fria;1980;13126;1912;11214
2900504;Érico Cardoso;1980;5737;913;4824
2900603;Aiquara;1980;7290;1646;5644
2900702;Alagoinhas;1980;102166;79688;22478
2900801;Alcobaça;1980;40212;4532;35680
2900900;Almadina;1980;9146;4797;4349
2901007;Amargosa;1980;25218;11912;13306
2901106;Amélia Rodrigues;1980;18191;11642;6549
2901205;Anagé;1980;31291;2174;29117
2901304;Andaraí;1980;22010;4167;17843
2901403;Angical;1980;11865;1773;10092
2901502;Anguera;1980;7748;2398;5350
2901601;Antas;1980;21468;3833;17635
2901700;Antônio Cardoso;1980;11505;690;10815
2901809;Antônio Gonçalves;1980;8169;3019;5150
2901908;Aporá;1980;13156;2629;10527
2902005;Aracatu;1980;13475;1264;12211
2902104;Araci;1980;32225;5909;26316
2902203;Aramari;1980;7774;3342;4432
2902302;Aratuípe;1980;7471;3310;4161
2902401;Aurelino Leal;1980;16378;8476;7902
2902500;Baianópolis;1980;9606;1250;8356
2902609;Baixa Grande;1980;19579;3724;15855
2902708;Barra;1980;51563;13497;38066
2902807;Barra da Estiva;1980;12106;2379;9727
2902906;Barra do Choça;1980;20524;6484;14040
2903003;Barra do Mendes;1980;11055;3173;7882
2903102;Barra do Rocha;1980;9593;2731;6862
2903201;Barreiras;1980;41454;30055;11399
2903300;Barro Preto;1980;8200;3396;4804
2903409;Belmonte;1980;22556;9994;12562
2903508;Belo Campo;1980;12692;3186;9506
2903607;Biritinga;1980;10478;1047;9431
2903706;Boa Nova;1980;24890;2345;22545
2903805;Boa Vista do Tupim;1980;16812;2522;14290
2903904;Bom Jesus da Lapa;1980;69192;24344;44848
2904001;Boninal;1980;9946;1542;8404
2904100;Boquira;1980;19070;4837;14233
2904209;Botuporã;1980;21032;3632;17400
2904308;Brejões;1980;10634;2388;8246
2904407;Brejolândia;1980;9073;871;8202
2904506;Brotas de Macaúbas;1980;12512;1840;10672
2904605;Brumado;1980;46747;25717;21030
2904704;Buerarema;1980;24875;10197;14678
2904803;Caatiba;1980;10663;2045;8618
2904902;Cachoeira;1980;27946;13762;14184
2905008;Caculé;1980;15481;6460;9021
2905107;Caém;1980;9683;1193;8490
2905206;Caetité;1980;45318;11218;34100
2905305;Cafarnaum;1980;20025;5946;14079
2905404;Cairu;1980;11048;5649;5399
2905503;Caldeirão Grande;1980;17077;4158;12919
2905602;Camacan;1980;40500;14997;25503
2905701;Camaçari;1980;89164;76123;13041
2905800;Camamu;1980;36160;6818;29342
2905909;Campo Alegre de Lourdes;1980;21574;2229;19345
2906006;Campo Formoso;1980;56692;11126;45566
2906105;Canápolis;1980;9439;1586;7853
2906204;Canarana;1980;25739;4599;21140
2906303;Canavieiras;1980;42122;14668;27454
2906402;Candeal;1980;10772;1824;8948
2906501;Candeias;1980;54081;42208;11873
2906600;Candiba;1980;11491;2546;8945
2906709;Cândido Sales;1980;18289;7921;10368
2906808;Cansanção;1980;24421;3316;21105
2906907;Caravelas;1980;41170;7105;34065
2907004;Cardeal da Silva;1980;4094;1206;2888
2907103;Carinhanha;1980;22275;5074;17201
2907202;Casa Nova;1980;39321;10943;28378
2907301;Castro Alves;1980;50547;13408;37139
2907400;Catolândia;1980;3170;366;2804
2907509;Catu;1980;37429;26351;11078
2907608;Central;1980;13858;5090;8768
2907707;Chorrochó;1980;10263;904;9359
2907806;Cícero Dantas;1980;37593;10137;27456
2907905;Cipó;1980;9032;4854;4178
2908002;Coaraci;1980;27412;16353;11059
2908101;Cocos;1980;15730;3528;12202
2908200;Conceição da Feira;1980;14422;6525;7897
2908309;Conceição do Almeida;1980;18407;6408;11999
2908408;Conceição do Coité;1980;41436;11770;29666
2908507;Conceição do Jacuípe;1980;18739;11079;7660
2908606;Conde;1980;15228;5734;9494
2908705;Condeúba;1980;25329;3184;22145
2908804;Contendas do Sincorá;1980;5919;2116;3803
2908903;Coração de Maria;1980;20943;4414;16529
2909000;Cordeiros;1980;7744;1253;6491
2909109;Coribe;1980;18849;2371;16478
2909208;Coronel João Sá;1980;12773;1768;11005
2909307;Correntina;1980;34783;4429;30354
2909406;Cotegipe;1980;22556;6432;16124
2909505;Cravolândia;1980;4805;1895;2910
2909604;Crisópolis;1980;14116;1697;12419
2909703;Cristópolis;1980;9972;1718;8254
2909802;Cruz das Almas;1980;37352;24551;12801
2909901;Curaçá;1980;20638;4650;15988
2910008;Dário Meira;1980;12935;3276;9659
2910107;Dom Basílio;1980;8696;690;8006
2910206;Dom Macedo Costa;1980;5473;580;4893
2910305;Elísio Medrado;1980;7722;1039;6683
2910404;Encruzilhada;1980;24748;2689;22059
2910503;Entre Rios;1980;22545;9761;12784
2910602;Esplanada;1980;19016;10527;8489
2910701;Euclides da Cunha;1980;50400;10023;40377
2910800;Feira de Santana;1980;291506;233631;57875
2910909;Firmino Alves;1980;6034;3648;2386
2911006;Floresta Azul;1980;18436;6727;11709
2911105;Formosa do Rio Preto;1980;11883;3630;8253
2911204;Gandu;1980;29270;13346;15924
2911303;Gentio do Ouro;1980;9192;2323;6869
2911402;Glória;1980;9877;1081;8796
2911501;Gongogi;1980;8343;4454;3889
2911600;Governador Mangabeira;1980;17002;5025;11977
2911709;Guanambi;1980;45526;24904;20622
2911808;Guaratinga;1980;30443;7170;23273
2911907;Iaçu;1980;25179;12885;12294
2912004;Ibiassucê;1980;10754;1277;9477
2912103;Ibicaraí;1980;30978;18160;12818
2912202;Ibicoara;1980;6025;452;5573
2912301;Ibicuí;1980;15615;6969;8646
2912400;Ibipeba;1980;11476;2241;9235
2912509;Ibipitanga;1980;12085;1268;10817
2912608;Ibiquera;1980;6708;1549;5159
2912707;Ibirapitanga;1980;20310;4634;15676
2912806;Ibirapuã;1980;9801;3428;6373
2912905;Ibirataia;1980;19977;9999;9978
2913002;Ibitiara;1980;21171;1588;19583
2913101;Ibititá;1980;15602;2635;12967
2913200;Ibotirama;1980;17166;9797;7369
2913309;Ichu;1980;5283;1060;4223
2913408;Igaporã;1980;11688;3495;8193
2913507;Iguaí;1980;23555;7193;16362
2913606;Ilhéus;1980;131456;80831;50625
2913705;Inhambupe;1980;22848;4999;17849
2913804;Ipecaetá;1980;17058;1179;15879
2913903;Ipiaú;1980;39075;27410;11665
2914000;Ipirá;1980;69756;12598;57158
2914109;Ipupiara;1980;6853;2951;3902
2914208;Irajuba;1980;7865;1383;6482
2914307;Iramaia;1980;12777;3948;8829
2914406;Iraquara;1980;14359;2393;11966
2914505;Irará;1980;20454;4736;15718
2914604;Irecê;1980;87922;37435;50487
2914703;Itaberaba;1980;45237;27548;17689
2914802;Itabuna;1980;153339;137724;15615
2914901;Itacaré;1980;13207;3005;10202
2915007;Itaeté;1980;15440;3408;12032
2915106;Itagi;1980;13428;5861;7567
2915205;Itagibá;1980;19006;4636;14370
2915304;Itagimirim;1980;7870;3784;4086
2915403;Itaju do Colônia;1980;10834;2839;7995
2915502;Itajuípe;1980;24986;12840;12146
2915601;Itamaraju;1980;77678;33109;44569
2915700;Itamari;1980;8097;3332;4765
2915809;Itambé;1980;25535;14564;10971
2915908;Itanagra;1980;4524;1302;3222
2916005;Itanhém;1980;27675;10873;16802
2916104;Itaparica;1980;10877;10346;531
2916203;Itapé;1980;11403;4950;6453
2916302;Itapebi;1980;11063;4597;6466
2916401;Itapetinga;1980;47418;39673;7745
2916500;Itapicuru;1980;19689;2886;16803
2916609;Itapitanga;1980;10387;5096;5291
2916708;Itaquara;1980;7755;2631;5124
2916807;Itarantim;1980;17126;7188;9938
2916906;Itiruçu;1980;9614;5639;3975
2917003;Itiúba;1980;30549;4714;25835
2917102;Itororó;1980;21860;9529;12331
2917201;Ituaçu;1980;13697;1709;11988
2917300;Ituberá;1980;27594;9560;18034
2917409;Jacaraci;1980;14278;1606;12672
2917508;Jacobina;1980;103967;36185;67782
2917607;Jaguaquara;1980;32775;16731;16044
2917706;Jaguarari;1980;23004;4826;18178
2917805;Jaguaripe;1980;10874;2842;8032
2917904;Jandaíra;1980;6603;2929;3674
2918001;Jequié;1980;116867;86925;29942
2918100;Jeremoabo;1980;33436;4991;28445
2918209;Jiquiriçá;1980;9356;2011;7345
2918308;Jitaúna;1980;16765;5552;11213
2918407;Juazeiro;1980;118175;64323;53852
2918506;Jussara;1980;12810;7207;5603
2918605;Jussiape;1980;8771;2564;6207
2918704;Lafaiete Coutinho;1980;4590;1104;3486
2918803;Laje;1980;15743;2987;12756
2918902;Lajedão;1980;4685;1945;2740
2919009;Lajedinho;1980;6897;723;6174
2919108;Lamarão;1980;9358;1360;7998
2919207;Lauro de Freitas;1980;35431;23405;12026
2919306;Lençóis;1980;5639;2617;3022
2919405;Licínio de Almeida;1980;12162;4111;8051
2919504;Livramento de Nossa Senhora;1980;29283;8905;20378
2919603;Macajuba;1980;9428;2067;7361
2919702;Macarani;1980;14099;6479;7620
2919801;Macaúbas;1980;31098;4988;26110
2919900;Macururé;1980;8296;1371;6925
2920007;Maiquinique;1980;7345;3056;4289
2920106;Mairi;1980;34481;5216;29265
2920205;Malhada;1980;19676;3937;15739
2920304;Malhada de Pedras;1980;6233;712;5521
2920403;Manoel Vitorino;1980;16633;2536;14097
2920502;Maracás;1980;25712;7806;17906
2920601;Maragogipe;1980;41248;20831;20417
2920700;Maraú;1980;14298;2065;12233
2920809;Marcionílio Souza;1980;10142;1947;8195
2920908;Mascote;1980;19227;1278;17949
2921005;Mata de São João;1980;32661;23727;8934
2921104;Medeiros Neto;1980;27460;14770;12690
2921203;Miguel Calmon;1980;23395;8408;14987
2921302;Milagres;1980;9020;5934;3086
2921401;Mirangaba;1980;13416;3187;10229
2921500;Monte Santo;1980;42178;3290;38888
2921609;Morpará;1980;7194;2808;4386
2921708;Morro do Chapéu;1980;31824;9674;22150
2921807;Mortugaba;1980;10714;2305;8409
2921906;Mucugê;1980;6545;1321;5224
2922003;Mucuri;1980;15144;2827;12317
2922102;Mundo Novo;1980;19594;7426;12168
2922201;Muniz Ferreira;1980;6049;1796;4253
2922300;Muritiba;1980;31118;13685;17433
2922409;Mutuípe;1980;17324;4426;12898
2922508;Nazaré;1980;23596;18032;5564
2922607;Nilo Peçanha;1980;7627;1199;6428
2922706;Nova Canaã;1980;13670;4758;8912
2922805;Nova Itarana;1980;7018;1182;5836
2922904;Nova Soure;1980;22839;5676;17163
2923001;Nova Viçosa;1980;18591;6092;12499
2923100;Olindina;1980;16572;6067;10505
2923209;Oliveira dos Brejinhos;1980;18343;2762;15581
2923308;Ouriçangas;1980;6343;1036;5307
2923407;Palmas de Monte Alto;1980;15724;2249;13475
2923506;Palmeiras;1980;6621;2656;3965
2923605;Paramirim;1980;21997;3552;18445
2923704;Paratinga;1980;20635;4926;15709
2923803;Paripiranga;1980;35442;5179;30263
2923902;Pau Brasil;1980;18776;8742;10034
2924009;Paulo Afonso;1980;71137;61965;9172
2924108;Pedrão;1980;7617;997;6620
2924207;Pedro Alexandre;1980;10097;1095;9002
2924306;Piatã;1980;16764;2030;14734
2924405;Pilão Arcado;1980;27912;2989;24923
2924504;Pindaí;1980;13126;1721;11405
2924603;Pindobaçu;1980;28332;2575;25757
2924702;Piripá;1980;10031;1909;8122
2924801;Piritiba;1980;16301;6536;9765
2924900;Planaltino;1980;9124;1620;7504
2925006;Planalto;1980;22359;5985;16374
2925105;Poções;1980;45521;16880;28641
2925204;Pojuca;1980;16112;11450;4662
2925303;Porto Seguro;1980;46300;5725;40575
2925402;Potiraguá;1980;11023;4116;6907
2925501;Prado;1980;26433;6898;19535
2925600;Presidente Dutra;1980;13144;5742;7402
2925709;Presidente Jânio Quadros;1980;19621;1236;18385
2925808;Queimadas;1980;27259;6310;20949
2925907;Quijingue;1980;19621;896;18725
2926004;Remanso;1980;28934;13012;15922
2926103;Retirolândia;1980;10402;2030;8372
2926202;Riachão das Neves;1980;18292;5950;12342
2926301;Riachão do Jacuípe;1980;62887;10187;52700
2926400;Riacho de Santana;1980;33116;6696;26420
2926509;Ribeira do Amparo;1980;24100;1974;22126
2926608;Ribeira do Pombal;1980;45679;13251;32428
2926707;Rio de Contas;1980;13628;3874;9754
2926806;Rio do Antônio;1980;11821;2521;9300
2926905;Rio do Pires;1980;10637;1889;8748
2927002;Rio Real;1980;19061;7115;11946
2927101;Rodelas;1980;4486;1717;2769
2927200;Ruy Barbosa;1980;31458;15081;16377
2927309;Salinas da Margarida;1980;7765;3384;4381
2927408;Salvador;1980;1502013;1499613;2400
2927507;Santa Bárbara;1980;15181;2721;12460
2927606;Santa Brígida;1980;9271;2016;7255
2927705;Santa Cruz Cabrália;1980;49375;1546;47829
2927804;Santa Cruz da Vitória;1980;6975;4363;2612
2927903;Santa Inês;1980;8451;6732;1719
2928000;Santaluz;1980;23119;7579;15540
2928109;Santa Maria da Vitória;1980;38759;17262;21497
2928208;Santana;1980;21898;8986;12912
2928307;Santanópolis;1980;9851;731;9120
2928406;Santa Rita de Cássia;1980;26362;6332;20030
2928505;Santa Terezinha;1980;17289;1076;16213
2928604;Santo Amaro;1980;57937;40990;16947
2928703;Santo Antônio de Jesus;1980;51582;34628;16954
2928802;Santo Estêvão;1980;30863;7387;23476
2928901;São Desidério;1980;14926;3143;11783
2929008;São Félix;1980;15241;7156;8085
2929107;São Felipe;1980;18680;5017;13663
2929206;São Francisco do Conde;1980;17838;7089;10749
2929305;São Gonçalo dos Campos;1980;21715;7465;14250
2929404;São Miguel das Matas;1980;9772;1519;8253
2929503;São Sebastião do Passé;1980;32312;19400;12912
2929602;Sapeaçu;1980;12937;4491;8446
2929701;Sátiro Dias;1980;12592;1511;11081
2929800;Saúde;1980;8476;2647;5829
2929909;Seabra;1980;23238;5759;17479
2930006;Sebastião Laranjeiras;1980;6404;1488;4916
2930105;Senhor do Bonfim;1980;63834;39702;24132
2930204;Sento Sé;1980;31674;8723;22951
2930303;Serra Dourada;1980;16641;2099;14542
2930402;Serra Preta;1980;19568;476;19092
2930501;Serrinha;1980;57467;25466;32001
2930600;Serrolândia;1980;22361;3704;18657
2930709;Simões Filho;1980;43571;25573;17998
2930808;Souto Soares;1980;12279;1252;11027
2930907;Tabocas do Brejo Velho;1980;10669;1817;8852
2931004;Tanhaçu;1980;13987;2784;11203
2931103;Tanquinho;1980;9827;4595;5232
2931202;Taperoá;1980;12132;4551;7581
2931301;Tapiramutá;1980;7953;3313;4640
2931400;Teodoro Sampaio;1980;9750;5775;3975
2931509;Teofilândia;1980;15095;1398;13697
2931608;Teolândia;1980;9253;1218;8035
2931707;Terra Nova;1980;12337;8296;4041
2931806;Tremedal;1980;34140;1768;32372
2931905;Tucano;1980;36493;6683;29810
2932002;Uauá;1980;20298;4531;15767
2932101;Ubaíra;1980;18206;5053;13153
2932200;Ubaitaba;1980;16030;9393;6637
2932309;Ubatã;1980;23248;16981;6267
2932408;Uibaí;1980;11606;5777;5829
2932507;Una;1980;37601;7233;30368
2932606;Urandi;1980;13295;2018;11277
2932705;Uruçuca;1980;21936;9571;12365
2932804;Utinga;1980;16154;3998;12156
2932903;Valença;1980;66277;31799;34478
2933000;Valente;1980;21791;4972;16819
2933109;Várzea do Poço;1980;9999;3386;6613
2933208;Vera Cruz;1980;13749;12053;1696
2933307;Vitória da Conquista;1980;170619;127512;43107
2933406;Wagner;1980;5351;2622;2729
2933505;Wenceslau Guimarães;1980;16302;2422;13880
2933604;Xique-Xique;1980;42321;20441;21880
3100104;Abadia dos Dourados;1980;8004;3055;4949
3100203;Abaeté;1980;17858;12890;4968
3100302;Abre Campo;1980;17712;4638;13074
3100401;Acaiaca;1980;3292;1429;1863
3100500;Açucena;1980;28537;12102;16435
3100609;Água Boa;1980;20626;3233;17393
3100708;Água Comprida;1980;1966;765;1201
3100807;Aguanil;1980;3173;905;2268
3100906;Águas Formosas;1980;22204;10621;11583
3101003;Águas Vermelhas;1980;14959;5890;9069
3101102;Aimorés;1980;28869;18351;10518
3101201;Aiuruoca;1980;7511;2112;5399
3101300;Alagoa;1980;3032;813;2219
3101409;Albertina;1980;2066;802;1264
3101508;Além Paraíba;1980;28829;23596;5233
3101607;Alfenas;1980;38271;32027;6244
3101706;Almenara;1980;38826;23497;15329
3101805;Alpercata;1980;5888;1628;4260
3101904;Alpinópolis;1980;17978;8938;9040
3102001;Alterosa;1980;10108;6307;3801
3102100;Alto Rio Doce;1980;14959;3331;11628
3102209;Alvarenga;1980;6085;1419;4666
3102308;Alvinópolis;1980;15047;7310;7737
3102407;Alvorada de Minas;1980;3966;704;3262
3102506;Amparo do Serra;1980;5941;1460;4481
3102605;Andradas;1980;24206;14468;9738
3102704;Cachoeira de Pajeú;1980;8234;1703;6531
3102803;Andrelândia;1980;14604;8697;5907
3102902;Antônio Carlos;1980;9618;3273;6345
3103009;Antônio Dias;1980;10663;3407;7256
3103108;Antônio Prado de Minas;1980;2128;549;1579
3103207;Araçaí;1980;1704;1294;410
3103306;Aracitaba;1980;2671;1240;1431
3103405;Araçuaí;1980;31367;12855;18512
3103504;Araguari;1980;83519;74267;9252
3103603;Arantina;1980;2911;2062;849
3103702;Araponga;1980;6625;1098;5527
3103801;Arapuá;1980;3408;989;2419
3103900;Araújos;1980;4695;3126;1569
3104007;Araxá;1980;53414;51339;2075
3104106;Arceburgo;1980;7215;4294;2921
3104205;Arcos;1980;22036;16698;5338
3104304;Areado;1980;9015;5670;3345
3104403;Argirita;1980;3799;1717;2082
3104502;Arinos;1980;14068;3901;10167
3104601;Astolfo Dutra;1980;10513;6771;3742
3104700;Ataléia;1980;21341;6067;15274
3104809;Augusto de Lima;1980;5959;1327;4632
3104908;Baependi;1980;15234;6589;8645
3105004;Baldim;1980;7567;3529;4038
3105103;Bambuí;1980;20544;14136;6408
3105202;Bandeira;1980;6178;1818;4360
3105301;Bandeira do Sul;1980;3347;2353;994
3105400;Barão de Cocais;1980;15293;12705;2588
3105509;Barão de Monte Alto;1980;6597;2905;3692
3105608;Barbacena;1980;86391;71821;14570
3105707;Barra Longa;1980;8928;1840;7088
3105905;Barroso;1980;14321;13243;1078
3106002;Bela Vista de Minas;1980;9915;8011;1904
3106101;Belmiro Braga;1980;3927;821;3106
3106200;Belo Horizonte;1980;1780839;1775073;5766
3106309;Belo Oriente;1980;12630;5662;6968
3106408;Belo Vale;1980;7247;2256;4991
3106507;Berilo;1980;17686;1303;16383
3106606;Bertópolis;1980;10267;3801;6466
3106705;Betim;1980;84193;76798;7395
3106804;Bias Fortes;1980;5044;1391;3653
3106903;Bicas;1980;10335;8601;1734
3107000;Biquinhas;1980;3487;699;2788
3107109;Boa Esperança;1980;25492;17362;8130
3107208;Bocaina de Minas;1980;5324;1501;3823
3107307;Bocaiúva;1980;40466;19976;20490
3107406;Bom Despacho;1980;29347;24350;4997
3107505;Bom Jardim de Minas;1980;7710;5128;2582
3107604;Bom Jesus da Penha;1980;2754;1048;1706
3107703;Bom Jesus do Amparo;1980;4322;1482;2840
3107802;Bom Jesus do Galho;1980;17446;5398;12048
3107901;Bom Repouso;1980;6933;1898;5035
3108008;Bom Sucesso;1980;16326;11097;5229
3108107;Bonfim;1980;7015;1704;5311
3108206;Bonfinópolis de Minas;1980;16387;2366;14021
3108305;Borda da Mata;1980;13468;6532;6936
3108404;Botelhos;1980;13473;6826;6647
3108503;Botumirim;1980;7087;1287;5800
3108602;Brasília de Minas;1980;40331;13360;26971
3108701;Brás Pires;1980;6026;923;5103
3108800;Braúnas;1980;6855;1079;5776
3108909;Brazópolis;1980;14263;6503;7760
3109006;Brumadinho;1980;18018;8606;9412
3109105;Bueno Brandão;1980;10285;3577;6708
3109204;Buenópolis;1980;9974;5023;4951
3109303;Buritis;1980;15429;5772;9657
3109402;Buritizeiro;1980;18269;9768;8501
3109501;Cabo Verde;1980;12065;4424;7641
3109600;Cachoeira da Prata;1980;2897;2530;367
3109709;Cachoeira de Minas;1980;8418;3110;5308
3109808;Cachoeira Dourada;1980;2366;1527;839
3109907;Caetanópolis;1980;5766;4942;824
3110004;Caeté;1980;30630;25123;5507
3110103;Caiana;1980;3710;1203;2507
3110202;Cajuri;1980;3938;1523;2415
3110301;Caldas;1980;13676;5290;8386
3110400;Camacho;1980;3548;1021;2527
3110509;Camanducaia;1980;12515;6061;6454
3110608;Cambuí;1980;17303;9777;7526
3110707;Cambuquira;1980;10611;7608;3003
3110806;Campanário;1980;9313;4626;4687
3110905;Campanha;1980;10511;7267;3244
3111002;Campestre;1980;17308;6674;10634
3111101;Campina Verde;1980;21152;11385;9767
3111200;Campo Belo;1980;37346;30552;6794
3111309;Campo do Meio;1980;9195;5442;3753
3111408;Campo Florido;1980;4962;1989;2973
3111507;Campos Altos;1980;10544;8602;1942
3111606;Campos Gerais;1980;21303;9415;11888
3111705;Canaã;1980;5325;927;4398
3111804;Canápolis;1980;7084;4153;2931
3111903;Cana Verde;1980;5169;2227;2942
3112000;Candeias;1980;12752;4816;7936
3112109;Caparaó;1980;5545;799;4746
3112208;Capela Nova;1980;5405;1846;3559
3112307;Capelinha;1980;23719;10500;13219
3112406;Capetinga;1980;6760;4028;2732
3112505;Capim Branco;1980;4930;2555;2375
3112604;Capinópolis;1980;13160;10034;3126
3112703;Capitão Enéas;1980;9934;5655;4279
3112802;Capitólio;1980;5222;2866;2356
3112901;Caputira;1980;6726;1701;5025
3113008;Caraí;1980;17343;3078;14265
3113107;Caranaíba;1980;4138;788;3350
3113206;Carandaí;1980;15621;9545;6076
3113305;Carangola;1980;33370;18893;14477
3113404;Caratinga;1980;110038;55302;54736
3113503;Carbonita;1980;8273;2375;5898
3113602;Careaçu;1980;5259;2906;2353
3113701;Carlos Chagas;1980;26901;12913;13988
3113800;Carmésia;1980;3037;889;2148
3113909;Carmo da Cachoeira;1980;8569;3946;4623
3114006;Carmo da Mata;1980;9545;5543;4002
3114105;Carmo de Minas;1980;9728;3624;6104
3114204;Carmo do Cajuru;1980;12504;7863;4641
3114303;Carmo do Paranaíba;1980;25382;15867;9515
3114402;Carmo do Rio Claro;1980;14830;7892;6938
3114501;Carmópolis de Minas;1980;11322;5311;6011
3114600;Carrancas;1980;4395;1446;2949
3114709;Carvalhópolis;1980;2324;1146;1178
3114808;Carvalhos;1980;5211;1566;3645
3114907;Casa Grande;1980;2209;679;1530
3115003;Cascalho Rico;1980;2447;694;1753
3115102;Cássia;1980;16448;10709;5739
3115201;Conceição da Barra de Minas;1980;3374;1865;1509
3115300;Cataguases;1980;49269;42315;6954
3115409;Catas Altas da Noruega;1980;3044;731;2313
3115508;Caxambu;1980;16867;16201;666
3115607;Cedro do Abaeté;1980;1495;971;524
3115706;Central de Minas;1980;6975;3420;3555
3115805;Centralina;1980;11239;8970;2269
3115904;Chácara;1980;3062;1096;1966
3116001;Chalé;1980;5475;1246;4229
3116100;Chapada do Norte;1980;14758;1204;13554
3116209;Chiador;1980;3898;983;2915
3116308;Cipotânea;1980;6331;1243;5088
3116407;Claraval;1980;3710;1026;2684
3116506;Claro dos Poções;1980;7982;3334;4648
3116605;Cláudio;1980;16056;9120;6936
3116704;Coimbra;1980;4738;2157;2581
3116803;Coluna;1980;9090;2166;6924
3116902;Comendador Gomes;1980;3224;656;2568
3117009;Comercinho;1980;9308;1436;7872
3117108;Conceição da Aparecida;1980;8246;4076;4170
3117207;Conceição das Pedras;1980;2139;581;1558
3117306;Conceição das Alagoas;1980;13549;9460;4089
3117405;Conceição de Ipanema;1980;5613;1225;4388
3117504;Conceição do Mato Dentro;1980;19766;7708;12058
3117603;Conceição do Pará;1980;3483;725;2758
3117702;Conceição do Rio Verde;1980;9900;6797;3103
3117801;Conceição dos Ouros;1980;6615;3211;3404
3117900;Congonhal;1980;5707;2828;2879
3118007;Congonhas;1980;30788;23752;7036
3118106;Congonhas do Norte;1980;4353;999;3354
3118205;Conquista;1980;7244;3890;3354
3118304;Conselheiro Lafaiete;1980;72445;66946;5499
3118403;Conselheiro Pena;1980;32238;19861;12377
3118502;Consolação;1980;1593;538;1055
3118601;Contagem;1980;280470;278119;2351
3118700;Coqueiral;1980;8137;3844;4293
3118809;Coração de Jesus;1980;30098;9219;20879
3118908;Cordisburgo;1980;7932;4125;3807
3119005;Cordislândia;1980;2678;1474;1204
3119104;Corinto;1980;23894;17536;6358
3119203;Coroaci;1980;10263;3417;6846
3119302;Coromandel;1980;20934;12112;8822
3119401;Coronel Fabriciano;1980;75701;73201;2500
3119500;Coronel Murta;1980;8322;3511;4811
3119609;Coronel Pacheco;1980;3291;1586;1705
3119708;Coronel Xavier Chaves;1980;3278;1403;1875
3119807;Córrego Danta;1980;5799;2130;3669
3119906;Córrego do Bom Jesus;1980;3514;725;2789
3120003;Córrego Novo;1980;7829;1295;6534
3120102;Couto de Magalhães de Minas;1980;3119;1984;1135
3120201;Cristais;1980;7920;3650;4270
3120300;Cristália;1980;4777;475;4302
3120409;Cristiano Otoni;1980;4049;2424;1625
3120508;Cristina;1980;9306;3555;5751
3120607;Crucilândia;1980;4306;1559;2747
3120706;Cruzeiro da Fortaleza;1980;2717;1677;1040
3120805;Cruzília;1980;10332;7268;3064
3120904;Curvelo;1980;50774;39838;10936
3121001;Datas;1980;3519;1609;1910
3121100;Delfim Moreira;1980;7297;1783;5514
3121209;Delfinópolis;1980;6389;3185;3204
3121308;Descoberto;1980;3895;1558;2337
3121407;Desterro de Entre Rios;1980;7335;1918;5417
3121506;Desterro do Melo;1980;3850;921;2929
3121605;Diamantina;1980;35925;26549;9376
3121704;Diogo de Vasconcelos;1980;4583;690;3893
3121803;Dionísio;1980;10003;4204;5799
3121902;Divinésia;1980;3132;929;2203
3122009;Divino;1980;21260;4750;16510
3122108;Divino das Laranjeiras;1980;5755;2137;3618
3122207;Divinolândia de Minas;1980;4848;3338;1510
3122306;Divinópolis;1980;117333;109596;7737
3122405;Divisa Nova;1980;3896;2070;1826
3122504;Dom Cavati;1980;6246;4514;1732
3122603;Dom Joaquim;1980;6233;2239;3994
3122702;Dom Silvério;1980;10021;3984;6037
3122801;Dom Viçoso;1980;2670;688;1982
3122900;Dona Eusébia;1980;3872;1783;2089
3123007;Dores de Campos;1980;6384;5127;1257
3123106;Dores de Guanhães;1980;5205;558;4647
3123205;Dores do Indaiá;1980;15196;13069;2127
3123304;Dores do Turvo;1980;4841;1149;3692
3123403;Doresópolis;1980;1561;535;1026
3123502;Douradoquara;1980;2125;848;1277
3123601;Elói Mendes;1980;16981;9328;7653
3123700;Engenheiro Caldas;1980;8501;3984;4517
3123809;Engenheiro Navarro;1980;6070;3152;2918
3123908;Entre Rios de Minas;1980;12943;6836;6107
3124005;Ervália;1980;13335;3519;9816
3124104;Esmeraldas;1980;16215;5331;10884
3124203;Espera Feliz;1980;11466;4681;6785
3124302;Espinosa;1980;32716;10350;22366
3124401;Espírito Santo do Dourado;1980;3551;800;2751
3124500;Estiva;1980;10601;3023;7578
3124609;Estrela Dalva;1980;2671;1449;1222
3124708;Estrela do Indaiá;1980;4305;2585;1720
3124807;Estrela do Sul;1980;7350;3440;3910
3124906;Eugenópolis;1980;9003;3599;5404
3125002;Ewbank da Câmara;1980;2991;1777;1214
3125101;Extrema;1980;10781;5843;4938
3125200;Fama;1980;1985;886;1099
3125309;Faria Lemos;1980;3500;1698;1802
3125408;Felício dos Santos;1980;4600;739;3861
3125507;São Gonçalo do Rio Preto;1980;2809;944;1865
3125606;Felisburgo;1980;5138;2775;2363
3125705;Felixlândia;1980;10654;5353;5301
3125804;Fernandes Tourinho;1980;3608;1215;2393
3125903;Ferros;1980;14450;3598;10852
3126000;Florestal;1980;4809;2657;2152
3126109;Formiga;1980;52394;37859;14535
3126208;Formoso;1980;5458;1390;4068
3126307;Fortaleza de Minas;1980;3819;1767;2052
3126406;Fortuna de Minas;1980;1898;908;990
3126505;Francisco Badaró;1980;15569;2153;13416
3126604;Francisco Dumont;1980;3577;815;2762
3126703;Francisco Sá;1980;24633;8408;16225
3126802;Frei Gaspar;1980;8449;1126;7323
3126901;Frei Inocêncio;1980;7462;3771;3691
3127008;Fronteira;1980;7050;5375;1675
3127057;Fronteira dos Vales;1980;5348;2057;3291
3127107;Frutal;1980;34271;23981;10290
3127206;Funilândia;1980;2400;682;1718
3127305;Galiléia;1980;12848;6518;6330
3127404;Gonçalves;1980;4249;848;3401
3127503;Gonzaga;1980;5511;1721;3790
3127602;Gouveia;1980;9326;5033;4293
3127701;Governador Valadares;1980;196117;177776;18341
3127800;Grão Mogol;1980;22199;4452;17747
3127909;Grupiara;1980;1359;824;535
3128006;Guanhães;1980;22778;13725;9053
3128105;Guapé;1980;11338;4223;7115
3128204;Guaraciaba;1980;10573;1612;8961
3128303;Guaranésia;1980;13442;8386;5056
3128402;Guarani;1980;7884;4041;3843
3128501;Guarará;1980;2847;2076;771
3128600;Guarda-Mor;1980;5137;1552;3585
3128709;Guaxupé;1980;30114;23653;6461
3128808;Guidoval;1980;7249;2638;4611
3128907;Guimarânia;1980;5447;3091;2356
3129004;Guiricema;1980;10443;2343;8100
3129103;Gurinhatã;1980;8908;1811;7097
3129202;Heliodora;1980;4773;2747;2026
3129301;Iapu;1980;14933;6733;8200
3129400;Ibertioga;1980;4634;1717;2917
3129509;Ibiá;1980;16107;11726;4381
3129608;Ibiaí;1980;5550;1668;3882
3129707;Ibiraci;1980;8030;3833;4197
3129806;Ibirité;1980;39967;27431;12536
3129905;Ibitiúra de Minas;1980;2616;1057;1559
3130002;Ibituruna;1980;2588;1614;974
3130101;Igarapé;1980;16561;11023;5538
3130200;Igaratinga;1980;4140;1710;2430
3130309;Iguatama;1980;6886;4246;2640
3130408;Ijaci;1980;3622;2402;1220
3130507;Ilicínea;1980;7499;4151;3348
3130606;Inconfidentes;1980;5653;2014;3639
3130705;Indianópolis;1980;3678;1637;2041
3130804;Ingaí;1980;2657;1151;1506
3130903;Inhapim;1980;32874;8078;24796
3131000;Inhaúma;1980;3854;1900;1954
3131109;Inimutaba;1980;5213;2881;2332
3131208;Ipanema;1980;17183;8471;8712
3131307;Ipatinga;1980;150318;149143;1175
3131406;Ipiaçu;1980;4254;3251;1003
3131505;Ipuiúna;1980;6689;3680;3009
3131604;Iraí de Minas;1980;3427;1166;2261
3131703;Itabira;1980;71114;58675;12439
3131802;Itabirinha;1980;10931;3408;7523
3131901;Itabirito;1980;26967;23369;3598
3132008;Itacambira;1980;8719;459;8260
3132107;Itacarambi;1980;16925;7023;9902
3132206;Itaguara;1980;9763;4926;4837
3132305;Itaipé;1980;14886;2616;12270
3132404;Itajubá;1980;60595;53653;6942
3132503;Itamarandiba;1980;28907;8172;20735
3132602;Itamarati de Minas;1980;2986;1520;1466
3132701;Itambacuri;1980;22970;11378;11592
3132800;Itambé do Mato Dentro;1980;3375;382;2993
3132909;Itamogi;1980;9007;4428;4579
3133006;Itamonte;1980;8118;3485;4633
3133105;Itanhandu;1980;9700;6939;2761
3133204;Itanhomi;1980;20682;6843;13839
3133303;Itaobim;1980;18161;10598;7563
3133402;Itapagipe;1980;11477;4544;6933
3133501;Itapecerica;1980;21751;12390;9361
3133600;Itapeva;1980;4729;1800;2929
3133709;Itatiaiuçu;1980;5426;2075;3351
3133808;Itaúna;1980;53438;49403;4035
3133907;Itaverava;1980;6214;1410;4804
3134004;Itinga;1980;23839;4096;19743
3134103;Itueta;1980;7049;2038;5011
3134202;Ituiutaba;1980;74240;65133;9107
3134301;Itumirim;1980;5059;3196;1863
3134400;Iturama;1980;47564;23193;24371
3134509;Itutinga;1980;3926;1997;1929
3134608;Jaboticatubas;1980;11569;3525;8044
3134707;Jacinto;1980;11832;4615;7217
3134806;Jacuí;1980;6572;2218;4354
3134905;Jacutinga;1980;11686;6264;5422
3135001;Jaguaraçu;1980;2051;898;1153
3135100;Janaúba;1980;43031;29859;13172
3135209;Januária;1980;71949;25190;46759
3135308;Japaraíba;1980;2853;758;2095
3135407;Jeceaba;1980;6390;2811;3579
3135506;Jequeri;1980;16514;4453;12061
3135605;Jequitaí;1980;8392;3356;5036
3135704;Jequitibá;1980;4789;975;3814
3135803;Jequitinhonha;1980;23267;11716;11551
3135902;Jesuânia;1980;4287;2040;2247
3136009;Joaíma;1980;18747;7070;11677
3136108;Joanésia;1980;7269;1531;5738
3136207;João Monlevade;1980;48198;47164;1034
3136306;João Pinheiro;1980;45858;19153;26705
3136405;Joaquim Felício;1980;4992;1869;3123
3136504;Jordânia;1980;8304;5151;3153
3136603;Nova União;1980;4066;682;3384
3136702;Juiz de Fora;1980;307534;301692;5842
3136801;Juramento;1980;6883;1879;5004
3136900;Juruaia;1980;5330;1494;3836
3137007;Ladainha;1980;16134;3502;12632
3137106;Lagamar;1980;9618;3506;6112
3137205;Lagoa da Prata;1980;24269;19971;4298
3137304;Lagoa dos Patos;1980;3919;1344;2575
3137403;Lagoa Dourada;1980;8733;3684;5049
3137502;Lagoa Formosa;1980;17550;6927;10623
3137601;Lagoa Santa;1980;19499;15376;4123
3137700;Lajinha;1980;16087;5512;10575
3137809;Lambari;1980;14070;9718;4352
3137908;Lamim;1980;3483;787;2696
3138005;Laranjal;1980;6154;3063;3091
3138104;Lassance;1980;6440;1534;4906
3138203;Lavras;1980;52710;45300;7410
3138302;Leandro Ferreira;1980;2803;966;1837
3138401;Leopoldina;1980;42118;30984;11134
3138500;Liberdade;1980;6392;2712;3680
3138609;Lima Duarte;1980;14309;7421;6888
3138708;Luminárias;1980;5363;2209;3154
3138807;Luz;1980;14436;10492;3944
3138906;Machacalis;1980;6322;4511;1811
3139003;Machado;1980;26731;16551;10180
3139102;Madre de Deus de Minas;1980;6474;2874;3600
3139201;Malacacheta;1980;36743;9729;27014
3139300;Manga;1980;33042;9783;23259
3139409;Manhuaçu;1980;57729;27294;30435
3139508;Manhumirim;1980;25818;12748;13070
3139607;Mantena;1980;39750;18310;21440
3139706;Maravilhas;1980;4812;2402;2410
3139805;Mar de Espanha;1980;7903;5369;2534
3139904;Maria da Fé;1980;11153;5083;6070
3140001;Mariana;1980;29401;19519;9882
3140100;Marilac;1980;4208;2459;1749
3140209;Maripá de Minas;1980;2233;1130;1103
3140308;Marliéria;1980;4111;801;3310
3140407;Marmelópolis;1980;2815;1098;1717
3140506;Martinho Campos;1980;9546;5637;3909
3140605;Materlândia;1980;5003;1157;3846
3140704;Mateus Leme;1980;18659;12135;6524
3140803;Matias Barbosa;1980;9405;8389;1016
3140902;Matipó;1980;11485;6518;4967
3141009;Mato Verde;1980;16897;5751;11146
3141108;Matozinhos;1980;16201;14357;1844
3141207;Matutina;1980;4270;2055;2215
3141306;Medeiros;1980;2507;919;1588
3141405;Medina;1980;22709;11181;11528
3141504;Mendes Pimentel;1980;15288;3527;11761
3141603;Mercês;1980;10119;4310;5809
3141702;Mesquita;1980;14494;4792;9702
3141801;Minas Novas;1980;27506;4418;23088
3141900;Minduri;1980;4101;2848;1253
3142007;Mirabela;1980;14573;6459;8114
3142106;Miradouro;1980;9350;3169;6181
3142205;Miraí;1980;13970;7183;6787
3142304;Moeda;1980;3952;1331;2621
3142403;Moema;1980;5080;3758;1322
3142502;Monjolos;1980;3126;1180;1946
3142601;Monsenhor Paulo;1980;5575;2811;2764
3142700;Montalvânia;1980;17874;7558;10316
3142809;Monte Alegre de Minas;1980;15110;8135;6975
3142908;Monte Azul;1980;34871;12692;22179
3143005;Monte Belo;1980;12204;4752;7452
3143104;Monte Carmelo;1980;26870;21679;5191
3143203;Monte Santo de Minas;1980;18621;9609;9012
3143302;Montes Claros;1980;177302;155295;22007
3143401;Monte Sião;1980;10936;4973;5963
3143500;Morada Nova de Minas;1980;6023;2957;3066
3143609;Morro da Garça;1980;2603;769;1834
3143708;Morro do Pilar;1980;4141;2072;2069
3143807;Munhoz;1980;4327;1716;2611
3143906;Muriaé;1980;69979;55185;14794
3144003;Mutum;1980;26036;8185;17851
3144102;Muzambinho;1980;15631;8780;6851
3144201;Nacip Raydan;1980;4356;1952;2404
3144300;Nanuque;1980;42734;36267;6467
3144409;Natércia;1980;4252;1705;2547
3144508;Nazareno;1980;6048;3963;2085
3144607;Nepomuceno;1980;21175;10800;10375
3144706;Nova Era;1980;14679;11700;2979
3144805;Nova Lima;1980;41217;35039;6178
3144904;Nova Módica;1980;5286;1720;3566
3145000;Nova Ponte;1980;5325;2953;2372
3145109;Nova Resende;1980;9936;3638;6298
3145208;Nova Serrana;1980;9266;6535;2731
3145307;Novo Cruzeiro;1980;31213;4860;26353
3145406;Olaria;1980;2227;551;1676
3145505;Olímpio Noronha;1980;2116;1015;1101
3145604;Oliveira;1980;29588;23395;6193
3145703;Oliveira Fortes;1980;2184;761;1423
3145802;Onça de Pitangui;1980;2774;505;2269
3145901;Ouro Branco;1980;12210;8399;3811
3146008;Ouro Fino;1980;22415;13643;8772
3146107;Ouro Preto;1980;53413;37996;15417
3146206;Ouro Verde de Minas;1980;9821;3132;6689
3146305;Padre Paraíso;1980;14855;7711;7144
3146404;Paineiras;1980;5890;2980;2910
3146503;Pains;1980;8123;4657;3466
3146602;Paiva;1980;1654;842;812
3146701;Palma;1980;7847;3751;4096
3146909;Papagaios;1980;6636;3924;2712
3147006;Paracatu;1980;49014;29900;19114
3147105;Pará de Minas;1980;44358;38030;6328
3147204;Paraguaçu;1980;14488;9370;5118
3147303;Paraisópolis;1980;13749;8853;4896
3147402;Paraopeba;1980;10836;8662;2174
3147501;Passabém;1980;2655;343;2312
3147600;Passa Quatro;1980;12046;7996;4050
3147709;Passa Tempo;1980;7645;3896;3749
3147808;Passa Vinte;1980;3792;1374;2418
3147907;Passos;1980;69046;56924;12122
3148004;Patos de Minas;1980;86121;63384;22737
3148103;Patrocínio;1980;44376;31202;13174
3148202;Patrocínio do Muriaé;1980;4335;1959;2376
3148301;Paula Cândido;1980;8200;2345;5855
3148400;Paulistas;1980;5515;1455;4060
3148509;Pavão;1980;10964;4113;6851
3148608;Peçanha;1980;22464;6244;16220
3148707;Pedra Azul;1980;20166;13658;6508
3148806;Pedra do Anta;1980;4122;959;3163
3148905;Pedra do Indaiá;1980;4565;1433;3132
3149002;Pedra Dourada;1980;1222;370;852
3149101;Pedralva;1980;9883;3406;6477
3149200;Pedrinópolis;1980;3670;2117;1553
3149309;Pedro Leopoldo;1980;30007;20884;9123
3149408;Pedro Teixeira;1980;1540;344;1196
3149507;Pequeri;1980;2680;2249;431
3149606;Pequi;1980;2959;1664;1295
3149705;Perdigão;1980;4381;2628;1753
3149804;Perdizes;1980;9238;2775;6463
3149903;Perdões;1980;14105;9993;4112
3150000;Pescador;1980;4245;2148;2097
3150109;Piau;1980;3427;1071;2356
3150208;Piedade de Ponte Nova;1980;4619;1923;2696
3150307;Piedade do Rio Grande;1980;5202;2298;2904
3150406;Piedade dos Gerais;1980;3810;587;3223
3150505;Pimenta;1980;5602;3674;1928
3150604;Piracema;1980;6321;1748;4573
3150703;Pirajuba;1980;2984;1730;1254
3150802;Piranga;1980;15928;3132;12796
3150901;Piranguçu;1980;4718;1117;3601
3151008;Piranguinho;1980;5542;2181;3361
3151107;Pirapetinga;1980;7357;4395;2962
3151206;Pirapora;1980;32672;31495;1177
3151305;Piraúba;1980;10251;4386;5865
3151404;Pitangui;1980;16335;12134;4201
3151503;Piumhi;1980;20926;17263;3663
3151602;Planura;1980;8168;6041;2127
3151701;Poço Fundo;1980;12414;5347;7067
3151800;Poços de Caldas;1980;86971;81416;5555
3151909;Pocrane;1980;12227;4071;8156
3152006;Pompéu;1980;17151;11000;6151
3152105;Ponte Nova;1980;50084;36812;13272
3152204;Porteirinha;1980;46052;11472;34580
3152303;Porto Firme;1980;9107;2101;7006
3152402;Poté;1980;15915;4642;11273
3152501;Pouso Alegre;1980;57362;50826;6536
3152600;Pouso Alto;1980;5219;2181;3038
3152709;Prados;1980;7078;3431;3647
3152808;Prata;1980;19559;8630;10929
3152907;Pratápolis;1980;18225;13940;4285
3153004;Pratinha;1980;2472;1061;1411
3153103;Presidente Bernardes;1980;6928;840;6088
3153202;Presidente Juscelino;1980;5602;1019;4583
3153301;Presidente Kubitschek;1980;2414;1057;1357
3153400;Presidente Olegário;1980;24241;8142;16099
3153509;Alto Jequitibá;1980;6677;2493;4184
3153608;Prudente de Morais;1980;4247;3012;1235
3153707;Quartel Geral;1980;3151;1815;1336
3153806;Queluzito;1980;1910;275;1635
3153905;Raposos;1980;11801;11052;749
3154002;Raul Soares;1980;32264;13452;18812
3154101;Recreio;1980;10762;7899;2863
3154200;Resende Costa;1980;8539;4222;4317
3154309;Resplendor;1980;19433;11757;7676
3154408;Ressaquinha;1980;9053;3457;5596
3154507;Riacho dos Machados;1980;8981;1036;7945
3154606;Ribeirão das Neves;1980;67249;61670;5579
3154705;Ribeirão Vermelho;1980;3568;2995;573
3154804;Rio Acima;1980;5073;3467;1606
3154903;Rio Casca;1980;15789;8360;7429
3155009;Rio Doce;1980;2777;1173;1604
3155108;Rio do Prado;1980;13428;4849;8579
3155207;Rio Espera;1980;7718;2038;5680
3155306;Rio Manso;1980;4445;727;3718
3155405;Rio Novo;1980;9588;5922;3666
3155504;Rio Paranaíba;1980;10768;3976;6792
3155603;Rio Pardo de Minas;1980;42749;4856;37893
3155702;Rio Piracicaba;1980;12613;9079;3534
3155801;Rio Pomba;1980;14057;9328;4729
3155900;Rio Preto;1980;8282;3756;4526
3156007;Rio Vermelho;1980;15089;2339;12750
3156106;Ritápolis;1980;5806;3046;2760
3156205;Rochedo de Minas;1980;1526;773;753
3156304;Rodeiro;1980;3244;1256;1988
3156403;Romaria;1980;2832;2209;623
3156502;Rubelita;1980;10667;1247;9420
3156601;Rubim;1980;12235;7145;5090
3156700;Sabará;1980;64210;58137;6073
3156809;Sabinópolis;1980;14899;6426;8473
3156908;Sacramento;1980;18792;10527;8265
3157005;Salinas;1980;48808;14207;34601
3157104;Salto da Divisa;1980;8401;4882;3519
3157203;Santa Bárbara;1980;18057;12431;5626
3157302;Santa Bárbara do Tugúrio;1980;5419;1015;4404
3157401;Santa Cruz do Escalvado;1980;7571;1335;6236
3157500;Santa Efigênia de Minas;1980;4506;1109;3397
3157609;Santa Fé de Minas;1980;3744;871;2873
3157708;Santa Juliana;1980;6031;3650;2381
3157807;Santa Luzia;1980;59893;51854;8039
3157906;Santa Margarida;1980;11123;3221;7902
3158003;Santa Maria de Itabira;1980;9491;3532;5959
3158102;Santa Maria do Salto;1980;4634;2335;2299
3158201;Santa Maria do Suaçuí;1980;19986;7989;11997
3158300;Santana da Vargem;1980;6346;2506;3840
3158409;Santana de Cataguases;1980;3204;1664;1540
3158508;Santana de Pirapama;1980;10060;1783;8277
3158607;Santana do Deserto;1980;3260;678;2582
3158706;Santana do Garambéu;1980;1639;511;1128
3158805;Santana do Jacaré;1980;3590;2888;702
3158904;Santana do Manhuaçu;1980;7750;2110;5640
3159001;Santana do Riacho;1980;3191;856;2335
3159100;Santana dos Montes;1980;4294;1289;3005
3159209;Santa Rita de Caldas;1980;9079;4084;4995
3159308;Santa Rita de Jacutinga;1980;7542;3117;4425
3159407;Santa Rita de Ibitipoca;1980;5367;1380;3987
3159506;Santa Rita do Itueto;1980;6937;824;6113
3159605;Santa Rita do Sapucaí;1980;22228;14987;7241
3159704;Santa Rosa da Serra;1980;2757;1284;1473
3159803;Santa Vitória;1980;17385;11139;6246
3159902;Santo Antônio do Amparo;1980;11785;6574;5211
3160009;Santo Antônio do Aventureiro;1980;3988;1321;2667
3160108;Santo Antônio do Grama;1980;4803;2061;2742
3160207;Santo Antônio do Itambé;1980;5356;765;4591
3160306;Santo Antônio do Jacinto;1980;12715;2380;10335
3160405;Santo Antônio do Monte;1980;14912;9346;5566
3160504;Santo Antônio do Rio Abaixo;1980;2707;505;2202
3160603;Santo Hipólito;1980;3647;1630;2017
3160702;Santos Dumont;1980;40005;32391;7614
3160801;São Bento Abade;1980;1782;1170;612
3160900;São Brás do Suaçuí;1980;2978;2138;840
3161007;São Domingos do Prata;1980;17742;6046;11696
3161106;São Francisco;1980;61886;13749;48137
3161205;São Francisco de Paula;1980;5451;2303;3148
3161304;São Francisco de Sales;1980;4441;1623;2818
3161403;São Francisco do Glória;1980;5522;2104;3418
3161502;São Geraldo;1980;7521;3572;3949
3161601;São Geraldo da Piedade;1980;4631;730;3901
3161700;São Gonçalo do Abaeté;1980;10875;3404;7471
3161809;São Gonçalo do Pará;1980;6227;4424;1803
3161908;São Gonçalo do Rio Abaixo;1980;10093;2434;7659
3162005;São Gonçalo do Sapucaí;1980;17498;12548;4950
3162104;São Gotardo;1980;17320;12535;4785
3162203;São João Batista do Glória;1980;4862;3158;1704
3162302;São João da Mata;1980;2051;916;1135
3162401;São João da Ponte;1980;33162;8140;25022
3162500;São João del Rei;1980;64691;56357;8334
3162609;São João do Oriente;1980;11993;6569;5424
3162708;São João do Paraíso;1980;23731;2705;21026
3162807;São João Evangelista;1980;15230;5798;9432
3162906;São João Nepomuceno;1980;17614;14208;3406
3163003;São José da Safira;1980;3852;2050;1802
3163102;São José da Varginha;1980;2030;682;1348
3163201;São José do Alegre;1980;2985;1306;1679
3163300;São José do Divino;1980;5327;1970;3357
3163409;São José do Goiabal;1980;6474;1795;4679
3163508;São José do Jacuri;1980;11363;1361;10002
3163607;São José do Mantimento;1980;2692;798;1894
3163706;São Lourenço;1980;24021;22981;1040
3163805;São Miguel do Anta;1980;5499;2136;3363
3163904;São Pedro da União;1980;4773;1322;3451
3164001;São Pedro dos Ferros;1980;11473;5589;5884
3164100;São Pedro do Suaçuí;1980;9111;1988;7123
3164209;São Romão;1980;12073;2504;9569
3164308;São Roque de Minas;1980;6434;2409;4025
3164407;São Sebastião da Bela Vista;1980;3164;1123;2041
3164506;São Sebastião do Maranhão;1980;12809;2426;10383
3164605;São Sebastião do Oeste;1980;5007;704;4303
3164704;São Sebastião do Paraíso;1980;39565;29935;9630
3164803;São Sebastião do Rio Preto;1980;2743;596;2147
3164902;São Sebastião do Rio Verde;1980;1681;559;1122
3165008;São Tiago;1980;8967;5000;3967
3165107;São Tomás de Aquino;1980;7323;3630;3693
3165206;São Thomé das Letras;1980;5292;1125;4167
3165305;São Vicente de Minas;1980;5569;3943;1626
3165404;Sapucaí-Mirim;1980;3701;1398;2303
3165503;Sardoá;1980;3724;932;2792
3165602;Senador Cortes;1980;1764;434;1330
3165701;Senador Firmino;1980;6757;2941;3816
3165800;Senador José Bento;1980;2129;472;1657
3165909;Senador Modestino Gonçalves;1980;5656;850;4806
3166006;Senhora de Oliveira;1980;4812;1749;3063
3166105;Senhora do Porto;1980;4640;1114;3526
3166204;Senhora dos Remédios;1980;9069;1761;7308
3166303;Sericita;1980;5413;1444;3969
3166402;Seritinga;1980;1675;905;770
3166501;Serra Azul de Minas;1980;3847;890;2957
3166600;Serra da Saudade;1980;1020;393;627
3166709;Serra dos Aimorés;1980;8096;5742;2354
3166808;Serra do Salitre;1980;6299;2930;3369
3166907;Serrania;1980;5729;3817;1912
3167004;Serranos;1980;2155;1287;868
3167103;Serro;1980;17369;7764;9605
3167202;Sete Lagoas;1980;100618;94592;6026
3167301;Silveirânia;1980;2075;526;1549
3167400;Silvianópolis;1980;5746;2590;3156
3167509;Simão Pereira;1980;2371;810;1561
3167608;Simonésia;1980;14443;2754;11689
3167707;Sobrália;1980;7613;2830;4783
3167806;Soledade de Minas;1980;4815;2534;2281
3167905;Tabuleiro;1980;4791;1852;2939
3168002;Taiobeiras;1980;19125;10260;8865
3168101;Tapira;1980;2723;968;1755
3168200;Tapiraí;1980;2387;874;1513
3168309;Taquaraçu de Minas;1980;3455;909;2546
3168408;Tarumirim;1980;23851;5745;18106
3168507;Teixeiras;1980;8586;3821;4765
3168606;Teófilo Otoni;1980;128826;87957;40869
3168705;Timóteo;1980;50601;46724;3877
3168804;Tiradentes;1980;7644;6130;1514
3168903;Tiros;1980;9842;3650;6192
3169000;Tocantins;1980;13159;5765;7394
3169109;Toledo;1980;4006;1007;2999
3169208;Tombos;1980;9198;5075;4123
3169307;Três Corações;1980;44382;36167;8215
3169356;Três Marias;1980;17624;14898;2726
3169406;Três Pontas;1980;37729;24342;13387
3169505;Tumiritinga;1980;5848;3287;2561
3169604;Tupaciguara;1980;25241;17600;7641
3169703;Turmalina;1980;17339;5138;12201
3169802;Turvolândia;1980;3440;912;2528
3169901;Ubá;1980;53306;43880;9426
3170008;Ubaí;1980;12303;1630;10673
3170107;Uberaba;1980;199208;182501;16707
3170206;Uberlândia;1980;240967;231583;9384
3170305;Umburatiba;1980;2821;1298;1523
3170404;Unaí;1980;67885;29841;38044
3170503;Urucânia;1980;9036;1842;7194
3170602;Vargem Bonita;1980;2510;782;1728
3170701;Varginha;1980;64904;57774;7130
3170800;Várzea da Palma;1980;18528;11955;6573
3170909;Varzelândia;1980;23181;6321;16860
3171006;Vazante;1980;14944;6658;8286
3171105;Veríssimo;1980;3414;1171;2243
3171204;Vespasiano;1980;25046;21096;3950
3171303;Viçosa;1980;38626;31110;7516
3171402;Vieiras;1980;4114;1180;2934
3171501;Mathias Lobato;1980;3053;2074;979
3171600;Virgem da Lapa;1980;13829;3378;10451
3171709;Virgínia;1980;8166;1997;6169
3171808;Virginópolis;1980;9926;3376;6550
3171907;Virgolândia;1980;9111;3004;6107
3172004;Visconde do Rio Branco;1980;26257;17297;8960
3172103;Volta Grande;1980;4765;2621;2144
3172202;Wenceslau Braz;1980;2528;1035;1493
3200102;Afonso Cláudio;1980;48288;9715;38573
3200201;Alegre;1980;33519;13591;19928
3200300;Alfredo Chaves;1980;10726;2982;7744
3200409;Anchieta;1980;11413;6131;5282
3200508;Apiacá;1980;6510;2642;3868
3200607;Aracruz;1980;35791;27400;8391
3200706;Atílio Vivacqua;1980;5952;1419;4533
3200805;Baixo Guandu;1980;25933;15038;10895
3200904;Barra de São Francisco;1980;51519;16935;34584
3201001;Boa Esperança;1980;11109;3404;7705
3201100;Bom Jesus do Norte;1980;6573;5614;959
3201209;Cachoeiro de Itapemirim;1980;123686;90467;33219
3201308;Cariacica;1980;189099;185298;3801
3201407;Castelo;1980;25885;9667;16218
3201506;Colatina;1980;111678;68096;43582
3201605;Conceição da Barra;1980;28384;6984;21400
3201704;Conceição do Castelo;1980;17324;4864;12460
3201803;Divino de São Lourenço;1980;3419;486;2933
3201902;Domingos Martins;1980;27584;5244;22340
3202009;Dores do Rio Preto;1980;4008;988;3020
3202108;Ecoporanga;1980;31399;9541;21858
3202207;Fundão;1980;9215;5750;3465
3202306;Guaçuí;1980;19405;13145;6260
3202405;Guarapari;1980;38500;32135;6365
3202504;Ibiraçu;1980;20234;12716;7518
3202603;Iconha;1980;8282;2208;6074
3202702;Itaguaçu;1980;13266;4495;8771
3202801;Itapemirim;1980;35113;17360;17753
3202900;Itarana;1980;8925;2096;6829
3203007;Iúna;1980;37622;11331;26291
3203106;Jerônimo Monteiro;1980;8291;3494;4797
3203205;Linhares;1980;123163;56772;66391
3203304;Mantenópolis;1980;13631;3931;9700
3203403;Mimoso do Sul;1980;23275;8953;14322
3203502;Montanha;1980;17394;11169;6225
3203601;Mucurici;1980;11531;1111;10420
3203700;Muniz Freire;1980;18964;4129;14835
3203809;Muqui;1980;12565;5608;6957
3203908;Nova Venécia;1980;45660;16988;28672
3204005;Pancas;1980;30095;7550;22545
3204104;Pinheiros;1980;20045;11857;8188
3204203;Piúma;1980;5345;3929;1416
3204302;Presidente Kennedy;1980;9801;1023;8778
3204401;Rio Novo do Sul;1980;8900;3503;5397
3204500;Santa Leopoldina;1980;24664;2660;22004
3204609;Santa Teresa;1980;25991;6716;19275
3204708;São Gabriel da Palha;1980;42296;15097;27199
3204807;São José do Calçado;1980;9141;4393;4748
3204906;São Mateus;1980;55080;27472;27608
3205002;Serra;1980;82568;80300;2268
3205101;Viana;1980;23440;18631;4809
3205200;Vila Velha;1980;203401;202375;1026
3205309;Vitória;1980;207736;207736;0
3300100;Angra dos Reis;1980;57869;29102;28767
3300209;Araruama;1980;49827;29262;20565
3300308;Barra do Piraí;1980;71930;55848;16082
3300407;Barra Mansa;1980;154719;135941;18778
3300506;Bom Jardim;1980;18534;6858;11676
3300605;Bom Jesus do Itabapoana;1980;27968;16752;11216
3300704;Cabo Frio;1980;70961;58464;12497
3300803;Cachoeiras de Macacu;1980;35871;19099;16772
3300902;Cambuci;1980;21038;7470;13568
3301009;Campos dos Goytacazes;1980;348542;203358;145184
3301108;Cantagalo;1980;19190;9270;9920
3301207;Carmo;1980;12270;5837;6433
3301306;Casimiro de Abreu;1980;22161;13709;8452
3301405;Conceição de Macabu;1980;13624;9658;3966
3301504;Cordeiro;1980;15354;13184;2170
3301603;Duas Barras;1980;7992;2758;5234
3301702;Duque de Caxias;1980;575830;555223;20607
3301801;Engenheiro Paulo de Frontin;1980;12917;6405;6512
3301900;Itaboraí;1980;114542;23645;90897
3302007;Itaguaí;1980;90131;76205;13926
3302106;Itaocara;1980;21309;9309;12000
3302205;Itaperuna;1980;63094;38866;24228
3302304;Laje do Muriaé;1980;7517;2786;4731
3302403;Macaé;1980;75863;55224;20639
3302502;Magé;1980;166603;163930;2673
3302601;Mangaratiba;1980;13841;8096;5745
3302700;Maricá;1980;32618;19588;13030
3302809;Mendes;1980;15532;10333;5199
3302908;Miguel Pereira;1980;14733;11537;3196
3303005;Miracema;1980;22005;16617;5388
3303104;Natividade;1980;19879;8536;11343
3303203;Nilópolis;1980;151585;151585;0
3303302;Niterói;1980;397135;397135;0
3303401;Nova Friburgo;1980;123383;107096;16287
3303500;Nova Iguaçu;1980;1094789;1091850;2939
3303609;Paracambi;1980;30310;27403;2907
3303708;Paraíba do Sul;1980;29245;22296;6949
3303807;Paraty;1980;20626;8816;11810
3303906;Petrópolis;1980;242017;202213;39804
3304003;Piraí;1980;28789;21819;6970
3304102;Porciúncula;1980;13452;7310;6142
3304201;Resende;1980;87338;67963;19375
3304300;Rio Bonito;1980;40038;22114;17924
3304409;Rio Claro;1980;12916;6448;6468
3304508;Rio das Flores;1980;6853;2612;4241
3304557;Rio de Janeiro;1980;5090723;5090723;0
3304607;Santa Maria Madalena;1980;11082;3564;7518
3304706;Santo Antônio de Pádua;1980;33520;19378;14142
3304805;São Fidélis;1980;34973;15263;19710
3304904;São Gonçalo;1980;615351;615351;0
3305000;São João da Barra;1980;54588;21066;33522
3305109;São João de Meriti;1980;398819;398819;0
3305208;São Pedro da Aldeia;1980;37508;29128;8380
3305307;São Sebastião do Alto;1980;8947;1587;7360
3305406;Sapucaia;1980;14946;7968;6978
3305505;Saquarema;1980;28200;21090;7110
3305604;Silva Jardim;1980;16828;4874;11954
3305703;Sumidouro;1980;11386;1400;9986
3305802;Teresópolis;1980;98705;78995;19710
3305901;Trajano de Moraes;1980;10624;2683;7941
3306008;Três Rios;1980;71170;57885;13285
3306107;Valença;1980;53583;39825;13758
3306206;Vassouras;1980;44318;19134;25184
3306305;Volta Redonda;1980;183620;180124;3496
3500105;Adamantina;1980;32049;24277;7772
3500204;Adolfo;1980;3607;1765;1842
3500303;Aguaí;1980;17056;12614;4442
3500402;Águas da Prata;1980;5717;4237;1480
3500501;Águas de Lindóia;1980;9161;8740;421
3500550;Águas de Santa Bárbara;1980;4632;2418;2214
3500600;Águas de São Pedro;1980;1091;1091;0
3500709;Agudos;1980;24478;19661;4817
3500808;Alfredo Marcondes;1980;4309;2104;2205
3500907;Altair;1980;2318;967;1351
3501004;Altinópolis;1980;12743;7348;5395
3501103;Alto Alegre;1980;6080;2200;3880
3501202;Álvares Florence;1980;6588;1825;4763
3501301;Álvares Machado;1980;14653;8921;5732
3501400;Álvaro de Carvalho;1980;3919;1708;2211
3501509;Alvinlândia;1980;3461;1352;2109
3501608;Americana;1980;121998;121735;263
3501707;Américo Brasiliense;1980;11864;9775;2089
3501806;Américo de Campos;1980;6874;3357;3517
3501905;Amparo;1980;41603;28740;12863
3502002;Analândia;1980;2312;1080;1232
3502101;Andradina;1980;47664;42086;5578
3502200;Angatuba;1980;17052;7243;9809
3502309;Anhembi;1980;3458;1723;1735
3502408;Anhumas;1980;3421;1442;1979
3502507;Aparecida;1980;29344;27602;1742
3502606;Aparecida d'Oeste;1980;5148;2848;2300
3502705;Apiaí;1980;26933;11928;15005
3502804;Araçatuba;1980;129307;116352;12955
3502903;Araçoiaba da Serra;1980;8539;4503;4036
3503000;Aramina;1980;3446;1785;1661
3503109;Arandu;1980;4164;1269;2895
3503208;Araraquara;1980;128122;118781;9341
3503307;Araras;1980;65010;54196;10814
3503406;Arealva;1980;6788;3254;3534
3503505;Areias;1980;3706;1477;2229
3503604;Areiópolis;1980;6765;3454;3311
3503703;Ariranha;1980;5538;3612;1926
3503802;Artur Nogueira;1980;15932;6968;8964
3503901;Arujá;1980;17487;16073;1414
3504008;Assis;1980;67357;61220;6137
3504107;Atibaia;1980;57820;48453;9367
3504206;Auriflama;1980;12031;7814;4217
3504305;Avaí;1980;5367;1939;3428
3504404;Avanhandava;1980;6399;4765;1634
3504503;Avaré;1980;46921;41072;5849
3504602;Bady Bassitt;1980;2834;1070;1764
3504701;Balbinos;1980;1186;446;740
3504800;Bálsamo;1980;5720;3764;1956
3504909;Bananal;1980;10969;5776;5193
3505005;Barão de Antonina;1980;3950;1313;2637
3505104;Barbosa;1980;5587;3446;2141
3505203;Bariri;1980;19894;15379;4515
3505302;Barra Bonita;1980;22594;20406;2188
3505401;Barra do Turvo;1980;4882;982;3900
3505500;Barretos;1980;72768;65710;7058
3505609;Barrinha;1980;12564;11565;999
3505708;Barueri;1980;75338;75338;0
3505807;Bastos;1980;15343;11664;3679
3505906;Batatais;1980;37283;30476;6807
3506003;Bauru;1980;186659;180772;5887
3506102;Bebedouro;1980;46034;39823;6211
3506201;Bento de Abreu;1980;2037;949;1088
3506300;Bernardino de Campos;1980;8994;6620;2374
3506409;Bilac;1980;5332;3599;1733
3506508;Birigui;1980;50893;45326;5567
3506607;Biritiba Mirim;1980;13374;7558;5816
3506706;Boa Esperança do Sul;1980;8352;4846;3506
3506805;Bocaina;1980;6774;4373;2401
3506904;Bofete;1980;4446;2145;2301
3507001;Boituva;1980;12573;10111;2462
3507100;Bom Jesus dos Perdões;1980;7096;5511;1585
3507209;Borá;1980;866;148;718
3507308;Boracéia;1980;3561;1578;1983
3507407;Borborema;1980;11635;6329;5306
3507506;Botucatu;1980;64545;58310;6235
3507605;Bragança Paulista;1980;84050;62651;21399
3507704;Braúna;1980;4551;2311;2240
3507803;Brodowski;1980;11201;9184;2017
3507902;Brotas;1980;11262;7530;3732
3508009;Buri;1980;11622;5051;6571
3508108;Buritama;1980;11564;9405;2159
3508207;Buritizal;1980;3868;1575;2293
3508306;Cabrália Paulista;1980;3447;1770;1677
3508405;Cabreúva;1980;11716;6591;5125
3508504;Caçapava;1980;51353;45202;6151
3508603;Cachoeira Paulista;1980;20557;16555;4002
3508702;Caconde;1980;16418;7966;8452
3508801;Cafelândia;1980;17480;9022;8458
3508900;Caiabu;1980;3702;1180;2522
3509007;Caieiras;1980;25156;22278;2878
3509106;Caiuá;1980;2971;1245;1726
3509205;Cajamar;1980;21942;19521;2421
3509304;Cajobi;1980;8290;5341;2949
3509403;Cajuru;1980;16240;10389;5851
3509502;Campinas;1980;664566;591415;73151
3509601;Campo Limpo Paulista;1980;21891;20584;1307
3509700;Campos do Jordão;1980;26105;23348;2757
3509809;Campos Novos Paulista;1980;3792;1813;1979
3509908;Cananéia;1980;7734;5748;1986
3510005;Cândido Mota;1980;19780;13550;6230
3510104;Cândido Rodrigues;1980;1991;953;1038
3510203;Capão Bonito;1980;45522;25294;20228
3510302;Capela do Alto;1980;7393;4330;3063
3510401;Capivari;1980;25175;19776;5399
3510500;Caraguatatuba;1980;33802;33215;587
3510609;Carapicuíba;1980;185822;185822;0
3510708;Cardoso;1980;12013;8770;3243
3510807;Casa Branca;1980;21744;14288;7456
3510906;Cássia dos Coqueiros;1980;2516;830;1686
3511003;Castilho;1980;12247;8095;4152
3511102;Catanduva;1980;72865;65966;6899
3511201;Catiguá;1980;5682;2459;3223
3511300;Cedral;1980;6203;2373;3830
3511409;Cerqueira César;1980;10726;7207;3519
3511508;Cerquilho;1980;12341;10239;2102
3511607;Cesário Lange;1980;7855;4143;3712
3511706;Charqueada;1980;8898;6571;2327
3511904;Clementina;1980;4298;1906;2392
3512001;Colina;1980;11607;7884;3723
3512100;Colômbia;1980;3372;1742;1630
3512209;Conchal;1980;13034;9357;3677
3512308;Conchas;1980;11038;7040;3998
3512407;Cordeirópolis;1980;9379;6606;2773
3512506;Coroados;1980;5648;2903;2745
3512605;Coronel Macedo;1980;6344;2794;3550
3512704;Corumbataí;1980;2784;951;1833
3512803;Cosmópolis;1980;23243;18886;4357
3512902;Cosmorama;1980;8638;2666;5972
3513009;Cotia;1980;62948;59996;2952
3513108;Cravinhos;1980;16935;13880;3055
3513207;Cristais Paulista;1980;4903;1413;3490
3513306;Cruzália;1980;4734;2031;2703
3513405;Cruzeiro;1980;57993;55173;2820
3513504;Cubatão;1980;78631;78314;317
3513603;Cunha;1980;20866;6449;14417
3513702;Descalvado;1980;20333;13736;6597
3513801;Diadema;1980;228663;228663;0
3513900;Divinolândia;1980;10266;4151;6115
3514007;Dobrada;1980;4377;2939;1438
3514106;Dois Córregos;1980;15482;12524;2958
3514205;Dolcinópolis;1980;2209;1286;923
3514304;Dourado;1980;6558;4691;1867
3514403;Dracena;1980;35973;28833;7140
3514502;Duartina;1980;12184;7410;4774
3514601;Dumont;1980;3311;2498;813
3514700;Echaporã;1980;5685;3324;2361
3514809;Eldorado;1980;11299;3570;7729
3514908;Elias Fausto;1980;8293;3963;4330
3515004;Embu das Artes;1980;95800;95800;0
3515103;Embu-Guaçu;1980;21038;19919;1119
3515186;Espírito Santo do Pinhal;1980;33359;23213;10146
3515202;Estrela d'Oeste;1980;9017;4435;4582
3515301;Estrela do Norte;1980;3290;1025;2265
3515400;Fartura;1980;12817;6537;6280
3515509;Fernandópolis;1980;46996;40492;6504
3515608;Fernando Prestes;1980;4423;2107;2316
3515707;Ferraz de Vasconcelos;1980;55046;54800;246
3515806;Flora Rica;1980;2740;1082;1658
3515905;Floreal;1980;3588;1813;1775
3516002;Flórida Paulista;1980;15180;6659;8521
3516101;Florínea;1980;2744;1604;1140
3516200;Franca;1980;148990;144091;4899
3516309;Francisco Morato;1980;28537;28317;220
3516408;Franco da Rocha;1980;50794;44029;6765
3516507;Gabriel Monteiro;1980;3009;944;2065
3516606;Gália;1980;11797;4535;7262
3516705;Garça;1980;39926;27251;12675
3516804;Gastão Vidigal;1980;3784;2070;1714
3516903;General Salgado;1980;11516;4568;6948
3517000;Getulina;1980;11054;5873;5181
3517109;Glicério;1980;4926;2129;2797
3517208;Guaiçara;1980;5354;2435;2919
3517307;Guaimbê;1980;5164;2306;2858
3517406;Guaíra;1980;25673;18986;6687
3517505;Guapiaçu;1980;6758;3399;3359
3517604;Guapiara;1980;16046;3359;12687
3517703;Guará;1980;13327;11927;1400
3517802;Guaraçaí;1980;8399;3881;4518
3517901;Guaraci;1980;6467;4821;1646
3518008;Guarani d'Oeste;1980;8300;1683;6617
3518107;Guarantã;1980;5716;2396;3320
3518206;Guararapes;1980;22515;17453;5062
3518305;Guararema;1980;15105;6963;8142
3518404;Guaratinguetá;1980;84864;72931;11933
3518503;Guareí;1980;6926;2102;4824
3518602;Guariba;1980;18887;16329;2558
3518701;Guarujá;1980;151120;151120;0
3518800;Guarulhos;1980;532724;426818;105906
3518909;Guzolândia;1980;4306;2376;1930
3519006;Herculândia;1980;7098;3875;3223
3519105;Iacanga;1980;6624;4415;2209
3519204;Iacri;1980;9199;3135;6064
3519303;Ibaté;1980;11448;8524;2924
3519402;Ibirá;1980;8260;5509;2751
3519501;Ibirarema;1980;4841;3199;1642
3519600;Ibitinga;1980;29141;23651;5490
3519709;Ibiúna;1980;31826;19025;12801
3519808;Icém;1980;5187;4464;723
3519907;Iepê;1980;9360;5997;3363
3520004;Igaraçu do Tietê;1980;12730;11637;1093
3520103;Igarapava;1980;20261;15316;4945
3520202;Igaratá;1980;4394;2174;2220
3520301;Iguape;1980;23363;16281;7082
3520400;Ilhabela;1980;7800;7571;229
3520509;Indaiatuba;1980;56243;48498;7745
3520608;Indiana;1980;4372;2885;1487
3520707;Indiaporã;1980;6547;5055;1492
3520806;Inúbia Paulista;1980;4290;1699;2591
3520905;Ipaussu;1980;10227;7021;3206
3521002;Iperó;1980;6606;3912;2694
3521101;Ipeúna;1980;1854;963;891
3521200;Iporanga;1980;4724;1202;3522
3521309;Ipuã;1980;9137;6995;2142
3521408;Iracemápolis;1980;8283;6299;1984
3521507;Irapuã;1980;7199;3228;3971
3521606;Irapuru;1980;9743;4818;4925
3521705;Itaberá;1980;16399;5659;10740
3521804;Itaí;1980;14553;5996;8557
3521903;Itajobi;1980;14503;5947;8556
3522000;Itaju;1980;2495;652;1843
3522109;Itanhaém;1980;27464;26183;1281
3522208;Itapecerica da Serra;1980;60473;57271;3202
3522307;Itapetininga;1980;84381;63403;20978
3522406;Itapeva;1980;65546;38349;27197
3522505;Itapevi;1980;53442;53442;0
3522604;Itapira;1980;47923;37146;10777
3522703;Itápolis;1980;25981;15309;10672
3522802;Itaporanga;1980;16456;7584;8872
3522901;Itapuí;1980;7613;4960;2653
3523008;Itapura;1980;3179;2629;550
3523107;Itaquaquecetuba;1980;73068;73068;0
3523206;Itararé;1980;37763;24362;13401
3523305;Itariri;1980;9448;4827;4621
3523404;Itatiba;1980;41630;35536;6094
3523503;Itatinga;1980;9218;5622;3596
3523602;Itirapina;1980;6929;5020;1909
3523701;Itirapuã;1980;4916;2896;2020
3523800;Itobi;1980;5762;3534;2228
3523909;Itu;1980;74203;63157;11046
3524006;Itupeva;1980;10189;3466;6723
3524105;Ituverava;1980;27501;23487;4014
3524204;Jaborandi;1980;5463;4319;1144
3524303;Jaboticabal;1980;46981;41004;5977
3524402;Jacareí;1980;115738;107860;7878
3524501;Jaci;1980;3801;1213;2588
3524600;Jacupiranga;1980;28558;17296;11262
3524709;Jaguariúna;1980;15213;9298;5915
3524808;Jales;1980;38601;28821;9780
3524907;Jambeiro;1980;2872;1013;1859
3525003;Jandira;1980;36043;36043;0
3525102;Jardinópolis;1980;19668;15662;4006
3525201;Jarinu;1980;6238;1187;5051
3525300;Jaú;1980;74012;62132;11880
3525409;Jeriquara;1980;2564;1549;1015
3525508;Joanópolis;1980;7754;3281;4473
3525607;João Ramalho;1980;2850;833;2017
3525706;José Bonifácio;1980;22968;14265;8703
3525805;Júlio Mesquita;1980;4590;2079;2511
3525904;Jundiaí;1980;258809;221810;36999
3526001;Junqueirópolis;1980;21373;10999;10374
3526100;Juquiá;1980;15161;7865;7296
3526209;Juquitiba;1980;12497;8621;3876
3526308;Lagoinha;1980;4441;1453;2988
3526407;Laranjal Paulista;1980;15172;12008;3164
3526506;Lavínia;1980;6159;3388;2771
3526605;Lavrinhas;1980;3674;1953;1721
3526704;Leme;1980;46253;41038;5215
3526803;Lençóis Paulista;1980;35011;29253;5758
3526902;Limeira;1980;150561;137814;12747
3527009;Lindóia;1980;3213;2613;600
3527108;Lins;1980;51038;44711;6327
3527207;Lorena;1980;57369;52878;4491
3527306;Louveira;1980;10322;8172;2150
3527405;Lucélia;1980;18709;12610;6099
3527504;Lucianópolis;1980;2624;938;1686
3527603;Luís Antônio;1980;2926;1259;1667
3527702;Luiziânia;1980;3865;2514;1351
3527801;Lupércio;1980;3492;1062;2430
3527900;Lutécia;1980;2997;1337;1660
3528007;Macatuba;1980;10859;6346;4513
3528106;Macaubal;1980;6387;3432;2955
3528205;Macedônia;1980;4215;1633;2582
3528304;Magda;1980;3571;1376;2195
3528403;Mairinque;1980;30828;23789;7039
3528502;Mairiporã;1980;27540;18937;8603
3528601;Manduri;1980;5361;2338;3023
3528700;Marabá Paulista;1980;3863;1281;2582
3528809;Maracaí;1980;10054;5600;4454
3528908;Mariápolis;1980;5326;2052;3274
3529005;Marília;1980;121768;107253;14515
3529104;Marinópolis;1980;2072;909;1163
3529203;Martinópolis;1980;19650;12643;7007
3529302;Matão;1980;38133;33431;4702
3529401;Mauá;1980;205736;205736;0
3529500;Mendonça;1980;3999;1293;2706
3529609;Meridiano;1980;3771;1467;2304
3529708;Miguelópolis;1980;13537;10576;2961
3529807;Mineiros do Tietê;1980;6708;5218;1490
3529906;Miracatu;1980;17359;5539;11820
3530003;Mira Estrela;1980;2439;1177;1262
3530102;Mirandópolis;1980;21522;14014;7508
3530201;Mirante do Paranapanema;1980;15459;8538;6921
3530300;Mirassol;1980;28309;25364;2945
3530409;Mirassolândia;1980;2701;736;1965
3530508;Mococa;1980;47313;35949;11364
3530607;Mogi das Cruzes;1980;197935;174981;22954
3530706;Mogi Guaçu;1980;73570;65465;8105
3530805;Mogi Mirim;1980;50633;42668;7965
3530904;Mombuca;1980;2659;761;1898
3531001;Monções;1980;2413;1076;1337
3531100;Mongaguá;1980;9928;9827;101
3531209;Monte Alegre do Sul;1980;4850;2015;2835
3531308;Monte Alto;1980;31231;25558;5673
3531407;Monte Aprazível;1980;16442;10494;5948
3531506;Monte Azul Paulista;1980;13021;9634;3387
3531605;Monte Castelo;1980;6140;1931;4209
3531704;Monteiro Lobato;1980;2687;658;2029
3531803;Monte Mor;1980;14020;6890;7130
3531902;Morro Agudo;1980;17444;11562;5882
3532009;Morungaba;1980;6528;4584;1944
3532108;Murutinga do Sul;1980;4580;2290;2290
3532207;Narandiba;1980;3533;1512;2021
3532306;Natividade da Serra;1980;6888;1911;4977
3532405;Nazaré Paulista;1980;8419;2481;5938
3532504;Neves Paulista;1980;7804;4379;3425
3532603;Nhandeara;1980;10223;5923;4300
3532702;Nipoã;1980;2737;1540;1197
3532801;Nova Aliança;1980;4287;1862;2425
3532900;Nova Europa;1980;4508;2018;2490
3533007;Nova Granada;1980;11440;8557;2883
3533106;Nova Guataporanga;1980;2708;1240;1468
3533205;Nova Independência;1980;1867;973;894
3533304;Nova Luzitânia;1980;1970;873;1097
3533403;Nova Odessa;1980;21891;19534;2357
3533502;Novo Horizonte;1980;26816;18705;8111
3533601;Nuporanga;1980;5062;3410;1652
3533700;Ocauçu;1980;4828;1479;3349
3533809;Óleo;1980;2996;1053;1943
3533908;Olímpia;1980;31787;25029;6758
3534005;Onda Verde;1980;2015;826;1189
3534104;Oriente;1980;6472;2552;3920
3534203;Orindiúva;1980;2118;1172;946
3534302;Orlândia;1980;25330;22933;2397
3534401;Osasco;1980;474544;474544;0
3534500;Oscar Bressane;1980;3077;1088;1989
3534609;Osvaldo Cruz;1980;26113;17624;8489
3534708;Ourinhos;1980;59738;52682;7056
3534807;Ouro Verde;1980;5854;3049;2805
3534906;Pacaembu;1980;15719;6903;8816
3535002;Palestina;1980;9018;5153;3865
3535101;Palmares Paulista;1980;4266;3005;1261
3535200;Palmeira d'Oeste;1980;12673;6126;6547
3535309;Palmital;1980;17129;10939;6190
3535408;Panorama;1980;8073;5736;2337
3535507;Paraguaçu Paulista;1980;23596;17933;5663
3535606;Paraibuna;1980;14126;5562;8564
3535705;Paraíso;1980;3617;1738;1879
3535804;Paranapanema;1980;11064;4140;6924
3535903;Paranapuã;1980;5789;3115;2674
3536000;Parapuã;1980;12273;5720;6553
3536109;Pardinho;1980;2746;960;1786
3536208;Pariquera-Açu;1980;11319;6200;5119
3536307;Patrocínio Paulista;1980;9016;4931;4085
3536406;Paulicéia;1980;2378;899;1479
3536505;Paulínia;1980;20753;19089;1664
3536604;Paulo de Faria;1980;6638;4958;1680
3536703;Pederneiras;1980;26107;19972;6135
3536802;Pedra Bela;1980;4686;650;4036
3536901;Pedranópolis;1980;3554;1134;2420
3537008;Pedregulho;1980;12919;6494;6425
3537107;Pedreira;1980;21381;19693;1688
3537206;Pedro de Toledo;1980;6060;2318;3742
3537305;Penápolis;1980;40332;32120;8212
3537404;Pereira Barreto;1980;46366;40744;5622
3537503;Pereiras;1980;3763;1584;2179
3537602;Peruíbe;1980;18411;17060;1351
3537701;Piacatu;1980;4741;1843;2898
3537800;Piedade;1980;35897;13137;22760
3537909;Pilar do Sul;1980;13857;8071;5786
3538006;Pindamonhangaba;1980;69568;62683;6885
3538105;Pindorama;1980;10188;6460;3728
3538204;Pinhalzinho;1980;6432;2145;4287
3538303;Piquerobi;1980;3545;1490;2055
3538501;Piquete;1980;14364;10308;4056
3538600;Piracaia;1980;13792;8202;5590
3538709;Piracicaba;1980;214307;197881;16426
3538808;Piraju;1980;21384;16247;5137
3538907;Pirajuí;1980;19423;13153;6270
3539004;Pirangi;1980;7587;5071;2516
3539103;Pirapora do Bom Jesus;1980;4814;2512;2302
3539202;Pirapozinho;1980;17918;14332;3586
3539301;Pirassununga;1980;44970;33313;11657
3539400;Piratininga;1980;10056;5837;4219
3539509;Pitangueiras;1980;18602;14393;4209
3539608;Planalto;1980;6041;2820;3221
3539707;Platina;1980;2279;907;1372
3539806;Poá;1980;52787;52522;265
3539905;Poloni;1980;4775;3131;1644
3540002;Pompéia;1980;16261;12075;4186
3540101;Pongaí;1980;3540;1659;1881
3540200;Pontal;1980;16751;12392;4359
3540309;Pontes Gestal;1980;2859;1378;1481
3540408;Populina;1980;4714;2857;1857
3540507;Porangaba;1980;6406;2885;3521
3540606;Porto Feliz;1980;27127;19740;7387
3540705;Porto Ferreira;1980;27991;25641;2350
3540804;Potirendaba;1980;10705;5584;5121
3540903;Pradópolis;1980;7827;6105;1722
3541000;Praia Grande;1980;66004;66004;0
3541109;Presidente Alves;1980;4866;1828;3038
3541208;Presidente Bernardes;1980;15784;8408;7376
3541307;Presidente Epitácio;1980;29608;23371;6237
3541406;Presidente Prudente;1980;136849;129624;7225
3541505;Presidente Venceslau;1980;30160;26715;3445
3541604;Promissão;1980;20222;15877;4345
3541703;Quatá;1980;8744;4127;4617
3541802;Queiroz;1980;2299;1302;997
3541901;Queluz;1980;7002;5092;1910
3542008;Quintana;1980;4905;3312;1593
3542107;Rafard;1980;5940;3796;2144
3542206;Rancharia;1980;23341;17953;5388
3542305;Redenção da Serra;1980;4001;1242;2759
3542404;Regente Feijó;1980;11083;8036;3047
3542503;Reginópolis;1980;4619;2456;2163
3542602;Registro;1980;39109;28696;10413
3542701;Restinga;1980;3541;1451;2090
3542800;Ribeira;1980;7463;1715;5748
3542909;Ribeirão Bonito;1980;8360;5790;2570
3543006;Ribeirão Branco;1980;13903;2034;11869
3543105;Ribeirão Corrente;1980;2741;1221;1520
3543204;Ribeirão do Sul;1980;3129;1535;1594
3543303;Ribeirão Pires;1980;56530;56530;0
3543402;Ribeirão Preto;1980;318544;308367;10177
3543501;Riversul;1980;11335;3757;7578
3543600;Rifaina;1980;3367;2613;754
3543709;Rincão;1980;7301;5002;2299
3543808;Rinópolis;1980;15161;6673;8488
3543907;Rio Claro;1980;110202;104101;6101
3544004;Rio das Pedras;1980;13472;10552;2920
3544103;Rio Grande da Serra;1980;20091;20091;0
3544202;Riolândia;1980;6836;4923;1913
3544301;Roseira;1980;4856;3986;870
3544400;Rubiácea;1980;2201;833;1368
3544509;Rubinéia;1980;2413;1188;1225
3544608;Sabino;1980;4829;2383;2446
3544707;Sagres;1980;3016;725;2291
3544806;Sales;1980;4791;1910;2881
3544905;Sales Oliveira;1980;6417;4170;2247
3545001;Salesópolis;1980;10657;5269;5388
3545100;Salmourão;1980;4778;1078;3700
3545209;Salto;1980;42379;42379;0
3545308;Salto de Pirapora;1980;14688;9502;5186
3545407;Salto Grande;1980;7011;4773;2238
3545506;Sandovalina;1980;2735;1131;1604
3545605;Santa Adélia;1980;10280;6952;3328
3545704;Santa Albertina;1980;6181;3358;2823
3545803;Santa Bárbara d'Oeste;1980;76628;71862;4766
3546009;Santa Branca;1980;8501;6628;1873
3546108;Santa Clara d'Oeste;1980;2653;1180;1473
3546207;Santa Cruz da Conceição;1980;2687;1012;1675
3546306;Santa Cruz das Palmeiras;1980;16085;12829;3256
3546405;Santa Cruz do Rio Pardo;1980;33616;22105;11511
3546504;Santa Ernestina;1980;3498;2441;1057
3546603;Santa Fé do Sul;1980;20370;17228;3142
3546702;Santa Gertrudes;1980;7987;6572;1415
3546801;Santa Isabel;1980;29013;18460;10553
3546900;Santa Lúcia;1980;5038;2984;2054
3547007;Santa Maria da Serra;1980;2852;1825;1027
3547106;Santa Mercedes;1980;4114;1495;2619
3547205;Santana da Ponte Pensa;1980;2794;860;1934
3547304;Santana de Parnaíba;1980;10098;3144;6954
3547403;Santa Rita d'Oeste;1980;4238;1471;2767
3547502;Santa Rita do Passa Quatro;1980;20876;13687;7189
3547601;Santa Rosa de Viterbo;1980;14431;11604;2827
3547700;Santo Anastácio;1980;21652;16280;5372
3547809;Santo André;1980;553077;553077;0
3547908;Santo Antônio da Alegria;1980;5291;2480;2811
3548005;Santo Antônio de Posse;1980;10877;7116;3761
3548104;Santo Antônio do Jardim;1980;5535;1665;3870
3548203;Santo Antônio do Pinhal;1980;5359;1790;3569
3548302;Santo Expedito;1980;2263;1280;983
3548401;Santópolis do Aguapeí;1980;3462;1856;1606
3548500;Santos;1980;416677;414703;1974
3548609;São Bento do Sapucaí;1980;9316;3663;5653
3548708;São Bernardo do Campo;1980;425611;384586;41025
3548807;São Caetano do Sul;1980;163086;163086;0
3548906;São Carlos;1980;119535;110236;9299
3549003;São Francisco;1980;4613;1965;2648
3549102;São João da Boa Vista;1980;55938;45729;10209
3549201;São João das Duas Pontes;1980;2963;1405;1558
3549300;São João do Pau d'Alho;1980;3600;1162;2438
3549409;São Joaquim da Barra;1980;29305;26277;3028
3549508;São José da Bela Vista;1980;6648;4358;2290
3549607;São José do Barreiro;1980;4034;1544;2490
3549706;São José do Rio Pardo;1980;36164;21865;14299
3549805;São José do Rio Preto;1980;188599;178970;9629
3549904;São José dos Campos;1980;287513;276873;10640
3550001;São Luiz do Paraitinga;1980;9750;3970;5780
3550100;São Manuel;1980;27549;19467;8082
3550209;São Miguel Arcanjo;1980;17145;7964;9181
3550308;São Paulo;1980;8493217;8337092;156125
3550407;São Pedro;1980;13175;10231;2944
3550506;São Pedro do Turvo;1980;7574;2547;5027
3550605;São Roque;1980;49548;31359;18189
3550704;São Sebastião;1980;18997;18598;399
3550803;São Sebastião da Grama;1980;11323;4622;6701
3550902;São Simão;1980;10676;8000;2676
3551009;São Vicente;1980;193008;192864;144
3551108;Sarapuí;1980;5179;1752;3427
3551207;Sarutaiá;1980;2974;1333;1641
3551306;Sebastianópolis do Sul;1980;2379;744;1635
3551405;Serra Azul;1980;4820;3698;1122
3551504;Serrana;1980;14379;12792;1587
3551603;Serra Negra;1980;17310;13514;3796
3551702;Sertãozinho;1980;51543;45433;6110
3551801;Sete Barras;1980;11274;3434;7840
3551900;Severínia;1980;7879;4483;3396
3552007;Silveiras;1980;3916;1125;2791
3552106;Socorro;1980;23657;12088;11569
3552205;Sorocaba;1980;269888;265975;3913
3552304;Sud Mennucci;1980;5361;2025;3336
3552403;Sumaré;1980;101851;95825;6026
3552502;Suzano;1980;101056;95152;5904
3552601;Tabapuã;1980;12313;5412;6901
3552700;Tabatinga;1980;7999;3885;4114
3552809;Taboão da Serra;1980;97656;97656;0
3552908;Taciba;1980;4524;2300;2224
3553005;Taguaí;1980;5744;2954;2790
3553104;Taiaçu;1980;3508;2361;1147
3553203;Taiúva;1980;4425;3167;1258
3553302;Tambaú;1980;15447;11617;3830
3553401;Tanabi;1980;20294;11474;8820
3553500;Tapiraí;1980;5093;1509;3584
3553609;Tapiratiba;1980;9867;3550;6317
3553708;Taquaritinga;1980;35929;29220;6709
3553807;Taquarituba;1980;16174;9658;6516
3553906;Tarabai;1980;3565;2176;1389
3554003;Tatuí;1980;55467;45244;10223
3554102;Taubaté;1980;169259;161431;7828
3554201;Tejupá;1980;4861;424;4437
3554300;Teodoro Sampaio;1980;26329;10752;15577
3554409;Terra Roxa;1980;5767;4048;1719
3554508;Tietê;1980;20042;15552;4490
3554607;Timburi;1980;3338;1074;2264
3554706;Torrinha;1980;6558;4577;1981
3554805;Tremembé;1980;18098;14907;3191
3554904;Três Fronteiras;1980;8713;3615;5098
3555000;Tupã;1980;56587;46278;10309
3555109;Tupi Paulista;1980;16348;9592;6756
3555208;Turiúba;1980;4004;1861;2143
3555307;Turmalina;1980;3015;860;2155
3555406;Ubatuba;1980;27139;24673;2466
3555505;Ubirajara;1980;4225;1876;2349
3555604;Uchoa;1980;7811;4286;3525
3555703;União Paulista;1980;1239;344;895
3555802;Urânia;1980;13493;6498;6995
3555901;Uru;1980;1591;458;1133
3556008;Urupês;1980;11991;6275;5716
3556107;Valentim Gentil;1980;5395;3433;1962
3556206;Valinhos;1980;48928;37450;11478
3556305;Valparaíso;1980;13297;9996;3301
3556404;Vargem Grande do Sul;1980;20363;16657;3706
3556503;Várzea Paulista;1980;33818;32645;1173
3556602;Vera Cruz;1980;11433;6878;4555
3556701;Vinhedo;1980;21647;21039;608
3556800;Viradouro;1980;10214;8635;1579
3556909;Vista Alegre do Alto;1980;2736;1570;1166
3557006;Votorantim;1980;53158;50455;2703
3557105;Votuporanga;1980;52279;45650;6629
3557204;Chavantes;1980;12968;8209;4759
4100103;Abatiá;1980;9642;3078;6564
4100202;Adrianópolis;1980;11122;1058;10064
4100301;Agudos do Sul;1980;5195;648;4547
4100400;Almirante Tamandaré;1980;34157;27054;7103
4100509;Altônia;1980;42763;11496;31267
4100608;Alto Paraná;1980;13348;6783;6565
4100707;Alto Piquiri;1980;22656;10407;12249
4100806;Alvorada do Sul;1980;12567;5236;7331
4100905;Amaporã;1980;3256;1825;1431
4101002;Ampére;1980;15628;5033;10595
4101101;Andirá;1980;17644;13506;4138
4101200;Antonina;1980;16304;12720;3584
4101309;Antônio Olinto;1980;6804;363;6441
4101408;Apucarana;1980;80245;67121;13124
4101507;Arapongas;1980;54670;48211;6459
4101606;Arapoti;1980;17103;4774;12329
4101705;Araruna;1980;14222;4536;9686
4101804;Araucária;1980;34789;27131;7658
4101903;Assaí;1980;22098;10109;11989
4102000;Assis Chateaubriand;1980;54629;28379;26250
4102109;Astorga;1980;20677;14180;6497
4102208;Atalaia;1980;4749;1991;2758
4102307;Balsa Nova;1980;5293;1262;4031
4102406;Bandeirantes;1980;33726;18974;14752
4102505;Barbosa Ferraz;1980;36156;10708;25448
4102604;Barracão;1980;18143;2707;15436
4102703;Barra do Jacaré;1980;4005;1038;2967
4102802;Bela Vista do Paraíso;1980;15003;11298;3705
4102901;Bituruna;1980;11703;3433;8270
4103008;Boa Esperança;1980;8487;1972;6515
4103107;Bocaiúva do Sul;1980;12115;2329;9786
4103206;Bom Sucesso;1980;9408;3483;5925
4103305;Borrazópolis;1980;15456;4962;10494
4103404;Cafeara;1980;3141;1173;1968
4103503;Califórnia;1980;8082;3408;4674
4103602;Cambará;1980;21359;13258;8101
4103701;Cambé;1980;53857;44830;9027
4103800;Cambira;1980;12026;2915;9111
4103909;Campina da Lagoa;1980;23110;10067;13043
4104006;Campina Grande do Sul;1980;9800;3787;6013
4104105;Campo do Tenente;1980;3847;1060;2787
4104204;Campo Largo;1980;54834;37366;17468
4104303;Campo Mourão;1980;75423;49339;26084
4104402;Cândido de Abreu;1980;18492;2348;16144
4104501;Capanema;1980;25779;7724;18055
4104600;Capitão Leônidas Marques;1980;40832;10316;30516
4104709;Carlópolis;1980;13528;5284;8244
4104808;Cascavel;1980;163470;123656;39814
4104907;Castro;1980;49815;25581;24234
4105003;Catanduvas;1980;36325;8625;27700
4105102;Centenário do Sul;1980;16392;7824;8568
4105201;Cerro Azul;1980;20006;2222;17784
4105300;Céu Azul;1980;25441;11792;13649
4105409;Chopinzinho;1980;35170;7707;27463
4105508;Cianorte;1980;48801;28810;19991
4105607;Cidade Gaúcha;1980;8240;4261;3979
4105706;Clevelândia;1980;16799;11977;4822
4105805;Colombo;1980;62882;54955;7927
4105904;Colorado;1980;17055;10313;6742
4106001;Congonhinhas;1980;8308;2746;5562
4106100;Conselheiro Mairinck;1980;3718;1472;2246
4106209;Contenda;1980;7558;3495;4063
4106308;Corbélia;1980;35898;13967;21931
4106407;Cornélio Procópio;1980;42588;31797;10791
4106506;Coronel Vivida;1980;26947;10126;16821
4106605;Cruzeiro do Oeste;1980;27279;15354;11925
4106704;Cruzeiro do Sul;1980;5704;1601;4103
4106803;Cruz Machado;1980;15149;1780;13369
4106902;Curitiba;1980;1024980;1024980;0
4107009;Curiúva;1980;19660;5121;14539
4107108;Diamante do Norte;1980;8408;3161;5247
4107207;Dois Vizinhos;1980;42468;12250;30218
4107306;Doutor Camargo;1980;6634;3232;3402
4107405;Enéas Marques;1980;14277;1706;12571
4107504;Engenheiro Beltrão;1980;15638;5813;9825
4107603;Faxinal;1980;25550;8953;16597
4107702;Fênix;1980;7444;3415;4029
4107801;Floraí;1980;6645;3879;2766
4107900;Floresta;1980;4297;2160;2137
4108007;Florestópolis;1980;12140;6317;5823
4108106;Flórida;1980;1985;1051;934
4108205;Formosa do Oeste;1980;36002;10005;25997
4108304;Foz do Iguaçu;1980;136352;101538;34814
4108320;Francisco Alves;1980;14715;4628;10087
4108403;Francisco Beltrão;1980;48765;28307;20458
4108502;General Carneiro;1980;8976;2973;6003
4108601;Goioerê;1980;48792;22311;26481
4108700;Grandes Rios;1980;35310;5102;30208
4108809;Guaíra;1980;29170;19599;9571
4108908;Guairaçá;1980;7099;2642;4457
4109005;Guapirama;1980;3168;1213;1955
4109104;Guaporema;1980;2705;942;1763
4109203;Guaraci;1980;5681;3213;2468
4109302;Guaraniaçu;1980;34465;7607;26858
4109401;Guarapuava;1980;158585;89926;68659
4109500;Guaraqueçaba;1980;7650;1282;6368
4109609;Guaratuba;1980;12178;8117;4061
4109708;Ibaiti;1980;28465;12219;16246
4109807;Ibiporã;1980;27621;20066;7555
4109906;Icaraíma;1980;16391;5789;10602
4110003;Iguaraçu;1980;6527;2092;4435
4110102;Imbituva;1980;21983;5792;16191
4110201;Inácio Martins;1980;10468;2072;8396
4110300;Inajá;1980;2684;1490;1194
4110409;Indianópolis;1980;9066;2574;6492
4110508;Ipiranga;1980;10106;2206;7900
4110607;Iporã;1980;37570;13449;24121
4110706;Irati;1980;42228;22755;19473
4110805;Iretama;1980;22109;4275;17834
4110904;Itaguajé;1980;5217;2970;2247
4111001;Itambaracá;1980;8655;3477;5178
4111100;Itambé;1980;6556;3346;3210
4111209;Itapejara d'Oeste;1980;10110;3064;7046
4111308;Itaúna do Sul;1980;4128;1697;2431
4111407;Ivaí;1980;10505;1758;8747
4111506;Ivaiporã;1980;62836;25596;37240
4111605;Ivatuba;1980;2550;1407;1143
4111704;Jaboti;1980;5190;1300;3890
4111803;Jacarezinho;1980;38922;23671;15251
4111902;Jaguapitã;1980;11987;5225;6762
4112009;Jaguariaíva;1980;15313;8723;6590
4112108;Jandaia do Sul;1980;17756;12685;5071
4112207;Janiópolis;1980;13741;3281;10460
4112306;Japira;1980;5774;1185;4589
4112405;Japurá;1980;10492;3313;7179
4112504;Jardim Alegre;1980;28636;7754;20882
4112603;Jardim Olinda;1980;1306;701;605
4112702;Jataizinho;1980;9551;6641;2910
4112801;Joaquim Távora;1980;10383;4907;5476
4112900;Jundiaí do Sul;1980;5406;2104;3302
4113007;Jussara;1980;5716;2981;2735
4113106;Kaloré;1980;8365;2276;6089
4113205;Lapa;1980;35031;14366;20665
4113304;Laranjeiras do Sul;1980;62838;21312;41526
4113403;Leópolis;1980;5180;1560;3620
4113502;Loanda;1980;19458;12571;6887
4113601;Lobato;1980;3413;1729;1684
4113700;Londrina;1980;301696;266931;34765
4113809;Lupionópolis;1980;5146;3152;1994
4113908;Mallet;1980;10041;3254;6787
4114005;Mamborê;1980;24646;8274;16372
4114104;Mandaguaçu;1980;14016;7153;6863
4114203;Mandaguari;1980;24475;14689;9786
4114302;Mandirituba;1980;15444;7212;8232
4114401;Mangueirinha;1980;21151;2278;18873
4114500;Manoel Ribas;1980;16228;2473;13755
4114609;Marechal Cândido Rondon;1980;56210;25039;31171
4114708;Maria Helena;1980;24957;5891;19066
4114807;Marialva;1980;42367;31247;11120
4114906;Marilândia do Sul;1980;13915;5827;8088
4115002;Marilena;1980;6975;2540;4435
4115101;Mariluz;1980;13448;7697;5751
4115200;Maringá;1980;168232;160652;7580
4115309;Mariópolis;1980;6199;2305;3894
4115408;Marmeleiro;1980;14388;3258;11130
4115507;Marumbi;1980;6733;2586;4147
4115606;Matelândia;1980;33440;10000;23440
4115705;Matinhos;1980;5676;4801;875
4115804;Medianeira;1980;49367;24368;24999
4115903;Mirador;1980;2037;853;1184
4116000;Miraselva;1980;5941;2149;3792
4116109;Moreira Sales;1980;18939;7517;11422
4116208;Morretes;1980;13245;5748;7497
4116307;Munhoz de Melo;1980;4914;1524;3390
4116406;Nossa Senhora das Graças;1980;4266;1591;2675
4116505;Nova Aliança do Ivaí;1980;1080;545;535
4116604;Nova América da Colina;1980;4479;1337;3142
4116703;Nova Aurora;1980;18391;6316;12075
4116802;Nova Cantu;1980;11789;2584;9205
4116901;Nova Esperança;1980;23932;15722;8210
4117008;Nova Fátima;1980;8200;4722;3478
4117107;Nova Londrina;1980;12113;9635;2478
4117206;Nova Olímpia;1980;6262;4006;2256
4117222;Nova Santa Rosa;1980;6895;1752;5143
4117305;Ortigueira;1980;50099;4518;45581
4117404;Ourizona;1980;4879;1767;3112
4117503;Paiçandu;1980;11970;8824;3146
4117602;Palmas;1980;30867;16723;14144
4117701;Palmeira;1980;24235;11688;12547
4117800;Palmital;1980;34066;4313;29753
4117909;Palotina;1980;28253;12854;15399
4118006;Paraíso do Norte;1980;7834;5087;2747
4118105;Paranacity;1980;8312;3673;4639
4118204;Paranaguá;1980;81971;72027;9944
4118303;Paranapoema;1980;2158;1145;1013
4118402;Paranavaí;1980;65286;54654;10632
4118501;Pato Branco;1980;45938;31477;14461
4118600;Paula Freitas;1980;4519;650;3869
4118709;Paulo Frontin;1980;5356;989;4367
4118808;Peabiru;1980;16966;7859;9107
4118907;Pérola;1980;21531;6858;14673
4119004;Pérola d'Oeste;1980;16684;2964;13720
4119103;Piên;1980;5985;264;5721
4119202;Pinhalão;1980;7268;2055;5213
4119301;Pinhão;1980;33460;12836;20624
4119400;Piraí do Sul;1980;17074;9463;7611
4119509;Piraquara;1980;70641;60954;9687
4119608;Pitanga;1980;84504;9423;75081
4119707;Planaltina do Paraná;1980;4688;2231;2457
4119806;Planalto;1980;20279;3635;16644
4119905;Ponta Grossa;1980;186656;172929;13727
4120002;Porecatu;1980;21464;13203;8261
4120101;Porto Amazonas;1980;2915;1905;1010
4120200;Porto Rico;1980;5344;1186;4158
4120309;Porto Vitória;1980;3520;1506;2014
4120408;Presidente Castelo Branco;1980;4773;1377;3396
4120507;Primeiro de Maio;1980;13217;7906;5311
4120606;Prudentópolis;1980;39723;8738;30985
4120705;Quatiguá;1980;5312;3006;2306
4120804;Quatro Barras;1980;5717;3499;2218
4120903;Quedas do Iguaçu;1980;31507;12872;18635
4121000;Querência do Norte;1980;9070;5567;3503
4121109;Quinta do Sol;1980;7688;2674;5014
4121208;Quitandinha;1980;12395;1586;10809
4121307;Rancho Alegre;1980;4899;2359;2540
4121406;Realeza;1980;21709;8772;12937
4121505;Rebouças;1980;10915;3835;7080
4121604;Renascença;1980;7909;2098;5811
4121703;Reserva;1980;23611;4058;19553
4121802;Ribeirão Claro;1980;12562;4687;7875
4121901;Ribeirão do Pinhal;1980;14837;7214;7623
4122008;Rio Azul;1980;10697;2528;8169
4122107;Rio Bom;1980;5015;1534;3481
4122206;Rio Branco do Sul;1980;31780;14423;17357
4122305;Rio Negro;1980;21665;15827;5838
4122404;Rolândia;1980;41452;26988;14464
4122503;Roncador;1980;17991;3434;14557
4122602;Rondon;1980;12999;3229;9770
4122701;Sabáudia;1980;4928;1820;3108
4122800;Salgado Filho;1980;15538;1562;13976
4122909;Salto do Itararé;1980;7482;2371;5111
4123006;Salto do Lontra;1980;34251;7090;27161
4123105;Santa Amélia;1980;4620;1950;2670
4123204;Santa Cecília do Pavão;1980;9871;4204;5667
4123303;Santa Cruz de Monte Castelo;1980;10002;4857;5145
4123402;Santa Fé;1980;9510;4935;4575
4123501;Santa Helena;1980;34882;7215;27667
4123600;Santa Inês;1980;2895;948;1947
4123709;Santa Isabel do Ivaí;1980;20242;8906;11336
4123808;Santa Izabel do Oeste;1980;15995;4427;11568
4123907;Santa Mariana;1980;15380;7599;7781
4124004;Santana do Itararé;1980;7530;2560;4970
4124103;Santo Antônio da Platina;1980;36781;21617;15164
4124202;Santo Antônio do Caiuá;1980;4043;2128;1915
4124301;Santo Antônio do Paraíso;1980;3360;1065;2295
4124400;Santo Antônio do Sudoeste;1980;35193;9090;26103
4124509;Santo Inácio;1980;5605;2891;2714
4124608;São Carlos do Ivaí;1980;4706;2401;2305
4124707;São Jerônimo da Serra;1980;16383;2982;13401
4124806;São João;1980;17084;3701;13383
4124905;São João do Caiuá;1980;7199;4302;2897
4125001;São João do Ivaí;1980;41293;11109;30184
4125100;São João do Triunfo;1980;10803;1896;8907
4125209;São Jorge d'Oeste;1980;13717;3943;9774
4125308;São Jorge do Ivaí;1980;9130;3503;5627
4125407;São José da Boa Vista;1980;9787;2063;7724
4125506;São José dos Pinhais;1980;70643;56814;13829
4125605;São Mateus do Sul;1980;26977;11418;15559
4125704;São Miguel do Iguaçu;1980;34241;7897;26344
4125803;São Pedro do Ivaí;1980;10464;4597;5867
4125902;São Pedro do Paraná;1980;4833;1271;3562
4126009;São Sebastião da Amoreira;1980;6931;2586;4345
4126108;São Tomé;1980;7160;2002;5158
4126207;Sapopema;1980;8416;1515;6901
4126306;Sengés;1980;13566;3955;9611
4126405;Sertaneja;1980;6928;4113;2815
4126504;Sertanópolis;1980;16492;7989;8503
4126603;Siqueira Campos;1980;15348;7690;7658
4126702;Tamboara;1980;5267;2333;2934
4126801;Tapejara;1980;12780;5454;7326
4126900;Tapira;1980;12470;3261;9209
4127007;Teixeira Soares;1980;12886;3082;9804
4127106;Telêmaco Borba;1980;54583;36200;18383
4127205;Terra Boa;1980;16267;7257;9010
4127304;Terra Rica;1980;16991;7603;9388
4127403;Terra Roxa;1980;25225;10707;14518
4127502;Tibagi;1980;20600;5627;14973
4127601;Tijucas do Sul;1980;8001;823;7178
4127700;Toledo;1980;81287;43029;38258
4127809;Tomazina;1980;15943;2587;13356
4127908;Tuneiras do Oeste;1980;12290;3272;9018
4128005;Ubiratã;1980;27326;13738;13588
4128104;Umuarama;1980;100555;59879;40676
4128203;União da Vitória;1980;39639;35517;4122
4128302;Uniflor;1980;3092;1040;2052
4128401;Uraí;1980;13974;7080;6894
4128500;Wenceslau Braz;1980;18452;9028;9424
4128609;Verê;1980;12268;1806;10462
4128708;Vitorino;1980;6830;2113;4717
4128807;Xambrê;1980;12126;2026;10100
4200101;Abelardo Luz;1980;17582;4573;13009
4200200;Agrolândia;1980;6139;1266;4873
4200309;Agronômica;1980;4549;510;4039
4200408;Água Doce;1980;8001;1833;6168
4200507;Águas de Chapecó;1980;6603;788;5815
4200606;Águas Mornas;1980;4626;746;3880
4200705;Alfredo Wagner;1980;9492;2099;7393
4200804;Anchieta;1980;10111;2882;7229
4200903;Angelina;1980;6669;666;6003
4201000;Anita Garibaldi;1980;15803;3466;12337
4201109;Anitápolis;1980;4598;565;4033
4201208;Antônio Carlos;1980;5412;710;4702
4201307;Araquari;1980;9674;7384;2290
4201406;Araranguá;1980;33679;25290;8389
4201505;Armazém;1980;5989;1109;4880
4201604;Arroio Trinta;1980;2945;1019;1926
4201703;Ascurra;1980;5420;3742;1678
4201802;Atalanta;1980;3487;616;2871
4201901;Aurora;1980;5275;408;4867
4202008;Balneário Camboriú;1980;21854;21580;274
4202107;Barra Velha;1980;11721;8707;3014
4202206;Benedito Novo;1980;10714;3765;6949
4202305;Biguaçu;1980;21441;16099;5342
4202404;Blumenau;1980;157251;146028;11223
4202503;Bom Jardim da Serra;1980;6413;1846;4567
4202602;Bom Retiro;1980;7946;3447;4499
4202701;Botuverá;1980;3587;474;3113
4202800;Braço do Norte;1980;11967;7022;4945
4202909;Brusque;1980;41228;37934;3294
4203006;Caçador;1980;39278;25621;13657
4203105;Caibi;1980;7288;1547;5741
4203204;Camboriú;1980;14038;9884;4154
4203303;Campo Alegre;1980;8311;2482;5829
4203402;Campo Belo do Sul;1980;13569;2880;10689
4203501;Campo Erê;1980;25335;3597;21738
4203600;Campos Novos;1980;43159;17017;26142
4203709;Canelinha;1980;7156;3202;3954
4203808;Canoinhas;1980;47272;28659;18613
4203907;Capinzal;1980;10395;4757;5638
4204004;Catanduvas;1980;10490;2466;8024
4204103;Caxambu do Sul;1980;9009;1778;7231
4204202;Chapecó;1980;83772;55226;28546
4204301;Concórdia;1980;59426;19578;39848
4204400;Coronel Freitas;1980;19168;3170;15998
4204509;Corupá;1980;8783;4429;4354
4204608;Criciúma;1980;110597;96368;14229
4204707;Cunha Porã;1980;16055;3440;12615
4204806;Curitibanos;1980;37712;27009;10703
4204905;Descanso;1980;17261;3249;14012
4205001;Dionísio Cerqueira;1980;16036;5355;10681
4205100;Dona Emma;1980;3482;810;2672
4205209;Erval Velho;1980;4955;1703;3252
4205308;Faxinal dos Guedes;1980;8476;3487;4989
4205407;Florianópolis;1980;187880;161795;26085
4205506;Fraiburgo;1980;15031;9009;6022
4205605;Galvão;1980;7991;1870;6121
4205704;Garopaba;1980;8238;2890;5348
4205803;Garuva;1980;7986;4999;2987
4205902;Gaspar;1980;25609;13714;11895
4206009;Governador Celso Ramos;1980;7814;4317;3497
4206108;Grão Pará;1980;6097;2305;3792
4206207;Gravatal;1980;8084;1982;6102
4206306;Guabiruba;1980;7150;4238;2912
4206405;Guaraciaba;1980;11893;1513;10380
4206504;Guaramirim;1980;10867;5039;5828
4206603;Guarujá do Sul;1980;4838;1306;3532
4206702;Herval d'Oeste;1980;15465;10050;5415
4206801;Ibicaré;1980;4212;788;3424
4206900;Ibirama;1980;23529;8256;15273
4207007;Içara;1980;24493;12015;12478
4207106;Ilhota;1980;8053;1413;6640
4207205;Imaruí;1980;18973;3659;15314
4207304;Imbituba;1980;25155;16574;8581
4207403;Imbuia;1980;3574;919;2655
4207502;Indaial;1980;28584;18255;10329
4207601;Ipira;1980;4899;832;4067
4207700;Ipumirim;1980;7112;1103;6009
4207809;Irani;1980;6268;564;5704
4207908;Irineópolis;1980;8761;1643;7118
4208005;Itá;1980;7815;1067;6748
4208104;Itaiópolis;1980;24538;5510;19028
4208203;Itajaí;1980;86456;78753;7703
4208302;Itapema;1980;6585;5274;1311
4208401;Itapiranga;1980;26487;4982;21505
4208500;Ituporanga;1980;17143;5310;11833
4208609;Jaborá;1980;4931;851;4080
4208708;Jacinto Machado;1980;12334;2356;9978
4208807;Jaguaruna;1980;14699;7423;7276
4208906;Jaraguá do Sul;1980;48538;32297;16241
4209003;Joaçaba;1980;24725;19230;5495
4209102;Joinville;1980;235803;222296;13507
4209201;Lacerdópolis;1980;2135;626;1509
4209300;Lages;1980;155295;123510;31785
4209409;Laguna;1980;39531;28325;11206
4209508;Laurentino;1980;4016;1594;2422
4209607;Lauro Müller;1980;13220;8739;4481
4209706;Lebon Régis;1980;8595;2804;5791
4209805;Leoberto Leal;1980;4237;294;3943
4209904;Lontras;1980;7335;3810;3525
4210001;Luiz Alves;1980;6480;1037;5443
4210100;Mafra;1980;40637;26804;13833
4210209;Major Gercino;1980;3846;844;3002
4210308;Major Vieira;1980;6550;629;5921
4210407;Maracajá;1980;4165;1469;2696
4210506;Maravilha;1980;22236;7181;15055
4210605;Massaranduba;1980;11986;2654;9332
4210704;Matos Costa;1980;4582;1351;3231
4210803;Meleiro;1980;10697;1798;8899
4210902;Modelo;1980;13869;2156;11713
4211009;Mondaí;1980;23928;5335;18593
4211108;Monte Castelo;1980;7680;2094;5586
4211207;Morro da Fumaça;1980;9071;4899;4172
4211306;Navegantes;1980;13532;8386;5146
4211405;Nova Erechim;1980;3252;1065;2187
4211504;Nova Trento;1980;9110;3604;5506
4211603;Nova Veneza;1980;9160;3604;5556
4211702;Orleans;1980;16382;6153;10229
4211801;Ouro;1980;5806;1556;4250
4211900;Palhoça;1980;38023;35073;2950
4212007;Palma Sola;1980;7333;1673;5660
4212106;Palmitos;1980;17748;5511;12237
4212205;Papanduva;1980;13457;4641;8816
4212304;Paulo Lopes;1980;5490;2147;3343
4212403;Pedras Grandes;1980;5249;711;4538
4212502;Penha;1980;9961;7454;2507
4212601;Peritiba;1980;2731;501;2230
4212700;Petrolândia;1980;6907;924;5983
4212809;Balneário Piçarras;1980;5593;3163;2430
4212908;Pinhalzinho;1980;9954;5211;4743
4213005;Pinheiro Preto;1980;2183;685;1498
4213104;Piratuba;1980;4803;1232;3571
4213203;Pomerode;1980;14377;8922;5455
4213302;Ponte Alta;1980;4926;2535;2391
4213401;Ponte Serrada;1980;12337;3549;8788
4213500;Porto Belo;1980;8419;7667;752
4213609;Porto União;1980;27713;19720;7993
4213708;Pouso Redondo;1980;10771;3211;7560
4213807;Praia Grande;1980;7608;1876;5732
4213906;Presidente Castello Branco;1980;1725;342;1383
4214003;Presidente Getúlio;1980;10114;4804;5310
4214102;Presidente Nereu;1980;3185;645;2540
4214201;Quilombo;1980;21453;3093;18360
4214300;Rancho Queimado;1980;2514;786;1728
4214409;Rio das Antas;1980;5447;1250;4197
4214508;Rio do Campo;1980;5795;1053;4742
4214607;Rio do Oeste;1980;7406;1553;5853
4214706;Rio dos Cedros;1980;8466;1869;6597
4214805;Rio do Sul;1980;36247;33353;2894
4214904;Rio Fortuna;1980;4010;669;3341
4215000;Rio Negrinho;1980;21008;17792;3216
4215109;Rodeio;1980;7972;4650;3322
4215208;Romelândia;1980;9468;1515;7953
4215307;Salete;1980;5577;1889;3688
4215406;Salto Veloso;1980;3317;1727;1590
4215505;Santa Cecília;1980;15566;6557;9009
4215604;Santa Rosa de Lima;1980;1723;120;1603
4215703;Santo Amaro da Imperatriz;1980;11316;5885;5431
4215802;São Bento do Sul;1980;35206;31594;3612
4215901;São Bonifácio;1980;3534;572;2962
4216008;São Carlos;1980;11625;3661;7964
4216107;São Domingos;1980;14035;3326;10709
4216206;São Francisco do Sul;1980;20599;17273;3326
4216305;São João Batista;1980;10693;5941;4752
4216404;São João do Sul;1980;7408;1784;5624
4216503;São Joaquim;1980;23624;13537;10087
4216602;São José;1980;87822;79170;8652
4216701;São José do Cedro;1980;17881;4526;13355
4216800;São José do Cerrito;1980;13368;1508;11860
4216909;São Lourenço do Oeste;1980;23891;8076;15815
4217006;São Ludgero;1980;4564;1644;2920
4217105;São Martinho;1980;3036;441;2595
4217204;São Miguel do Oeste;1980;35772;18790;16982
4217303;Saudades;1980;9293;1525;7768
4217402;Schroeder;1980;3990;1961;2029
4217501;Seara;1980;15996;3926;12070
4217600;Siderópolis;1980;12394;6540;5854
4217709;Sombrio;1980;17293;7039;10254
4217808;Taió;1980;18607;6225;12382
4217907;Tangará;1980;11644;3178;8466
4218004;Tijucas;1980;14608;8967;5641
4218103;Timbé do Sul;1980;5878;1072;4806
4218202;Timbó;1980;17927;14462;3465
4218301;Três Barras;1980;11338;5451;5887
4218400;Treze de Maio;1980;6565;804;5761
4218509;Treze Tílias;1980;3553;1496;2057
4218608;Trombudo Central;1980;7098;2288;4810
4218707;Tubarão;1980;75242;64536;10706
4218806;Turvo;1980;12205;3101;9104
4218905;Urubici;1980;12257;5164;7093
4219002;Urussanga;1980;21419;9794;11625
4219101;Vargeão;1980;2846;759;2087
4219200;Vidal Ramos;1980;8693;985;7708
4219309;Videira;1980;28152;18645;9507
4219408;Witmarsum;1980;3315;326;2989
4219507;Xanxerê;1980;30004;17621;12383
4219606;Xavantina;1980;5379;710;4669
4219705;Xaxim;1980;24504;6868;17636
4300109;Agudo;1980;15658;2432;13226
4300208;Ajuricaba;1980;11729;2909;8820
4300307;Alecrim;1980;13923;891;13032
4300406;Alegrete;1980;69466;55642;13824
4300505;Alpestre;1980;15303;1787;13516
4300604;Alvorada;1980;91384;90905;479
4300703;Anta Gorda;1980;7136;907;6229
4300802;Antônio Prado;1980;13030;5387;7643
4300901;Aratiba;1980;11765;1587;10178
4301008;Arroio do Meio;1980;19131;5427;13704
4301107;Arroio dos Ratos;1980;9580;8081;1499
4301206;Arroio do Tigre;1980;16183;2462;13721
4301305;Arroio Grande;1980;16653;10795;5858
4301404;Arvorezinha;1980;14886;3282;11604
4301503;Augusto Pestana;1980;8925;2098;6827
4301602;Bagé;1980;100133;69851;30282
4301701;Barão de Cotegipe;1980;7503;1768;5735
4301800;Barracão;1980;7168;1748;5420
4301909;Barra do Ribeiro;1980;10491;6076;4415
4302006;Barros Cassal;1980;14059;1860;12199
4302105;Bento Gonçalves;1980;58936;42067;16869
4302204;Boa Vista do Buricá;1980;8829;1753;7076
4302303;Bom Jesus;1980;16739;7754;8985
4302402;Bom Retiro do Sul;1980;8852;3491;5361
4302501;Bossoroca;1980;7435;2492;4943
4302600;Braga;1980;5780;1294;4486
4302709;Butiá;1980;21212;17903;3309
4302808;Caçapava do Sul;1980;32977;17396;15581
4302907;Cacequi;1980;15205;11407;3798
4303004;Cachoeira do Sul;1980;93341;62105;31236
4303103;Cachoeirinha;1980;63196;62752;444
4303202;Cacique Doble;1980;5997;1119;4878
4303301;Caibaté;1980;8382;2039;6343
4303400;Caiçara;1980;6952;1035;5917
4303509;Camaquã;1980;57353;32921;24432
4303608;Cambará do Sul;1980;6778;2938;3840
4303707;Campina das Missões;1980;8277;1335;6942
4303806;Campinas do Sul;1980;8680;2592;6088
4303905;Campo Bom;1980;33785;32162;1623
4304002;Campo Novo;1980;10717;4730;5987
4304200;Candelária;1980;26371;7164;19207
4304309;Cândido Godói;1980;8008;1000;7008
4304408;Canela;1980;19273;16590;2683
4304507;Canguçu;1980;55822;8855;46967
4304606;Canoas;1980;220446;214970;5476
4304705;Carazinho;1980;53681;43041;10640
4304804;Carlos Barbosa;1980;13651;6651;7000
4304903;Casca;1980;14301;3364;10937
4305009;Catuípe;1980;14667;5281;9386
4305108;Caxias do Sul;1980;220553;200314;20239
4305207;Cerro Largo;1980;19241;8882;10359
4305306;Chapada;1980;10217;2631;7586
4305405;Chiapetta;1980;4419;1387;3032
4305504;Ciríaco;1980;7792;1261;6531
4305603;Colorado;1980;4488;1066;3422
4305702;Condor;1980;6401;1748;4653
4305801;Constantina;1980;17034;3631;13403
4305900;Coronel Bicaco;1980;9237;3027;6210
4306007;Crissiumal;1980;19577;4842;14735
4306106;Cruz Alta;1980;66170;54933;11237
4306205;Cruzeiro do Sul;1980;9335;2036;7299
4306304;David Canabarro;1980;5295;478;4817
4306403;Dois Irmãos;1980;15205;9730;5475
4306502;Dom Feliciano;1980;12620;1038;11582
4306601;Dom Pedrito;1980;35150;26049;9101
4306700;Dona Francisca;1980;3121;1012;2109
4306809;Encantado;1980;17801;9702;8099
4306908;Encruzilhada do Sul;1980;27698;8490;19208
4307005;Erechim;1980;61115;48209;12906
4307104;Herval;1980;7280;2743;4537
4307203;Erval Grande;1980;7968;1396;6572
4307302;Erval Seco;1980;14824;2589;12235
4307401;Esmeralda;1980;6405;1795;4610
4307500;Espumoso;1980;31999;14297;17702
4307609;Estância Velha;1980;14229;12998;1231
4307708;Esteio;1980;50963;50206;757
4307807;Estrela;1980;37408;18656;18752
4307906;Farroupilha;1980;29000;16441;12559
4308003;Faxinal do Soturno;1980;8783;3404;5379
4308102;Feliz;1980;13305;3938;9367
4308201;Flores da Cunha;1980;15486;5473;10013
4308300;Fontoura Xavier;1980;14064;1494;12570
4308409;Formigueiro;1980;7876;963;6913
4308508;Frederico Westphalen;1980;29933;14219;15714
4308607;Garibaldi;1980;23038;11904;11134
4308706;Gaurama;1980;14222;2794;11428
4308805;General Câmara;1980;11696;4091;7605
4308904;Getúlio Vargas;1980;28116;12155;15961
4309001;Giruá;1980;28597;11200;17397
4309100;Gramado;1980;16322;11348;4974
4309209;Gravataí;1980;107437;80573;26864
4309308;Guaíba;1980;55041;44187;10854
4309407;Guaporé;1980;24630;11399;13231
4309506;Guarani das Missões;1980;11301;3426;7875
4309605;Horizontina;1980;24678;11734;12944
4309704;Humaitá;1980;9948;2933;7015
4309803;Ibiaçá;1980;6735;1754;4981
4309902;Ibiraiaras;1980;7617;1383;6234
4310009;Ibirubá;1980;19886;10004;9882
4310108;Igrejinha;1980;12027;8381;3646
4310207;Ijuí;1980;70929;53950;16979
4310306;Ilópolis;1980;3633;952;2681
4310405;Independência;1980;8317;2302;6015
4310504;Iraí;1980;13129;5589;7540
4310603;Itaqui;1980;33303;23540;9763
4310702;Itatiba do Sul;1980;6683;1160;5523
4310801;Ivoti;1980;8878;3881;4997
4310900;Jacutinga;1980;6532;1123;5409
4311007;Jaguarão;1980;23272;18208;5064
4311106;Jaguari;1980;15949;6028;9921
4311205;Júlio de Castilhos;1980;25620;14028;11592
4311304;Lagoa Vermelha;1980;28259;17436;10823
4311403;Lajeado;1980;63737;32554;31183
4311502;Lavras do Sul;1980;9225;4250;4975
4311601;Liberato Salzano;1980;10631;891;9740
4311700;Machadinho;1980;8098;2007;6091
4311809;Marau;1980;26997;9737;17260
4311908;Marcelino Ramos;1980;7769;3116;4653
4312005;Mariano Moro;1980;3345;591;2754
4312104;Mata;1980;6166;2079;4087
4312203;Maximiliano de Almeida;1980;6951;2076;4875
4312302;Miraguaí;1980;7681;1760;5921
4312401;Montenegro;1980;48816;29100;19716
4312500;Mostardas;1980;12969;2552;10417
4312609;Muçum;1980;7910;2809;5101
4312658;Não-Me-Toque;1980;12771;8211;4560
4312708;Nonoai;1980;28439;5686;22753
4312807;Nova Araçá;1980;2251;1024;1227
4312906;Nova Bassano;1980;6269;1551;4718
4313003;Nova Bréscia;1980;6996;982;6014
4313102;Nova Palma;1980;8031;1474;6557
4313201;Nova Petrópolis;1980;13873;4389;9484
4313300;Nova Prata;1980;21116;9200;11916
4313409;Novo Hamburgo;1980;136494;133206;3288
4313508;Osório;1980;60512;36494;24018
4313607;Paim Filho;1980;10644;2204;8440
4313706;Palmeira das Missões;1980;65996;27440;38556
4313805;Palmitinho;1980;13576;1002;12574
4313904;Panambi;1980;23870;17970;5900
4314001;Paraí;1980;4527;813;3714
4314100;Passo Fundo;1980;121155;105472;15683
4314209;Pedro Osório;1980;15020;9396;5624
4314308;Pejuçara;1980;3573;1575;1998
4314407;Pelotas;1980;259994;204817;55177
4314506;Pinheiro Machado;1980;14359;6094;8265
4314605;Piratini;1980;20124;5570;14554
4314704;Planalto;1980;17700;4442;13258
4314803;Portão;1980;10729;7925;2804
4314902;Porto Alegre;1980;1125478;1114851;10627
4315008;Porto Lucena;1980;12211;2385;9826
4315107;Porto Xavier;1980;12193;3028;9165
4315206;Putinga;1980;6146;778;5368
4315305;Quaraí;1980;19442;15107;4335
4315404;Redentora;1980;10340;2009;8331
4315503;Restinga Sêca;1980;14435;4615;9820
4315602;Rio Grande;1980;146114;137142;8972
4315701;Rio Pardo;1980;50147;25770;24377
4315800;Roca Sales;1980;8824;2280;6544
4315909;Rodeio Bonito;1980;13518;2157;11361
4316006;Rolante;1980;11769;5491;6278
4316105;Ronda Alta;1980;16648;3369;13279
4316204;Rondinha;1980;8505;1625;6880
4316303;Roque Gonzales;1980;9758;1566;8192
4316402;Rosário do Sul;1980;39258;30727;8531
4316501;Salvador do Sul;1980;14326;1957;12369
4316600;Sananduva;1980;14159;5295;8864
4316709;Santa Bárbara do Sul;1980;12372;6344;6028
4316808;Santa Cruz do Sul;1980;99645;55152;44493
4316907;Santa Maria;1980;181571;154528;27043
4317004;Santana da Boa Vista;1980;8911;1760;7151
4317103;Sant'Ana do Livramento;1980;68105;58222;9883
4317202;Santa Rosa;1980;52227;40371;11856
4317301;Santa Vitória do Palmar;1980;27172;15878;11294
4317400;Santiago;1980;46624;31362;15262
4317509;Santo Ângelo;1980;93667;54980;38687
4317608;Santo Antônio da Patrulha;1980;41363;16330;25033
4317707;Santo Antônio das Missões;1980;12679;3979;8700
4317806;Santo Augusto;1980;17462;9321;8141
4317905;Santo Cristo;1980;15314;3184;12130
4318002;São Borja;1980;58217;42226;15991
4318101;São Francisco de Assis;1980;25734;12259;13475
4318200;São Francisco de Paula;1980;23137;9899;13238
4318309;São Gabriel;1980;56736;41559;15177
4318408;São Jerônimo;1980;46867;29250;17617
4318507;São José do Norte;1980;21751;7796;13955
4318606;São José do Ouro;1980;12257;3873;8384
4318705;São Leopoldo;1980;98588;94868;3720
4318804;São Lourenço do Sul;1980;41597;14041;27556
4318903;São Luiz Gonzaga;1980;47533;30684;16849
4319000;São Marcos;1980;11813;7970;3843
4319109;São Martinho;1980;8037;2238;5799
4319208;São Nicolau;1980;11980;1935;10045
4319307;São Paulo das Missões;1980;9565;1182;8383
4319406;São Pedro do Sul;1980;20992;7865;13127
4319505;São Sebastião do Caí;1980;27180;14489;12691
4319604;São Sepé;1980;26866;11906;14960
4319703;São Valentim;1980;15795;2620;13175
4319802;São Vicente do Sul;1980;7349;3271;4078
4319901;Sapiranga;1980;37288;30776;6512
4320008;Sapucaia do Sul;1980;79361;78846;515
4320107;Sarandi;1980;20546;10130;10416
4320206;Seberi;1980;15502;3969;11533
4320305;Selbach;1980;4471;838;3633
4320404;Serafina Corrêa;1980;9320;3780;5540
4320503;Sertão;1980;9032;2215;6817
4320602;Severiano de Almeida;1980;4430;494;3936
4320701;Sobradinho;1980;29042;9136;19906
4320800;Soledade;1980;47576;17136;30440
4320909;Tapejara;1980;21138;6573;14565
4321006;Tapera;1980;10361;5883;4478
4321105;Tapes;1980;23729;8868;14861
4321204;Taquara;1980;41376;30342;11034
4321303;Taquari;1980;28922;13156;15766
4321402;Tenente Portela;1980;30643;8816;21827
4321501;Torres;1980;41619;18403;23216
4321600;Tramandaí;1980;19217;17958;1259
4321709;Três Coroas;1980;10470;6862;3608
4321808;Três de Maio;1980;33051;13610;19441
4321907;Três Passos;1980;45623;15422;30201
4322004;Triunfo;1980;13854;6782;7072
4322103;Tucunduva;1980;13864;3772;10092
4322202;Tupanciretã;1980;26644;13999;12645
4322301;Tuparendi;1980;13905;3973;9932
4322400;Uruguaiana;1980;91498;81273;10225
4322509;Vacaria;1980;58562;40397;18165
4322608;Venâncio Aires;1980;48274;16639;31635
4322707;Vera Cruz;1980;13932;4771;9161
4322806;Veranópolis;1980;23239;9964;13275
4322905;Viadutos;1980;8754;1664;7090
4323002;Viamão;1980;117670;106636;11034
4323101;Vicente Dutra;1980;8584;1691;6893
4323200;Victor Graeff;1980;4125;660;3465
5000203;Água Clara;1980;4807;1356;3451
5000609;Amambai;1980;58534;31441;27093
5000708;Anastácio;1980;21939;11882;10057
5000807;Anaurilândia;1980;7222;2843;4379
5000856;Angélica;1980;10535;5394;5141
5000906;Antônio João;1980;5668;3821;1847
5001003;Aparecida do Taboado;1980;14027;9100;4927
5001102;Aquidauana;1980;34493;23545;10948
5001243;Aral Moreira;1980;10121;2317;7804
5001508;Bandeirantes;1980;6808;3501;3307
5001904;Bataguassu;1980;9202;4230;4972
5002001;Batayporã;1980;14144;4410;9734
5002100;Bela Vista;1980;15601;11912;3689
5002209;Bonito;1980;11002;5114;5888
5002308;Brasilândia;1980;12622;3593;9029
5002407;Caarapó;1980;27307;14990;12317
5002605;Camapuã;1980;22654;9787;12867
5002704;Campo Grande;1980;291777;283656;8121
5002803;Caracol;1980;3819;1057;2762
5002902;Cassilândia;1980;17030;11269;5761
5003108;Corguinho;1980;3731;804;2927
5003207;Corumbá;1980;81129;67561;13568
5003306;Coxim;1980;27628;15639;11989
5003454;Deodápolis;1980;18078;7310;10768
5003702;Dourados;1980;106500;84854;21646
5003751;Eldorado;1980;15315;7562;7753
5003801;Fátima do Sul;1980;33318;16469;16849
5004007;Glória de Dourados;1980;16195;7808;8387
5004106;Guia Lopes da Laguna;1980;7757;4151;3606
5004304;Iguatemi;1980;24096;9350;14746
5004403;Inocência;1980;5894;1431;4463
5004502;Itaporã;1980;14417;7795;6622
5004700;Ivinhema;1980;23616;9475;14141
5004908;Jaraguari;1980;4711;651;4060
5005004;Jardim;1980;13817;11046;2771
5005103;Jateí;1980;6778;1104;5674
5005202;Ladário;1980;8792;7887;905
5005400;Maracaju;1980;13601;10059;3542
5005608;Miranda;1980;24122;9562;14560
5005681;Mundo Novo;1980;31156;16186;14970
5005707;Naviraí;1980;28567;17799;10768
5005806;Nioaque;1980;9057;4053;5004
5006200;Nova Andradina;1980;21673;15726;5947
5006309;Paranaíba;1980;36894;21975;14919
5006408;Pedro Gomes;1980;11821;4712;7109
5006606;Ponta Porã;1980;38062;27475;10587
5006903;Porto Murtinho;1980;11682;5110;6572
5007109;Ribas do Rio Pardo;1980;11310;2900;8410
5007208;Rio Brilhante;1980;15567;7560;8007
5007307;Rio Negro;1980;6621;3216;3405
5007406;Rio Verde de Mato Grosso;1980;15864;10027;5837
5007505;Rochedo;1980;3658;947;2711
5007901;Sidrolândia;1980;12846;4651;8195
5008008;Terenos;1980;8289;2584;5705
5008305;Três Lagoas;1980;57895;48599;9296
5100102;Acorizal;1980;8609;2699;5910
5100201;Água Boa;1980;4041;746;3295
5100250;Alta Floresta;1980;22999;6624;16375
5100300;Alto Araguaia;1980;11230;7138;4092
5100409;Alto Garças;1980;6705;4815;1890
5100508;Alto Paraguai;1980;10659;4933;5726
5101209;Araguainha;1980;1435;878;557
5101258;Araputanga;1980;17155;4744;12411
5101308;Arenápolis;1980;13533;6796;6737
5101407;Aripuanã;1980;13961;4323;9638
5101605;Barão de Melgaço;1980;8255;1733;6522
5101704;Barra do Bugres;1980;23646;11662;11984
5101803;Barra do Garças;1980;43601;29173;14428
5102504;Cáceres;1980;59067;34514;24553
5102702;Canarana;1980;8757;802;7955
5103007;Chapada dos Guimarães;1980;9370;2947;6423
5103205;Colíder;1980;34503;3655;30848
5103403;Cuiabá;1980;212980;197970;15010
5103502;Diamantino;1980;14144;6368;7776
5103601;Dom Aquino;1980;11753;6802;4951
5103908;General Carneiro;1980;3981;1416;2565
5104203;Guiratinga;1980;13585;9258;4327
5104609;Itiquira;1980;6997;1611;5386
5104807;Jaciara;1980;14438;11318;3120
5105002;Jauru;1980;16696;5513;11183
5105200;Juscimeira;1980;12757;6463;6294
5105309;Luciara;1980;8185;1540;6645
5105507;Vila Bela da Santíssima Trindade;1980;8935;1704;7231
5105622;Mirassol d'Oeste;1980;18600;7656;10944
5105903;Nobres;1980;13441;7826;5615
5106000;Nortelândia;1980;10451;6758;3693
5106109;Nossa Senhora do Livramento;1980;10274;2227;8047
5106208;Nova Brasilândia;1980;11493;3235;8258
5106257;Nova Xavantina;1980;20273;7609;12664
5106307;Paranatinga;1980;11767;4119;7648
5106372;Pedra Preta;1980;12343;4642;7701
5106505;Poconé;1980;23351;13343;10008
5106703;Ponte Branca;1980;3492;1709;1783
5106752;Pontes e Lacerda;1980;14406;7350;7056
5106802;Porto dos Gaúchos;1980;15065;3652;11413
5107008;Poxoréu;1980;28054;10829;17225
5107107;São José dos Quatro Marcos;1980;18202;5855;12347
5107206;Rio Branco;1980;17583;4313;13270
5107305;São José do Rio Claro;1980;7208;2169;5039
5107602;Rondonópolis;1980;81375;64983;16392
5107701;Rosário Oeste;1980;19757;7988;11769
5107750;Salto do Céu;1980;11249;2535;8714
5107776;Santa Terezinha;1980;6107;2340;3767
5107800;Santo Antônio do Leverger;1980;11738;3671;8067
5107859;São Félix do Araguaia;1980;11063;3108;7955
5107909;Sinop;1980;19891;8590;11301
5107958;Tangará da Serra;1980;31293;12745;18548
5108105;Tesouro;1980;3693;2212;1481
5108204;Torixoréu;1980;8094;2238;5856
5108402;Várzea Grande;1980;76678;73294;3384
5200100;Abadiânia;1980;9030;3469;5561
5200134;Acreúna;1980;12319;6866;5453
5200209;Água Limpa;1980;2226;1034;1192
5200308;Alexânia;1980;12116;6218;5898
5200506;Aloândia;1980;2233;1477;756
5200605;Alto Paraíso de Goiás;1980;2721;537;2184
5200803;Alvorada do Norte;1980;6056;4180;1876
5200902;Amorinópolis;1980;5348;2631;2717
5201108;Anápolis;1980;180012;163096;16916
5201207;Anhanguera;1980;732;621;111
5201306;Anicuns;1980;23150;13104;10046
5201405;Aparecida de Goiânia;1980;42627;20699;21928
5201504;Aporé;1980;2764;660;2104
5201603;Araçu;1980;3908;2037;1871
5201702;Aragarças;1980;9690;8872;818
5201801;Aragoiânia;1980;3707;1837;1870
5202502;Aruanã;1980;7293;1766;5527
5202601;Aurilândia;1980;4953;2413;2540
5202809;Avelinópolis;1980;2687;1238;1449
5203104;Baliza;1980;2783;884;1899
5203203;Barro Alto;1980;12021;2680;9341
5203302;Bela Vista de Goiás;1980;17255;6010;11245
5203401;Bom Jardim de Goiás;1980;7178;4214;2964
5203500;Bom Jesus de Goiás;1980;11623;6705;4918
5203609;Brazabrantes;1980;2241;706;1535
5203807;Britânia;1980;3435;2569;866
5203906;Buriti Alegre;1980;8803;6613;2190
5204003;Cabeceiras;1980;4993;1407;3586
5204102;Cachoeira Alta;1980;9243;4559;4684
5204201;Cachoeira de Goiás;1980;1242;580;662
5204300;Caçu;1980;10739;5727;5012
5204409;Caiapônia;1980;28632;12955;15677
5204508;Caldas Novas;1980;11274;6916;4358
5204607;Campestre de Goiás;1980;2459;842;1617
5204706;Campinorte;1980;7984;4311;3673
5204805;Campo Alegre de Goiás;1980;4386;1051;3335
5204904;Campos Belos;1980;10126;6874;3252
5205000;Carmo do Rio Verde;1980;10233;3653;6580
5205109;Catalão;1980;39172;30685;8487
5205208;Caturaí;1980;3899;1553;2346
5205307;Cavalcante;1980;11181;1774;9407
5205406;Ceres;1980;31493;13701;17792
5205703;Córrego do Ouro;1980;4367;1594;2773
5205802;Corumbá de Goiás;1980;20212;2447;17765
5205901;Corumbaíba;1980;5909;3057;2852
5206206;Cristalina;1980;15977;10459;5518
5206305;Cristianópolis;1980;1661;1166;495
5206404;Crixás;1980;30219;7355;22864
5206503;Cromínia;1980;3362;1845;1517
5206602;Cumari;1980;3783;2456;1327
5206701;Damianópolis;1980;3528;559;2969
5206800;Damolândia;1980;2366;1292;1074
5206909;Davinópolis;1980;2450;603;1847
5207105;Diorama;1980;3571;1186;2385
5207402;Edéia;1980;12597;7078;5519
5207501;Estrela do Norte;1980;3198;2238;960
5207600;Fazenda Nova;1980;9887;3909;5978
5207808;Firminópolis;1980;10058;6249;3809
5207907;Flores de Goiás;1980;3888;694;3194
5208004;Formosa;1980;43297;29618;13679
5208103;Formoso;1980;15403;5010;10393
5208301;Divinópolis de Goiás;1980;4244;1824;2420
5208400;Goianápolis;1980;7569;2785;4784
5208509;Goiandira;1980;5711;4351;1360
5208608;Goianésia;1980;32875;23521;9354
5208707;Goiânia;1980;717519;703640;13879
5208806;Goianira;1980;7488;4721;2767
5208905;Goiás;1980;42967;20746;22221
5209101;Goiatuba;1980;26937;18386;8551
5209200;Guapó;1980;10028;5356;4672
5209408;Guarani de Goiás;1980;3978;655;3323
5209606;Heitoraí;1980;3283;1833;1450
5209705;Hidrolândia;1980;8559;3396;5163
5209804;Hidrolina;1980;4813;2375;2438
5209903;Iaciara;1980;7974;4122;3852
5210000;Inhumas;1980;31430;23510;7920
5210109;Ipameri;1980;20384;14662;5722
5210208;Iporá;1980;27248;21607;5641
5210307;Israelândia;1980;3583;1625;1958
5210406;Itaberaí;1980;25822;11779;14043
5210604;Itaguaru;1980;7130;3612;3518
5210802;Itajá;1980;6289;2854;3435
5210901;Itapaci;1980;14225;6179;8046
5211008;Itapirapuã;1980;10824;5774;5050
5211206;Itapuranga;1980;30358;15492;14866
5211305;Itarumã;1980;5579;1360;4219
5211404;Itauçu;1980;9770;5580;4190
5211503;Itumbiara;1980;78049;62010;16039
5211602;Ivolândia;1980;4269;1528;2741
5211701;Jandaia;1980;10981;2469;8512
5211800;Jaraguá;1980;36559;14712;21847
5211909;Jataí;1980;53394;42840;10554
5212006;Jaupaci;1980;2652;1386;1266
5212105;Joviânia;1980;6320;4110;2210
5212204;Jussara;1980;22520;12761;9759
5212303;Leopoldo de Bulhões;1980;8336;4181;4155
5212501;Luziânia;1980;92817;75977;16840
5212600;Mairipotaba;1980;2670;848;1822
5212709;Mambaí;1980;5125;1179;3946
5212808;Mara Rosa;1980;21524;5215;16309
5212907;Marzagão;1980;1095;802;293
5213004;Maurilândia;1980;5032;3595;1437
5213087;Minaçu;1980;28371;18609;9762
5213103;Mineiros;1980;21690;16827;4863
5213400;Moiporá;1980;2787;1287;1500
5213509;Monte Alegre de Goiás;1980;7343;1097;6246
5213707;Montes Claros de Goiás;1980;9247;3853;5394
5213806;Morrinhos;1980;32122;20216;11906
5213905;Mossâmedes;1980;12208;3830;8378
5214002;Mozarlândia;1980;8451;5961;2490
5214101;Mutunópolis;1980;5157;2198;2959
5214408;Nazário;1980;5834;4338;1496
5214507;Nerópolis;1980;9368;7100;2268
5214606;Niquelândia;1980;33484;9263;24221
5214705;Nova América;1980;2204;740;1464
5214804;Nova Aurora;1980;1940;1161;779
5214903;Nova Roma;1980;4110;675;3435
5215009;Nova Veneza;1980;5083;3106;1977
5215207;Novo Brasil;1980;4966;1903;3063
5215306;Orizona;1980;12362;4329;8033
5215405;Ouro Verde de Goiás;1980;3844;1686;2158
5215504;Ouvidor;1980;3443;1507;1936
5215603;Padre Bernardo;1980;15855;7233;8622
5215702;Palmeiras de Goiás;1980;22536;10806;11730
5215801;Palmelo;1980;1833;1601;232
5215900;Palminópolis;1980;4303;1224;3079
5216007;Panamá;1980;2878;1181;1697
5216304;Paranaiguara;1980;6782;4825;1957
5216403;Paraúna;1980;13569;7513;6056
5216809;Petrolina de Goiás;1980;12153;4542;7611
5216908;Pilar de Goiás;1980;9246;699;8547
5217104;Piracanjuba;1980;24095;12627;11468
5217203;Piranhas;1980;15877;9372;6505
5217302;Pirenópolis;1980;29329;6652;22677
5217401;Pires do Rio;1980;19258;16670;2588
5217609;Planaltina;1980;16178;9275;6903
5217708;Pontalina;1980;19120;11586;7534
5218003;Porangatu;1980;34881;21131;13750
5218102;Portelândia;1980;2352;1397;955
5218300;Posse;1980;21684;6339;15345
5218508;Quirinópolis;1980;36236;22728;13508
5218607;Rialma;1980;7516;5904;1612
5218706;Rianápolis;1980;3501;2568;933
5218805;Rio Verde;1980;74699;55541;19158
5218904;Rubiataba;1980;19918;11540;8378
5219001;Sanclerlândia;1980;8535;4235;4300
5219100;Santa Bárbara de Goiás;1980;3247;1914;1333
5219209;Santa Cruz de Goiás;1980;3086;533;2553
5219308;Santa Helena de Goiás;1980;26654;20034;6620
5219407;Santa Rita do Araguaia;1980;3933;3063;870
5219506;Santa Rosa de Goiás;1980;4236;1905;2331
5219605;Santa Tereza de Goiás;1980;5417;3710;1707
5219704;Santa Terezinha de Goiás;1980;10964;3136;7828
5219803;São Domingos;1980;9660;2096;7564
5219902;São Francisco de Goiás;1980;9427;2184;7243
5220009;São João d'Aliança;1980;4333;1116;3217
5220108;São Luís de Montes Belos;1980;25228;16561;8667
5220207;São Miguel do Araguaia;1980;22793;15663;7130
5220405;São Simão;1980;11374;10572;802
5220504;Serranópolis;1980;5390;2279;3111
5220603;Silvânia;1980;19809;6265;13544
5220702;Sítio d'Abadia;1980;2712;286;2426
5221007;Taquaral de Goiás;1980;9154;4723;4431
5221304;Três Ranchos;1980;2249;951;1298
5221403;Trindade;1980;30609;22364;8245
5221502;Turvânia;1980;5913;2950;2963
5221601;Uruaçu;1980;32226;21082;11144
5221700;Uruana;1980;12011;6807;5204
5221809;Urutaí;1980;3138;1667;1471
5221908;Varjão;1980;3650;1657;1993
5222005;Vianópolis;1980;7934;3633;4301
5300108;Brasília;1980;1176908;1138994;37914
1100015;Alta Floresta D'Oeste;1991;31980;9379;22601
1100023;Ariquemes;1991;83684;45283;38401
1100031;Cabixi;1991;8174;1916;6258
1100049;Cacoal;1991;78934;44091;34843
1100056;Cerejeiras;1991;21608;14737;6871
1100064;Colorado do Oeste;1991;38993;15295;23698
1100080;Costa Marques;1991;10376;6747;3629
1100098;Espigão D'Oeste;1991;23156;11186;11970
1100106;Guajará-Mirim;1991;32583;27406;5177
1100114;Jaru;1991;63535;27675;35860
1100122;Ji-Paraná;1991;97799;75414;22385
1100130;Machadinho D'Oeste;1991;16765;4891;11874
1100148;Nova Brasilândia D'Oeste;1991;15798;5031;10767
1100155;Ouro Preto do Oeste;1991;83857;23586;60271
1100189;Pimenta Bueno;1991;48759;25505;23254
1100205;Porto Velho;1991;287534;229788;57746
1100254;Presidente Médici;1991;30064;10803;19261
1100288;Rolim de Moura;1991;59751;28272;31479
1100296;Santa Luzia D'Oeste;1991;12328;4287;8041
1100304;Vilhena;1991;39263;34513;4750
1100320;São Miguel do Guaporé;1991;19458;2218;17240
1100338;Nova Mamoré;1991;7248;3724;3524
1100346;Alvorada D'Oeste;1991;21045;7580;13465
1200054;Assis Brasil;1991;2917;1616;1301
1200104;Brasiléia;1991;20263;11557;8706
1200203;Cruzeiro do Sul;1991;66603;27854;38749
1200302;Feijó;1991;17769;7151;10618
1200336;Mâncio Lima;1991;10217;3575;6642
1200344;Manoel Urbano;1991;5327;2446;2881
1200385;Plácido de Castro;1991;15535;4332;11203
1200401;Rio Branco;1991;197376;168679;28697
1200450;Senador Guiomard;1991;17489;6303;11186
1200500;Sena Madureira;1991;24197;10369;13828
1200609;Tarauacá;1991;27659;9566;18093
1200708;Xapuri;1991;12366;5072;7294
1300029;Alvarães;1991;8487;3356;5131
1300060;Amaturá;1991;4738;1913;2825
1300086;Anamã;1991;6024;1331;4693
1300102;Anori;1991;8990;5101;3889
1300144;Apuí;1991;5732;2319;3413
1300201;Atalaia do Norte;1991;7993;2161;5832
1300300;Autazes;1991;17107;6363;10744
1300409;Barcelos;1991;11035;4018;7017
1300508;Barreirinha;1991;16316;5623;10693
1300607;Benjamin Constant;1991;18312;11539;6773
1300631;Beruri;1991;7436;2852;4584
1300680;Boa Vista do Ramos;1991;7504;2563;4941
1300706;Boca do Acre;1991;25005;11296;13709
1300805;Borba;1991;17217;7913;9304
1300839;Caapiranga;1991;6833;1707;5126
1300904;Canutama;1991;12152;4190;7962
1301001;Carauari;1991;19298;11498;7800
1301100;Careiro;1991;31816;4328;27488
1301159;Careiro da Várzea;1991;18161;707;17454
1301209;Coari;1991;38678;21081;17597
1301308;Codajás;1991;13462;8388;5074
1301407;Eirunepé;1991;20372;13442;6930
1301506;Envira;1991;16339;4646;11693
1301605;Fonte Boa;1991;16445;5773;10672
1301654;Guajará;1991;11495;2835;8660
1301704;Humaitá;1991;38792;18700;20092
1301803;Ipixuna;1991;9653;3554;6099
1301852;Iranduba;1991;18876;6403;12473
1301902;Itacoatiara;1991;58757;37380;21377
1301951;Itamarati;1991;9085;1538;7547
1302009;Itapiranga;1991;5137;3468;1669
1302108;Japurá;1991;10777;1417;9360
1302207;Juruá;1991;5045;1676;3369
1302306;Jutaí;1991;14890;9087;5803
1302405;Lábrea;1991;33052;15444;17608
1302504;Manacapuru;1991;57173;36019;21154
1302553;Manaquiri;1991;10718;2391;8327
1302603;Manaus;1991;1011501;1006585;4916
1302702;Manicoré;1991;37857;14373;23484
1302801;Maraã;1991;11838;2199;9639
1302900;Maués;1991;30499;16658;13841
1303007;Nhamundá;1991;13250;4847;8403
1303106;Nova Olinda do Norte;1991;12949;6298;6651
1303205;Novo Airão;1991;14024;5980;8044
1303304;Novo Aripuanã;1991;11634;5432;6202
1303403;Parintins;1991;58783;41591;17192
1303502;Pauini;1991;17037;2724;14313
1303536;Presidente Figueiredo;1991;7089;3232;3857
1303569;Rio Preto da Eva;1991;6519;2343;4176
1303601;Santa Isabel do Rio Negro;1991;15421;2104;13317
1303700;Santo Antônio do Içá;1991;17214;4472;12742
1303809;São Gabriel da Cachoeira;1991;23140;6835;16305
1303908;São Paulo de Olivença;1991;13623;5105;8518
1303957;São Sebastião do Uatumã;1991;4539;3410;1129
1304005;Silves;1991;5703;2241;3462
1304062;Tabatinga;1991;27923;19822;8101
1304104;Tapauá;1991;25386;7516;17870
1304203;Tefé;1991;53970;39057;14913
1304237;Tonantins;1991;10034;2491;7543
1304260;Uarini;1991;5407;1305;4102
1304302;Urucará;1991;11328;6143;5185
1304401;Urucurituba;1991;17673;5971;11702
1400050;Alto Alegre;1991;11211;3356;7855
1400100;Boa Vista;1991;144249;120157;24092
1400159;Bonfim;1991;9478;1221;8257
1400209;Caracaraí;1991;8900;5139;3761
1400308;Mucajaí;1991;13308;5222;8086
1400407;Normandia;1991;11188;1146;10042
1400506;São João da Baliza;1991;10143;2309;7834
1400605;São Luiz;1991;9106;2268;6838
1500107;Abaetetuba;1991;99989;56389;43600
1500206;Acará;1991;37184;5719;31465
1500305;Afuá;1991;20008;4093;15915
1500404;Alenquer;1991;52856;21958;30898
1500503;Almeirim;1991;33442;16342;17100
1500602;Altamira;1991;72408;50145;22263
1500701;Anajás;1991;14284;1979;12305
1500800;Ananindeua;1991;88151;74051;14100
1500909;Augusto Corrêa;1991;30323;8683;21640
1501006;Aveiro;1991;10876;2496;8380
1501105;Bagre;1991;13844;2140;11704
1501204;Baião;1991;20072;7877;12195
1501303;Barcarena;1991;45946;21629;24317
1501402;Belém;1991;1244689;849187;395502
1501501;Benevides;1991;68465;8361;60104
1501576;Bom Jesus do Tocantins;1991;15952;4817;11135
1501600;Bonito;1991;8532;1783;6749
1501709;Bragança;1991;97149;49600;47549
1501758;Brejo Grande do Araguaia;1991;11939;3184;8755
1501808;Breves;1991;72140;28719;43421
1501907;Bujaru;1991;14117;3787;10330
1502004;Cachoeira do Arari;1991;13246;4515;8731
1502103;Cametá;1991;85187;30278;54909
1502202;Capanema;1991;51166;39825;11341
1502301;Capitão Poço;1991;45452;14557;30895
1502400;Castanhal;1991;102071;92852;9219
1502509;Chaves;1991;17400;735;16665
1502608;Colares;1991;8338;2655;5683
1502707;Conceição do Araguaia;1991;54900;29851;25049
1502756;Concórdia do Pará;1991;15247;7694;7553
1502772;Curionópolis;1991;38672;15074;23598
1502806;Curralinho;1991;15204;3248;11956
1502905;Curuçá;1991;25776;9995;15781
1502939;Dom Eliseu;1991;24362;11806;12556
1503002;Faro;1991;13574;8884;4690
1503077;Garrafão do Norte;1991;20473;3951;16522
1503101;Gurupá;1991;18969;3561;15408
1503200;Igarapé-Açu;1991;27307;12610;14697
1503309;Igarapé-Miri;1991;41843;19797;22046
1503408;Inhangapi;1991;6668;1614;5054
1503507;Irituia;1991;31110;4024;27086
1503606;Itaituba;1991;116402;62186;54216
1503705;Itupiranga;1991;37011;8431;28580
1503804;Jacundá;1991;43012;22081;20931
1503903;Juruti;1991;23262;7973;15289
1504000;Limoeiro do Ajuru;1991;16475;2522;13953
1504059;Mãe do Rio;1991;29100;19140;9960
1504109;Magalhães Barata;1991;7331;3323;4008
1504208;Marabá;1991;123668;102435;21233
1504307;Maracanã;1991;25575;9652;15923
1504406;Marapanim;1991;20087;7712;12375
1504455;Medicilândia;1991;29728;3109;26619
1504505;Melgaço;1991;14538;1887;12651
1504604;Mocajuba;1991;18496;11756;6740
1504703;Moju;1991;44424;9748;34676
1504802;Monte Alegre;1991;46951;16987;29964
1504901;Muaná;1991;22367;4270;18097
1505007;Nova Timboteua;1991;9427;4383;5044
1505106;Óbidos;1991;42307;20147;22160
1505205;Oeiras do Pará;1991;18792;4958;13834
1505304;Oriximiná;1991;41154;21163;19991
1505403;Ourém;1991;30995;6202;24793
1505437;Ourilândia do Norte;1991;28718;10877;17841
1505486;Pacajá;1991;30777;4160;26617
1505502;Paragominas;1991;67075;40054;27021
1505536;Parauapebas;1991;53335;27443;25892
1505601;Peixe-Boi;1991;5966;2924;3042
1505700;Ponta de Pedras;1991;16500;5866;10634
1505809;Portel;1991;29452;11852;17600
1505908;Porto de Moz;1991;15407;5066;10341
1506005;Prainha;1991;26782;4196;22586
1506104;Primavera;1991;17132;8344;8788
1506138;Redenção;1991;55968;44944;11024
1506161;Rio Maria;1991;26536;14507;12029
1506187;Rondon do Pará;1991;40879;26400;14479
1506195;Rurópolis;1991;19468;3900;15568
1506203;Salinópolis;1991;22670;19317;3353
1506302;Salvaterra;1991;11889;7049;4840
1506401;Santa Cruz do Arari;1991;4774;1652;3122
1506500;Santa Izabel do Pará;1991;33329;23728;9601
1506583;Santa Maria das Barreiras;1991;7228;812;6416
1506609;Santa Maria do Pará;1991;17946;9117;8829
1506708;Santana do Araguaia;1991;15923;8521;7402
1506807;Santarém;1991;265062;180018;85044
1506906;Santarém Novo;1991;4486;1176;3310
1507003;Santo Antônio do Tauá;1991;17128;7905;9223
1507102;São Caetano de Odivelas;1991;21126;6316;14810
1507201;São Domingos do Capim;1991;42526;3956;38570
1507300;São Félix do Xingu;1991;24891;8198;16693
1507409;São Francisco do Pará;1991;11619;4030;7589
1507458;São Geraldo do Araguaia;1991;38540;8802;29738
1507474;São João de Pirabas;1991;16259;8776;7483
1507508;São João do Araguaia;1991;19824;1341;18483
1507607;São Miguel do Guamá;1991;32933;18123;14810
1507706;São Sebastião da Boa Vista;1991;14926;4922;10004
1507805;Senador José Porfírio;1991;39010;2195;36815
1507904;Soure;1991;17481;14500;2981
1507953;Tailândia;1991;17707;9657;8050
1508001;Tomé-Açu;1991;41403;16206;25197
1508084;Tucumã;1991;31375;12441;18934
1508100;Tucuruí;1991;81623;46014;35609
1508159;Uruará;1991;25339;5767;19572
1508209;Vigia;1991;37418;25166;12252
1508308;Viseu;1991;63173;12242;50931
1508407;Xinguara;1991;48024;27378;20646
1600105;Amapá;1991;8075;5036;3039
1600204;Calçoene;1991;5177;3904;1273
1600238;Ferreira Gomes;1991;2386;1512;874
1600279;Laranjal do Jari;1991;21372;14301;7071
1600303;Macapá;1991;179777;154063;25714
1600402;Mazagão;1991;8911;3921;4990
1600501;Oiapoque;1991;7555;4004;3551
1600600;Santana;1991;51451;45800;5651
1600709;Tartarugalzinho;1991;4693;1590;3103
1700350;Aliança do Tocantins;1991;6883;3935;2948
1700400;Almas;1991;7652;3511;4141
1700707;Alvorada;1991;9868;5615;4253
1701002;Ananás;1991;11851;5981;5870
1701101;Aparecida do Rio Negro;1991;3266;2031;1235
1701903;Araguacema;1991;6394;2955;3439
1702000;Araguaçu;1991;12712;5430;7282
1702109;Araguaína;1991;103315;84614;18701
1702208;Araguatins;1991;27861;12687;15174
1702307;Arapoema;1991;13964;5024;8940
1702406;Arraias;1991;12884;5518;7366
1702554;Augustinópolis;1991;10313;8422;1891
1702703;Aurora do Tocantins;1991;4663;1911;2752
1702901;Axixá do Tocantins;1991;9981;6467;3514
1703008;Babaçulândia;1991;9073;3237;5836
1703107;Barrolândia;1991;6525;4015;2510
1703206;Bernardo Sayão;1991;4315;1397;2918
1703701;Brejinho de Nazaré;1991;6828;3333;3495
1703800;Buriti do Tocantins;1991;8038;5263;2775
1703909;Caseara;1991;2775;2033;742
1705508;Colinas do Tocantins;1991;21018;19061;1957
1705557;Combinado;1991;4870;3390;1480
1705607;Conceição do Tocantins;1991;5930;2493;3437
1706001;Couto Magalhães;1991;6814;1594;5220
1706100;Cristalândia;1991;10973;5450;5523
1707009;Dianópolis;1991;14022;8408;5614
1707108;Divinópolis do Tocantins;1991;6394;3217;3177
1707207;Dois Irmãos do Tocantins;1991;7949;1918;6031
1707306;Dueré;1991;4573;2021;2552
1707553;Fátima;1991;4752;2787;1965
1707652;Figueirópolis;1991;7365;4288;3077
1707702;Filadélfia;1991;11029;2780;8249
1708205;Formoso do Araguaia;1991;17087;7810;9277
1708304;Goianorte;1991;5151;1573;3578
1709005;Goiatins;1991;18164;3183;14981
1709302;Guaraí;1991;20822;14573;6249
1709500;Gurupi;1991;56752;52523;4229
1710508;Itacajá;1991;13933;3178;10755
1710706;Itaguatins;1991;11080;1579;9501
1711100;Itaporã do Tocantins;1991;3652;1310;2342
1712405;Lizarda;1991;4166;983;3183
1712504;Marianópolis do Tocantins;1991;2333;1396;937
1713205;Miracema do Tocantins;1991;20815;15723;5092
1713304;Miranorte;1991;10908;8351;2557
1713601;Monte do Carmo;1991;6542;2204;4338
1714203;Natividade;1991;10330;4595;5735
1714302;Nazaré;1991;9020;1616;7404
1714880;Nova Olinda;1991;7669;5303;2366
1715002;Nova Rosalândia;1991;3078;1982;1096
1715101;Novo Acordo;1991;3857;1082;2775
1715754;Palmeirópolis;1991;11915;5995;5920
1716109;Paraíso do Tocantins;1991;28825;24282;4543
1716208;Paranã;1991;10966;1928;9038
1716505;Pedro Afonso;1991;13432;6919;6513
1716604;Peixe;1991;12871;2490;10381
1716653;Pequizeiro;1991;3289;1744;1545
1716703;Colméia;1991;8732;5678;3054
1717008;Pindorama do Tocantins;1991;4949;1853;3096
1717503;Pium;1991;8867;2649;6218
1717800;Ponte Alta do Bom Jesus;1991;6537;1720;4817
1717909;Ponte Alta do Tocantins;1991;7486;2331;5155
1718006;Porto Alegre do Tocantins;1991;2103;909;1194
1718204;Porto Nacional;1991;43224;34654;8570
1718303;Praia Norte;1991;6068;2413;3655
1718402;Presidente Kennedy;1991;6498;2807;3691
1718758;Rio Sono;1991;6994;1610;5384
1718808;Sampaio;1991;4379;1903;2476
1718907;Santa Rosa do Tocantins;1991;3822;875;2947
1719004;Santa Tereza do Tocantins;1991;3118;897;2221
1720309;São Sebastião do Tocantins;1991;4294;2287;2007
1720499;São Valério;1991;3650;1336;2314
1720655;Silvanópolis;1991;5878;2747;3131
1720804;Sítio Novo do Tocantins;1991;7870;4237;3633
1720903;Taguatinga;1991;11399;5312;6087
1721000;Palmas;1991;24334;19246;5088
1721109;Tocantínia;1991;6363;3031;3332
1721208;Tocantinópolis;1991;30775;14740;16035
1722081;Wanderlândia;1991;9260;5123;4137
1722107;Xambioá;1991;11756;9170;2586
2100055;Açailândia;1991;83820;46195;37625
2100105;Afonso Cunha;1991;4580;1589;2991
2100204;Alcântara;1991;19587;3993;15594
2100303;Aldeias Altas;1991;19520;5437;14083
2100402;Altamira do Maranhão;1991;20003;2535;17468
2100501;Alto Parnaíba;1991;10336;4508;5828
2100600;Amarante do Maranhão;1991;23102;7344;15758
2100709;Anajatuba;1991;19528;4361;15167
2100808;Anapurus;1991;10249;3269;6980
2100907;Araioses;1991;44029;8504;35525
2100956;Arame;1991;33923;11208;22715
2101004;Arari;1991;24826;12875;11951
2101103;Axixá;1991;9358;1265;8093
2101202;Bacabal;1991;98793;64783;34010
2101301;Bacuri;1991;22205;4330;17875
2101400;Balsas;1991;41648;30633;11015
2101509;Barão de Grajaú;1991;13500;5666;7834
2101608;Barra do Corda;1991;90820;34163;56657
2101707;Barreirinhas;1991;29640;7442;22198
2101806;Benedito Leite;1991;8960;1679;7281
2101905;Bequimão;1991;21377;4410;16967
2102002;Bom Jardim;1991;40572;7686;32886
2102101;Brejo;1991;27153;8452;18701
2102200;Buriti;1991;22856;4900;17956
2102309;Buriti Bravo;1991;21142;10162;10980
2102408;Cajapió;1991;12038;2259;9779
2102507;Cajari;1991;16018;2951;13067
2102606;Cândido Mendes;1991;32244;5932;26312
2102705;Cantanhede;1991;23308;6018;17290
2102804;Carolina;1991;24665;12198;12467
2102903;Carutapera;1991;32037;10327;21710
2103000;Caxias;1991;145725;84331;61394
2103109;Cedral;1991;15104;1626;13478
2103208;Chapadinha;1991;56862;28694;28168
2103307;Codó;1991;111967;58469;53498
2103406;Coelho Neto;1991;39669;31052;8617
2103505;Colinas;1991;35164;13587;21577
2103604;Coroatá;1991;70360;28768;41592
2103703;Cururupu;1991;41332;17492;23840
2103802;Dom Pedro;1991;19726;10858;8868
2103901;Duque Bacelar;1991;7539;2725;4814
2104008;Esperantinópolis;1991;30567;6789;23778
2104057;Estreito;1991;23031;11571;11460
2104107;Fortaleza dos Nogueiras;1991;12428;2952;9476
2104206;Fortuna;1991;15570;7923;7647
2104305;Godofredo Viana;1991;28315;3710;24605
2104404;Gonçalves Dias;1991;16533;6004;10529
2104503;Governador Archer;1991;10267;4382;5885
2104602;Governador Eugênio Barros;1991;22743;3148;19595
2104701;Graça Aranha;1991;5891;2687;3204
2104800;Grajaú;1991;54403;18133;36270
2104909;Guimarães;1991;12360;4670;7690
2105005;Humberto de Campos;1991;20071;3513;16558
2105104;Icatu;1991;20679;2976;17703
2105203;Igarapé Grande;1991;14810;4781;10029
2105302;Imperatriz;1991;276502;210051;66451
2105401;Itapecuru Mirim;1991;42853;20073;22780
2105500;João Lisboa;1991;53249;12084;41165
2105609;Joselândia;1991;15267;4333;10934
2105708;Lago da Pedra;1991;46877;17562;29315
2105807;Lago do Junco;1991;19276;2841;16435
2105906;Lago Verde;1991;13220;4467;8753
2106003;Lima Campos;1991;12404;4943;7461
2106102;Loreto;1991;9465;3458;6007
2106201;Luís Domingues;1991;9140;3941;5199
2106300;Magalhães de Almeida;1991;11495;5067;6428
2106409;Mata Roma;1991;10607;3784;6823
2106508;Matinha;1991;18326;4998;13328
2106607;Matões;1991;25318;5246;20072
2106706;Mirador;1991;17136;4361;12775
2106755;Miranda do Norte;1991;14277;11436;2841
2106805;Mirinzal;1991;16856;5366;11490
2106904;Monção;1991;25362;7080;18282
2107001;Montes Altos;1991;19521;2981;16540
2107100;Morros;1991;18730;3972;14758
2107209;Nina Rodrigues;1991;7498;1949;5549
2107308;Nova Iorque;1991;4934;2315;2619
2107407;Olho d'Água das Cunhãs;1991;16249;7125;9124
2107506;Paço do Lumiar;1991;53195;1147;52048
2107605;Palmeirândia;1991;15565;2337;13228
2107704;Paraibano;1991;15776;10218;5558
2107803;Parnarama;1991;31332;7671;23661
2107902;Passagem Franca;1991;22649;4493;18156
2108009;Pastos Bons;1991;14037;6093;7944
2108108;Paulo Ramos;1991;26978;5660;21318
2108207;Pedreiras;1991;50603;39694;10909
2108306;Penalva;1991;29287;8880;20407
2108405;Peri Mirim;1991;13375;2679;10696
2108504;Pindaré-Mirim;1991;31579;17748;13831
2108603;Pinheiro;1991;82432;32627;49805
2108702;Pio XII;1991;27300;9246;18054
2108801;Pirapemas;1991;16443;6099;10344
2108900;Poção de Pedras;1991;24481;7311;17170
2109007;Porto Franco;1991;32403;9341;23062
2109106;Presidente Dutra;1991;42721;21647;21074
2109205;Presidente Juscelino;1991;6435;1889;4546
2109304;Presidente Vargas;1991;7855;3024;4831
2109403;Primeira Cruz;1991;18419;5320;13099
2109502;Riachão;1991;28058;6628;21430
2109601;Rosário;1991;40916;19695;21221
2109700;Sambaíba;1991;5743;1512;4231
2109809;Santa Helena;1991;26434;12091;14343
2109908;Santa Inês;1991;64713;54035;10678
2110005;Santa Luzia;1991;116525;17967;98558
2110039;Santa Luzia do Paruá;1991;46387;8271;38116
2110104;Santa Quitéria do Maranhão;1991;20937;6712;14225
2110203;Santa Rita;1991;21280;6965;14315
2110302;Santo Antônio dos Lopes;1991;17629;4300;13329
2110401;São Benedito do Rio Preto;1991;15057;5947;9110
2110500;São Bento;1991;28036;14089;13947
2110609;São Bernardo;1991;24667;4949;19718
2110708;São Domingos do Maranhão;1991;34404;11278;23126
2110807;São Félix de Balsas;1991;6244;932;5312
2110906;São Francisco do Maranhão;1991;12917;2083;10834
2111003;São João Batista;1991;20447;2940;17507
2111102;São João dos Patos;1991;25552;16127;9425
2111201;São José de Ribamar;1991;70571;26044;44527
2111300;São Luís;1991;696371;246244;450127
2111409;São Luís Gonzaga do Maranhão;1991;26085;5266;20819
2111508;São Mateus do Maranhão;1991;31076;19519;11557
2111607;São Raimundo das Mangabeiras;1991;14147;7396;6751
2111706;São Vicente Ferrer;1991;18467;1969;16498
2111805;Sítio Novo;1991;13639;3395;10244
2111904;Sucupira do Norte;1991;10420;2446;7974
2112001;Tasso Fragoso;1991;6197;2096;4101
2112100;Timbiras;1991;22960;7815;15145
2112209;Timon;1991;107439;90814;16625
2112308;Tuntum;1991;36006;13474;22532
2112407;Turiaçu;1991;39599;5248;34351
2112506;Tutóia;1991;43313;10068;33245
2112605;Urbano Santos;1991;23388;6900;16488
2112704;Vargem Grande;1991;32897;12194;20703
2112803;Viana;1991;42161;16897;25264
2112902;Vitória do Mearim;1991;50294;10661;39633
2113009;Vitorino Freire;1991;30885;12187;18698
2114007;Zé Doca;1991;58012;24795;33217
2200103;Agricolândia;1991;5720;3623;2097
2200202;Água Branca;1991;16191;11525;4666
2200251;Alagoinha do Piauí;1991;8074;1225;6849
2200301;Alto Longá;1991;15581;3137;12444
2200400;Altos;1991;38853;21148;17705
2200509;Amarante;1991;16528;8323;8205
2200608;Angical do Piauí;1991;6129;4285;1844
2200707;Anísio de Abreu;1991;10379;2660;7719
2200806;Antônio Almeida;1991;4909;1250;3659
2200905;Aroazes;1991;8919;1953;6966
2201002;Arraial;1991;5491;1622;3869
2201101;Avelino Lopes;1991;12005;3344;8661
2201200;Barras;1991;50151;14446;35705
2201309;Barreiras do Piauí;1991;4052;1175;2877
2201408;Barro Duro;1991;8448;4182;4266
2201507;Batalha;1991;22332;6469;15863
2201606;Beneditinos;1991;12484;4029;8455
2201705;Bertolínia;1991;8756;3404;5352
2201804;Bocaina;1991;3890;1197;2693
2201903;Bom Jesus;1991;18126;8498;9628
2202000;Buriti dos Lopes;1991;31000;7776;23224
2202109;Campinas do Piauí;1991;5894;1231;4663
2202208;Campo Maior;1991;72258;31853;40405
2202307;Canto do Buriti;1991;27190;8585;18605
2202406;Capitão de Campos;1991;10161;4639;5522
2202505;Caracol;1991;11804;3124;8680
2202604;Castelo do Piauí;1991;28744;8277;20467
2202703;Cocal;1991;26989;7652;19337
2202802;Conceição do Canindé;1991;7629;1554;6075
2202901;Corrente;1991;24964;9572;15392
2203008;Cristalândia do Piauí;1991;5963;1739;4224
2203107;Cristino Castro;1991;11041;4897;6144
2203206;Curimatá;1991;12813;3606;9207
2203305;Demerval Lobão;1991;12218;7790;4428
2203354;Dirceu Arcoverde;1991;10948;1329;9619
2203404;Dom Expedito Lopes;1991;5058;2812;2246
2203420;Domingos Mourão;1991;4273;739;3534
2203453;Dom Inocêncio;1991;8992;428;8564
2203503;Elesbão Veloso;1991;16641;8841;7800
2203602;Eliseu Martins;1991;8746;2822;5924
2203701;Esperantina;1991;35806;17297;18509
2203800;Flores do Piauí;1991;4850;1744;3106
2203909;Floriano;1991;51494;43531;7963
2204006;Francinópolis;1991;5311;2462;2849
2204105;Francisco Ayres;1991;5028;2003;3025
2204204;Francisco Santos;1991;7049;3432;3617
2204303;Fronteiras;1991;14782;4761;10021
2204402;Gilbués;1991;9972;2734;7238
2204501;Guadalupe;1991;9603;8681;922
2204600;Hugo Napoleão;1991;3633;2702;931
2204709;Inhuma;1991;13174;5561;7613
2204808;Ipiranga do Piauí;1991;7525;3951;3574
2204907;Isaías Coelho;1991;7637;1163;6474
2205003;Itainópolis;1991;13506;2191;11315
2205102;Itaueira;1991;11009;4607;6402
2205201;Jaicós;1991;28731;5301;23430
2205300;Jerumenha;1991;8144;3188;4956
2205409;Joaquim Pires;1991;14629;2637;11992
2205508;José de Freitas;1991;29451;13712;15739
2205607;Landri Sales;1991;5681;3809;1872
2205706;Luís Correia;1991;28835;8277;20558
2205805;Luzilândia;1991;36013;12508;23505
2205904;Manoel Emídio;1991;6799;2504;4295
2206001;Marcos Parente;1991;4421;3020;1401
2206100;Matias Olímpio;1991;11938;3435;8503
2206209;Miguel Alves;1991;27679;7935;19744
2206308;Miguel Leão;1991;1254;709;545
2206407;Monsenhor Gil;1991;10986;3307;7679
2206506;Monsenhor Hipólito;1991;6276;2118;4158
2206605;Monte Alegre do Piauí;1991;9446;2373;7073
2206704;Nazaré do Piauí;1991;7831;3103;4728
2206803;Nossa Senhora dos Remédios;1991;6077;1948;4129
2206902;Novo Oriente do Piauí;1991;7201;2760;4441
2207009;Oeiras;1991;51891;16002;35889
2207207;Padre Marcos;1991;18728;2009;16719
2207306;Paes Landim;1991;5436;1773;3663
2207405;Palmeira do Piauí;1991;4445;800;3645
2207504;Palmeirais;1991;11595;3100;8495
2207603;Parnaguá;1991;12666;2810;9856
2207702;Parnaíba;1991;127929;105104;22825
2207801;Paulistana;1991;38942;6309;32633
2207900;Pedro II;1991;43817;16391;27426
2208007;Picos;1991;78409;45571;32838
2208106;Pimenteiras;1991;10588;2827;7761
2208205;Pio IX;1991;16126;3562;12564
2208304;Piracuruca;1991;31163;15440;15723
2208403;Piripiri;1991;63162;39341;23821
2208502;Porto;1991;14324;4558;9766
2208601;Prata do Piauí;1991;2710;1760;950
2208700;Redenção do Gurguéia;1991;6882;3476;3406
2208809;Regeneração;1991;20537;11017;9520
2208908;Ribeiro Gonçalves;1991;11913;2680;9233
2209005;Rio Grande do Piauí;1991;9789;3043;6746
2209104;Santa Cruz do Piauí;1991;9701;2966;6735
2209203;Santa Filomena;1991;5616;1916;3700
2209302;Santa Luz;1991;4458;1898;2560
2209401;Santo Antônio de Lisboa;1991;5073;2809;2264
2209500;Santo Inácio do Piauí;1991;5621;1381;4240
2209609;São Félix do Piauí;1991;5537;1663;3874
2209708;São Francisco do Piauí;1991;6675;1272;5403
2209807;São Gonçalo do Piauí;1991;5200;2637;2563
2209856;São João da Canabrava;1991;6839;1108;5731
2209906;São João da Serra;1991;7288;2564;4724
2210003;São João do Piauí;1991;38172;9155;29017
2210102;São José do Peixe;1991;5924;1565;4359
2210201;São José do Piauí;1991;6525;1825;4700
2210300;São Julião;1991;9728;1708;8020
2210409;São Miguel do Tapuio;1991;24829;6129;18700
2210508;São Pedro do Piauí;1991;11520;5877;5643
2210607;São Raimundo Nonato;1991;44208;13479;30729
2210706;Simões;1991;22147;3451;18696
2210805;Simplício Mendes;1991;13451;5710;7741
2210904;Socorro do Piauí;1991;5266;1394;3872
2211001;Teresina;1991;599272;556911;42361
2211100;União;1991;41328;13948;27380
2211209;Uruçuí;1991;15913;8953;6960
2211308;Valença do Piauí;1991;20600;10882;9718
2211407;Várzea Grande;1991;8079;2185;5894
2300101;Abaiara;1991;7889;2696;5193
2300150;Acarape;1991;10191;5383;4808
2300200;Acaraú;1991;45505;16623;28882
2300309;Acopiara;1991;49259;17768;31491
2300408;Aiuaba;1991;13219;2096;11123
2300507;Alcântaras;1991;8606;1963;6643
2300606;Altaneira;1991;4806;2799;2007
2300705;Alto Santo;1991;13610;3919;9691
2300754;Amontada;1991;25161;8836;16325
2300804;Antonina do Norte;1991;5086;3120;1966
2300903;Apuiarés;1991;9516;3828;5688
2301000;Aquiraz;1991;46305;40772;5533
2301109;Aracati;1991;60687;33990;26697
2301208;Aracoiaba;1991;22508;10478;12030
2301307;Araripe;1991;17409;7011;10398
2301406;Aratuba;1991;10578;1510;9068
2301505;Arneiroz;1991;7387;1382;6005
2301604;Assaré;1991;19610;6357;13253
2301703;Aurora;1991;24491;8820;15671
2301802;Baixio;1991;5412;2117;3295
2301851;Banabuiú;1991;14364;4021;10343
2301901;Barbalha;1991;38430;24302;14128
2301950;Barreira;1991;14759;3341;11418
2302008;Barro;1991;19375;8323;11052
2302057;Barroquinha;1991;12929;6065;6864
2302107;Baturité;1991;27147;16199;10948
2302206;Beberibe;1991;36801;10520;26281
2302305;Bela Cruz;1991;25966;9344;16622
2302404;Boa Viagem;1991;47918;14566;33352
2302503;Brejo Santo;1991;33721;17364;16357
2302602;Camocim;1991;51035;34167;16868
2302701;Campos Sales;1991;23282;13874;9408
2302800;Canindé;1991;61827;30115;31712
2302909;Capistrano;1991;15559;4459;11100
2303006;Caridade;1991;12432;5646;6786
2303105;Cariré;1991;17747;3822;13925
2303204;Caririaçu;1991;21318;7237;14081
2303303;Cariús;1991;17571;4786;12785
2303402;Carnaubal;1991;13625;5417;8208
2303501;Cascavel;1991;46507;37093;9414
2303600;Catarina;1991;11934;3676;8258
2303709;Caucaia;1991;165099;147601;17498
2303808;Cedro;1991;22930;11057;11873
2303907;Chaval;1991;10560;6888;3672
2303956;Chorozinho;1991;15492;4299;11193
2304004;Coreaú;1991;17565;8439;9126
2304103;Crateús;1991;66652;39945;26707
2304202;Crato;1991;90519;70280;20239
2304236;Croatá;1991;14884;4930;9954
2304251;Cruz;1991;20098;7145;12953
2304269;Deputado Irapuan Pinheiro;1991;8441;1173;7268
2304277;Ererê;1991;6437;1641;4796
2304285;Eusébio;1991;20410;20410;0
2304301;Farias Brito;1991;17625;6871;10754
2304350;Forquilha;1991;15245;8229;7016
2304400;Fortaleza;1991;1768637;1768637;0
2304509;Frecheirinha;1991;9704;4473;5231
2304608;General Sampaio;1991;5565;1772;3793
2304657;Graça;1991;14365;2012;12353
2304707;Granja;1991;41501;15897;25604
2304806;Granjeiro;1991;4743;871;3872
2304905;Groaíras;1991;8079;4620;3459
2304954;Guaiúba;1991;17562;10048;7514
2305001;Guaraciaba do Norte;1991;30312;9285;21027
2305100;Guaramiranga;1991;5293;1572;3721
2305209;Hidrolândia;1991;17900;6763;11137
2305233;Horizonte;1991;18283;10786;7497
2305266;Ibaretama;1991;11253;2004;9249
2305308;Ibiapina;1991;20031;6009;14022
2305332;Ibicuitinga;1991;8598;2424;6174
2305357;Icapuí;1991;13661;5100;8561
2305407;Icó;1991;60466;22513;37953
2305506;Iguatu;1991;75649;53123;22526
2305605;Independência;1991;24031;8086;15945
2305654;Ipaporanga;1991;10849;1821;9028
2305704;Ipaumirim;1991;11284;5240;6044
2305803;Ipu;1991;35689;17736;17953
2305902;Ipueiras;1991;35099;12931;22168
2306009;Iracema;1991;14015;6862;7153
2306108;Irauçuba;1991;17155;7704;9451
2306207;Itaiçaba;1991;5701;3210;2491
2306306;Itapajé;1991;33645;18970;14675
2306405;Itapipoca;1991;77263;34670;42593
2306504;Itapiúna;1991;12854;4966;7888
2306553;Itarema;1991;25548;7719;17829
2306603;Itatira;1991;13853;3996;9857
2306702;Jaguaretama;1991;17580;5436;12144
2306801;Jaguaribara;1991;7718;2878;4840
2306900;Jaguaribe;1991;32340;17158;15182
2307007;Jaguaruana;1991;25917;11734;14183
2307106;Jardim;1991;23964;5226;18738
2307205;Jati;1991;6863;2455;4408
2307304;Juazeiro do Norte;1991;173566;164922;8644
2307403;Jucás;1991;21100;7585;13515
2307502;Lavras da Mangabeira;1991;30751;14758;15993
2307601;Limoeiro do Norte;1991;41700;23342;18358
2307635;Madalena;1991;12660;3645;9015
2307650;Maracanaú;1991;157151;156410;741
2307700;Maranguape;1991;71705;51954;19751
2307809;Marco;1991;20704;8545;12159
2307908;Martinópole;1991;6447;4319;2128
2308005;Massapê;1991;23689;12758;10931
2308104;Mauriti;1991;37153;14270;22883
2308203;Meruoca;1991;10446;3890;6556
2308302;Milagres;1991;24187;9389;14798
2308351;Milhã;1991;12019;3775;8244
2308377;Miraíma;1991;10052;3810;6242
2308401;Missão Velha;1991;29228;10944;18284
2308500;Mombaça;1991;40833;13638;27195
2308609;Monsenhor Tabosa;1991;15527;5652;9875
2308708;Morada Nova;1991;58912;26499;32413
2308807;Moraújo;1991;6272;2333;3939
2308906;Morrinhos;1991;14526;5623;8903
2309003;Mucambo;1991;11952;5136;6816
2309102;Mulungu;1991;7842;3023;4819
2309201;Nova Olinda;1991;11354;4802;6552
2309300;Nova Russas;1991;37832;20526;17306
2309409;Novo Oriente;1991;26318;9251;17067
2309458;Ocara;1991;19828;5182;14646
2309508;Orós;1991;22014;14222;7792
2309607;Pacajus;1991;31800;22650;9150
2309706;Pacatuba;1991;60148;53626;6522
2309805;Pacoti;1991;10100;3179;6921
2309904;Pacujá;1991;5006;2292;2714
2310001;Palhano;1991;7946;3525;4421
2310100;Palmácia;1991;10236;3725;6511
2310209;Paracuru;1991;20942;11147;9795
2310258;Paraipaba;1991;19791;7841;11950
2310308;Parambu;1991;30079;8248;21831
2310407;Paramoti;1991;10447;2803;7644
2310506;Pedra Branca;1991;38800;12320;26480
2310605;Penaforte;1991;6435;2697;3738
2310704;Pentecoste;1991;32252;16591;15661
2310803;Pereiro;1991;14792;4067;10725
2310852;Pindoretama;1991;12442;4185;8257
2310902;Piquet Carneiro;1991;13097;4329;8768
2310951;Pires Ferreira;1991;9472;1562;7910
2311009;Poranga;1991;11057;4486;6571
2311108;Porteiras;1991;15027;3374;11653
2311207;Potengi;1991;8148;3321;4827
2311231;Potiretama;1991;5784;1443;4341
2311264;Quiterianópolis;1991;17345;2595;14750
2311306;Quixadá;1991;72224;39404;32820
2311355;Quixelô;1991;15679;2575;13104
2311405;Quixeramobim;1991;59100;25759;33341
2311504;Quixeré;1991;13801;6692;7109
2311603;Redenção;1991;22757;10718;12039
2311702;Reriutaba;1991;17305;8120;9185
2311801;Russas;1991;46566;27055;19511
2311900;Saboeiro;1991;15461;5486;9975
2311959;Salitre;1991;12645;3321;9324
2312007;Santana do Acaraú;1991;22447;8729;13718
2312106;Santana do Cariri;1991;15403;5699;9704
2312205;Santa Quitéria;1991;49343;15856;33487
2312304;São Benedito;1991;36700;15258;21442
2312403;São Gonçalo do Amarante;1991;29286;17999;11287
2312502;São João do Jaguaribe;1991;8018;2519;5499
2312601;São Luís do Curu;1991;10609;6934;3675
2312700;Senador Pompeu;1991;26597;14580;12017
2312809;Senador Sá;1991;5175;3105;2070
2312908;Sobral;1991;127489;103868;23621
2313005;Solonópole;1991;15831;5623;10208
2313104;Tabuleiro do Norte;1991;25106;12687;12419
2313203;Tamboril;1991;26260;8533;17727
2313252;Tarrafas;1991;10113;1155;8958
2313302;Tauá;1991;51339;22619;28720
2313351;Tejuçuoca;1991;11805;2213;9592
2313401;Tianguá;1991;44005;25413;18592
2313500;Trairi;1991;36344;7661;28683
2313559;Tururu;1991;9916;3650;6266
2313609;Ubajara;1991;23374;9113;14261
2313708;Umari;1991;7896;2675;5221
2313757;Umirim;1991;15331;7745;7586
2313807;Uruburetama;1991;13518;8293;5225
2313906;Uruoca;1991;10220;4420;5800
2313955;Varjota;1991;13465;9973;3492
2314003;Várzea Alegre;1991;31331;14423;16908
2314102;Viçosa do Ceará;1991;40865;10505;30360
2400109;Acari;1991;10983;7807;3176
2400208;Açu;1991;43591;29500;14091
2400307;Afonso Bezerra;1991;10733;6044;4689
2400406;Água Nova;1991;2309;1193;1116
2400505;Alexandria;1991;14580;8380;6200
2400604;Almino Afonso;1991;5698;3038;2660
2400703;Alto do Rodrigues;1991;8247;5323;2924
2400802;Angicos;1991;14476;11150;3326
2400901;Antônio Martins;1991;7564;2922;4642
2401008;Apodi;1991;31175;13864;17311
2401107;Areia Branca;1991;21216;17003;4213
2401206;Arês;1991;11140;5496;5644
2401305;Augusto Severo;1991;12437;5265;7172
2401404;Baía Formosa;1991;7223;5495;1728
2401453;Baraúna;1991;15471;8771;6700
2401503;Barcelona;1991;3655;1284;2371
2401602;Bento Fernandes;1991;4463;1845;2618
2401701;Bom Jesus;1991;7197;4430;2767
2401800;Brejinho;1991;8033;4694;3339
2401909;Caiçara do Rio do Vento;1991;2616;1431;1185
2402006;Caicó;1991;50640;42783;7857
2402105;Campo Redondo;1991;9349;4205;5144
2402204;Canguaretama;1991;22919;14045;8874
2402303;Caraúbas;1991;20248;10676;9572
2402402;Carnaúba dos Dantas;1991;5608;3957;1651
2402501;Carnaubais;1991;10461;3828;6633
2402600;Ceará-Mirim;1991;52157;26002;26155
2402709;Cerro Corá;1991;10526;4019;6507
2402808;Coronel Ezequiel;1991;5909;1570;4339
2402907;Coronel João Pessoa;1991;4725;1497;3228
2403004;Cruzeta;1991;7885;5234;2651
2403103;Currais Novos;1991;40227;33819;6408
2403202;Doutor Severiano;1991;6448;2019;4429
2403251;Parnamirim;1991;63312;48593;14719
2403301;Encanto;1991;4720;2102;2618
2403400;Equador;1991;5492;3372;2120
2403509;Espírito Santo;1991;10121;5017;5104
2403608;Extremoz;1991;14941;8169;6772
2403707;Felipe Guerra;1991;6042;3081;2961
2403806;Florânia;1991;12424;5441;6983
2403905;Francisco Dantas;1991;3267;1273;1994
2404002;Frutuoso Gomes;1991;4642;2456;2186
2404101;Galinhos;1991;1265;823;442
2404200;Goianinha;1991;17496;9879;7617
2404309;Governador Dix-Sept Rosado;1991;10447;4963;5484
2404408;Grossos;1991;9306;6897;2409
2404507;Guamaré;1991;6082;2361;3721
2404606;Ielmo Marinho;1991;9106;897;8209
2404705;Ipanguaçu;1991;16021;3808;12213
2404804;Ipueira;1991;1701;1056;645
2404903;Itaú;1991;4901;3648;1253
2405009;Jaçanã;1991;6859;4424;2435
2405108;Jandaíra;1991;5444;3206;2238
2405207;Janduís;1991;5983;3336;2647
2405306;Januário Cicco;1991;6659;1901;4758
2405405;Japi;1991;6072;3320;2752
2405504;Jardim de Angicos;1991;2439;546;1893
2405603;Jardim de Piranhas;1991;9957;5998;3959
2405702;Jardim do Seridó;1991;11840;8550;3290
2405801;João Câmara;1991;25854;17694;8160
2405900;João Dias;1991;2654;870;1784
2406007;José da Penha;1991;5531;2556;2975
2406106;Jucurutu;1991;14684;7377;7307
2406205;Lagoa d'Anta;1991;5071;2522;2549
2406304;Lagoa de Pedras;1991;5049;1812;3237
2406403;Lagoa de Velhos;1991;1968;1013;955
2406502;Lagoa Nova;1991;10786;4519;6267
2406601;Lagoa Salgada;1991;6130;2969;3161
2406700;Lajes;1991;8687;7069;1618
2406809;Lajes Pintadas;1991;4459;1693;2766
2406908;Lucrécia;1991;2967;1770;1197
2407005;Luís Gomes;1991;11336;6402;4934
2407104;Macaíba;1991;43450;29019;14431
2407203;Macau;1991;25985;19696;6289
2407302;Marcelino Vieira;1991;8813;3371;5442
2407401;Martins;1991;12299;5280;7019
2407500;Maxaranguape;1991;13518;2382;11136
2407609;Messias Targino;1991;3413;2238;1175
2407708;Montanhas;1991;9624;6698;2926
2407807;Monte Alegre;1991;15871;4697;11174
2407906;Monte das Gameleiras;1991;2761;1327;1434
2408003;Mossoró;1991;192267;177331;14936
2408102;Natal;1991;606887;606887;0
2408201;Nísia Floresta;1991;13934;6023;7911
2408300;Nova Cruz;1991;30053;17953;12100
2408409;Olho d'Água do Borges;1991;4576;2711;1865
2408508;Ouro Branco;1991;4545;2407;2138
2408607;Paraná;1991;3510;482;3028
2408706;Paraú;1991;4008;2601;1407
2408805;Parazinho;1991;3980;2558;1422
2408904;Parelhas;1991;17575;13357;4218
2409100;Passa e Fica;1991;6523;3049;3474
2409209;Passagem;1991;2449;1095;1354
2409308;Patu;1991;11741;8543;3198
2409407;Pau dos Ferros;1991;20827;17782;3045
2409506;Pedra Grande;1991;3489;1188;2301
2409605;Pedra Preta;1991;2710;576;2134
2409704;Pedro Avelino;1991;11447;5400;6047
2409803;Pedro Velho;1991;12756;5287;7469
2409902;Pendências;1991;11055;8366;2689
2410009;Pilões;1991;2161;1382;779
2410108;Poço Branco;1991;10455;5536;4919
2410207;Portalegre;1991;6357;2166;4191
2410306;Serra Caiada;1991;5995;3023;2972
2410405;Pureza;1991;6806;2040;4766
2410504;Rafael Fernandes;1991;3332;1529;1803
2410603;Rafael Godeiro;1991;2979;1439;1540
2410702;Riacho da Cruz;1991;2558;1807;751
2410801;Riacho de Santana;1991;3980;1187;2793
2410900;Riachuelo;1991;5816;3460;2356
2411007;Rodolfo Fernandes;1991;5257;3468;1789
2411106;Ruy Barbosa;1991;3304;1163;2141
2411205;Santa Cruz;1991;28654;21783;6871
2411403;Santana do Matos;1991;17188;7065;10123
2411429;Santana do Seridó;1991;2510;1042;1468
2411502;Santo Antônio;1991;19217;9794;9423
2411601;São Bento do Norte;1991;8943;6670;2273
2411700;São Bento do Trairí;1991;3239;1009;2230
2411809;São Fernando;1991;3504;1339;2165
2411908;São Francisco do Oeste;1991;2795;1578;1217
2412005;São Gonçalo do Amarante;1991;45461;8241;37220
2412104;São João do Sabugi;1991;5483;3744;1739
2412203;São José de Mipibu;1991;28151;12858;15293
2412302;São José do Campestre;1991;11826;8093;3733
2412401;São José do Seridó;1991;3177;1767;1410
2412500;São Miguel;1991;21286;9352;11934
2412609;São Paulo do Potengi;1991;14559;8304;6255
2412708;São Pedro;1991;7019;2342;4677
2412807;São Rafael;1991;7843;4547;3296
2412906;São Tomé;1991;11465;4983;6482
2413003;São Vicente;1991;4980;2383;2597
2413102;Senador Elói de Souza;1991;4309;1256;3053
2413201;Senador Georgino Avelino;1991;2663;707;1956
2413300;Serra de São Bento;1991;6294;2747;3547
2413359;Serra do Mel;1991;8016;1233;6783
2413409;Serra Negra do Norte;1991;7505;3053;4452
2413508;Serrinha;1991;6755;1897;4858
2413607;Severiano Melo;1991;10397;2121;8276
2413706;Sítio Novo;1991;4600;1548;3052
2413805;Taboleiro Grande;1991;2071;1288;783
2413904;Taipu;1991;10450;3647;6803
2414001;Tangará;1991;10213;6258;3955
2414100;Tenente Ananias;1991;9529;4991;4538
2414209;Tibau do Sul;1991;5964;1102;4862
2414308;Timbaúba dos Batistas;1991;1935;1379;556
2414407;Touros;1991;27043;5972;21071
2414506;Umarizal;1991;11084;8510;2574
2414605;Upanema;1991;8642;4653;3989
2414704;Várzea;1991;8531;5192;3339
2414803;Vera Cruz;1991;7970;3412;4558
2414902;Viçosa;1991;1309;1075;234
2415008;Vila Flor;1991;2297;1856;441
2500106;Água Branca;1991;8203;2085;6118
2500205;Aguiar;1991;7259;1789;5470
2500304;Alagoa Grande;1991;30128;15979;14149
2500403;Alagoa Nova;1991;22337;7634;14703
2500502;Alagoinha;1991;11075;5898;5177
2500601;Alhandra;1991;13270;6718;6552
2500700;São João do Rio do Peixe;1991;21551;6907;14644
2500809;Araçagi;1991;18369;4821;13548
2500908;Arara;1991;9654;6207;3447
2501005;Araruna;1991;17896;5756;12140
2501104;Areia;1991;28130;12905;15225
2501203;Areial;1991;6075;3216;2859
2501302;Aroeiras;1991;28799;5685;23114
2501401;Baía da Traição;1991;5358;2646;2712
2501500;Bananeiras;1991;23157;5760;17397
2501609;Barra de Santa Rosa;1991;17020;5883;11137
2501708;Barra de São Miguel;1991;5045;1438;3607
2501807;Bayeux;1991;77491;77212;279
2501906;Belém;1991;15645;11285;4360
2502003;Belém do Brejo do Cruz;1991;8141;4462;3679
2502102;Boa Ventura;1991;5970;2346;3624
2502201;Bom Jesus;1991;1735;515;1220
2502300;Bom Sucesso;1991;6277;1517;4760
2502409;Bonito de Santa Fé;1991;9043;4095;4948
2502508;Boqueirão;1991;33255;13098;20157
2502607;Igaracy;1991;5754;2993;2761
2502706;Borborema;1991;4184;2679;1505
2502805;Brejo do Cruz;1991;13884;7650;6234
2502904;Brejo dos Santos;1991;6233;3667;2566
2503001;Caaporã;1991;15007;8406;6601
2503100;Cabaceiras;1991;6180;1993;4187
2503209;Cabedelo;1991;29052;29052;0
2503308;Cachoeira dos Índios;1991;7315;2385;4930
2503407;Cacimba de Areia;1991;2906;905;2001
2503506;Cacimba de Dentro;1991;17672;5915;11757
2503605;Caiçara;1991;10529;5124;5405
2503704;Cajazeiras;1991;51273;38329;12944
2503803;Caldas Brandão;1991;4522;1336;3186
2503902;Camalaú;1991;5549;1990;3559
2504009;Campina Grande;1991;326307;307468;18839
2504108;Carrapateira;1991;1872;1122;750
2504207;Catingueira;1991;5199;2061;3138
2504306;Catolé do Rocha;1991;25220;14516;10704
2504405;Conceição;1991;23216;9952;13264
2504504;Condado;1991;7399;3442;3957
2504603;Conde;1991;10391;3269;7122
2504702;Congo;1991;4367;1418;2949
2504801;Coremas;1991;14485;8224;6261
2504900;Cruz do Espírito Santo;1991;12651;4493;8158
2505006;Cubati;1991;6279;3562;2717
2505105;Cuité;1991;23153;11651;11502
2505204;Cuitegi;1991;6989;5469;1520
2505303;Curral Velho;1991;2537;746;1791
2505402;Desterro;1991;12771;2976;9795
2505501;Vista Serrana;1991;3052;1104;1948
2505600;Diamante;1991;7356;2757;4599
2505709;Dona Inês;1991;9842;3139;6703
2505808;Duas Estradas;1991;7357;4224;3133
2505907;Emas;1991;3129;1137;1992
2506004;Esperança;1991;27594;16795;10799
2506103;Fagundes;1991;13195;4351;8844
2506202;Frei Martinho;1991;2684;1162;1522
2506301;Guarabira;1991;48654;41025;7629
2506400;Gurinhém;1991;13136;4722;8414
2506509;Gurjão;1991;6072;1975;4097
2506608;Ibiara;1991;6583;3010;3573
2506707;Imaculada;1991;10223;1840;8383
2506806;Ingá;1991;21721;11422;10299
2506905;Itabaiana;1991;26464;20162;6302
2507002;Itaporanga;1991;19814;11885;7929
2507101;Itapororoca;1991;13435;5714;7721
2507200;Itatuba;1991;9141;4105;5036
2507309;Jacaraú;1991;18344;6178;12166
2507408;Jericó;1991;9458;4043;5415
2507507;João Pessoa;1991;497600;497600;0
2507606;Juarez Távora;1991;7219;4755;2464
2507705;Juazeirinho;1991;17341;7529;9812
2507804;Junco do Seridó;1991;5768;2849;2919
2507903;Juripiranga;1991;9405;8348;1057
2508000;Juru;1991;10523;2644;7879
2508109;Lagoa;1991;5756;1643;4113
2508208;Lagoa de Dentro;1991;7322;2658;4664
2508307;Lagoa Seca;1991;21660;6378;15282
2508406;Lastro;1991;3278;759;2519
2508505;Livramento;1991;7029;2375;4654
2508604;Lucena;1991;7699;5442;2257
2508703;Mãe d'Água;1991;4719;1075;3644
2508802;Malta;1991;6023;4567;1456
2508901;Mamanguape;1991;49887;29897;19990
2509008;Manaíra;1991;11375;3356;8019
2509107;Mari;1991;20702;17178;3524
2509206;Massaranduba;1991;12030;2240;9790
2509305;Mataraca;1991;4990;3868;1122
2509404;Mogeiro;1991;13295;3736;9559
2509503;Montadas;1991;3836;1500;2336
2509602;Monte Horebe;1991;4053;1733;2320
2509701;Monteiro;1991;27052;14655;12397
2509800;Mulungu;1991;10922;3840;7082
2509909;Natuba;1991;11624;2951;8673
2510006;Nazarezinho;1991;7420;2259;5161
2510105;Nova Floresta;1991;7257;6167;1090
2510204;Nova Olinda;1991;6198;2305;3893
2510303;Nova Palmeira;1991;3320;1446;1874
2510402;Olho d'Água;1991;9109;2220;6889
2510501;Olivedos;1991;3392;1197;2195
2510600;Ouro Velho;1991;2826;1595;1231
2510709;Passagem;1991;3444;1038;2406
2510808;Patos;1991;81298;76708;4590
2510907;Paulista;1991;11004;2673;8331
2511004;Pedra Branca;1991;3566;1514;2052
2511103;Pedra Lavrada;1991;6677;1956;4721
2511202;Pedras de Fogo;1991;26614;12876;13738
2511301;Piancó;1991;15960;8786;7174
2511400;Picuí;1991;18895;9293;9602
2511509;Pilar;1991;13773;6990;6783
2511608;Pilões;1991;7894;2490;5404
2511707;Pilõezinhos;1991;5391;2034;3357
2511806;Pirpirituba;1991;10596;7081;3515
2511905;Pitimbu;1991;9463;5925;3538
2512002;Pocinhos;1991;14502;6549;7953
2512101;Pombal;1991;39511;22589;16922
2512200;Prata;1991;3311;1934;1377
2512309;Princesa Isabel;1991;22234;8810;13424
2512408;Puxinanã;1991;11573;2601;8972
2512507;Queimadas;1991;32555;11814;20741
2512606;Quixaba;1991;1657;463;1194
2512705;Remígio;1991;17167;9801;7366
2512804;Riacho dos Cavalos;1991;9462;2698;6764
2512903;Rio Tinto;1991;27127;15956;11171
2513000;Salgadinho;1991;2710;373;2337
2513109;Salgado de São Félix;1991;12534;3406;9128
2513208;Santa Cruz;1991;7410;2389;5021
2513307;Santa Helena;1991;6127;2226;3901
2513406;Santa Luzia;1991;13040;10803;2237
2513505;Santana de Mangueira;1991;6501;1144;5357
2513604;Santana dos Garrotes;1991;8064;2421;5643
2513703;Santa Rita;1991;94413;76490;17923
2513802;Santa Teresinha;1991;4920;1099;3821
2513901;São Bento;1991;21579;13323;8256
2514008;São João do Cariri;1991;7537;2217;5320
2514107;São João do Tigre;1991;4146;935;3211
2514206;São José da Lagoa Tapada;1991;7650;2720;4930
2514305;São José de Caiana;1991;5329;1267;4062
2514404;São José de Espinharas;1991;5998;1110;4888
2514503;São José de Piranhas;1991;17625;6076;11549
2514602;São José do Bonfim;1991;2808;762;2046
2514701;São José do Sabugi;1991;4001;1600;2401
2514800;São José dos Cordeiros;1991;6180;1352;4828
2514909;São Mamede;1991;8521;4944;3577
2515005;São Miguel de Taipu;1991;4213;2531;1682
2515104;São Sebastião de Lagoa de Roça;1991;8794;2779;6015
2515203;São Sebastião do Umbuzeiro;1991;4448;2378;2070
2515302;Sapé;1991;58515;34231;24284
2515401;São Vicente do Seridó;1991;7870;2373;5497
2515500;Serra Branca;1991;13595;7648;5947
2515609;Serra da Raiz;1991;3703;2080;1623
2515708;Serra Grande;1991;2598;1104;1494
2515807;Serra Redonda;1991;7305;2570;4735
2515906;Serraria;1991;9561;2893;6668
2516003;Solânea;1991;32732;14803;17929
2516102;Soledade;1991;11175;6902;4273
2516201;Sousa;1991;79135;52066;27069
2516300;Sumé;1991;17230;10322;6908
2516409;Tacima;1991;10407;3418;6989
2516508;Taperoá;1991;15197;7905;7292
2516607;Tavares;1991;14342;4015;10327
2516706;Teixeira;1991;17552;6858;10694
2516805;Triunfo;1991;10606;2866;7740
2516904;Uiraúna;1991;20133;8937;11196
2517001;Umbuzeiro;1991;17362;2896;14466
2517100;Várzea;1991;2211;1090;1121
2600054;Abreu e Lima;1991;77035;70548;6487
2600104;Afogados da Ingazeira;1991;29617;18222;11395
2600203;Afrânio;1991;13305;3053;10252
2600302;Agrestina;1991;17993;9325;8668
2600401;Água Preta;1991;36609;16899;19710
2600500;Águas Belas;1991;38355;15138;23217
2600609;Alagoinha;1991;11068;5137;5931
2600708;Aliança;1991;37455;15310;22145
2600807;Altinho;1991;23144;8082;15062
2600906;Amaraji;1991;19997;9913;10084
2601003;Angelim;1991;8734;3907;4827
2601102;Araripina;1991;60585;26938;33647
2601201;Arcoverde;1991;55776;49465;6311
2601300;Barra de Guabiraba;1991;10520;8473;2047
2601409;Barreiros;1991;40569;27558;13011
2601508;Belém de Maria;1991;12204;6451;5753
2601607;Belém do São Francisco;1991;23002;11424;11578
2601706;Belo Jardim;1991;60658;43755;16903
2601805;Betânia;1991;11226;2150;9076
2601904;Bezerros;1991;52134;35828;16306
2602001;Bodocó;1991;28507;7053;21454
2602100;Bom Conselho;1991;41177;20176;21001
2602209;Bom Jardim;1991;36798;11039;25759
2602308;Bonito;1991;35043;18642;16401
2602407;Brejão;1991;8707;2132;6575
2602506;Brejinho;1991;7403;1865;5538
2602605;Brejo da Madre de Deus;1991;31206;18020;13186
2602704;Buenos Aires;1991;12462;4546;7916
2602803;Buíque;1991;38123;9867;28256
2602902;Cabo de Santo Agostinho;1991;127036;109763;17273
2603009;Cabrobó;1991;23965;12905;11060
2603108;Cachoeirinha;1991;15852;10533;5319
2603207;Caetés;1991;20626;4374;16252
2603306;Calçado;1991;9424;2736;6688
2603405;Calumbi;1991;6878;1629;5249
2603454;Camaragibe;1991;99407;99407;0
2603504;Camocim de São Félix;1991;13827;10522;3305
2603603;Camutanga;1991;7488;5277;2211
2603702;Canhotinho;1991;24576;11726;12850
2603801;Capoeiras;1991;19577;4392;15185
2603900;Carnaíba;1991;25931;5591;20340
2604007;Carpina;1991;66078;58127;7951
2604106;Caruaru;1991;213697;182012;31685
2604205;Catende;1991;31519;22371;9148
2604304;Cedro;1991;9005;4321;4684
2604403;Chã de Alegria;1991;10899;5832;5067
2604502;Chã Grande;1991;15499;7238;8261
2604601;Condado;1991;18450;14079;4371
2604700;Correntes;1991;16218;7716;8502
2604809;Cortês;1991;12415;7834;4581
2604908;Cumaru;1991;18004;4703;13301
2605004;Cupira;1991;22701;13892;8809
2605103;Custódia;1991;28849;12824;16025
2605202;Escada;1991;55841;37319;18522
2605301;Exu;1991;31941;10728;21213
2605400;Feira Nova;1991;18526;10975;7551
2605459;Fernando de Noronha;1991;1686;1686;0
2605509;Ferreiros;1991;10927;6413;4514
2605608;Flores;1991;21810;5285;16525
2605707;Floresta;1991;32336;12444;19892
2605806;Frei Miguelinho;1991;14099;2168;11931
2605905;Gameleira;1991;19641;11671;7970
2606002;Garanhuns;1991;103341;89206;14135
2606101;Glória do Goitá;1991;26808;8549;18259
2606200;Goiana;1991;64150;40552;23598
2606309;Granito;1991;5947;1175;4772
2606408;Gravatá;1991;61485;46150;15335
2606507;Iati;1991;18586;5431;13155
2606606;Ibimirim;1991;28101;13564;14537
2606705;Ibirajuba;1991;7548;1849;5699
2606804;Igarassu;1991;79837;59817;20020
2606903;Iguaracy;1991;11239;4531;6708
2607000;Inajá;1991;23198;6189;17009
2607109;Ingazeira;1991;4430;1700;2730
2607208;Ipojuca;1991;45424;25168;20256
2607307;Ipubi;1991;21231;10108;11123
2607406;Itacuruba;1991;3248;2556;692
2607505;Itaíba;1991;27142;4968;22174
2607604;Ilha de Itamaracá;1991;11606;8580;3026
2607653;Itambé;1991;34250;22434;11816
2607703;Itapetim;1991;15658;6881;8777
2607752;Itapissuma;1991;16408;14101;2307
2607802;Itaquitinga;1991;14027;9458;4569
2607901;Jaboatão dos Guararapes;1991;487119;419479;67640
2608008;Jataúba;1991;14450;4771;9679
2608107;João Alfredo;1991;27419;7801;19618
2608206;Joaquim Nabuco;1991;15702;8563;7139
2608305;Jupi;1991;19865;6213;13652
2608404;Jurema;1991;12688;5712;6976
2608503;Lagoa de Itaenga;1991;16508;11242;5266
2608602;Lagoa do Ouro;1991;11375;3628;7747
2608701;Lagoa dos Gatos;1991;16762;6690;10072
2608800;Lajedo;1991;29718;17993;11725
2608909;Limoeiro;1991;54860;40222;14638
2609006;Macaparana;1991;20854;10960;9894
2609105;Machados;1991;9021;4233;4788
2609204;Maraial;1991;21491;11996;9495
2609303;Mirandiba;1991;12867;4995;7872
2609402;Moreno;1991;39132;31571;7561
2609501;Nazaré da Mata;1991;26539;20485;6054
2609600;Olinda;1991;341394;341394;0
2609709;Orobó;1991;20877;4571;16306
2609808;Orocó;1991;10731;3429;7302
2609907;Ouricuri;1991;73526;22741;50785
2610004;Palmares;1991;57731;43326;14405
2610103;Palmeirina;1991;8311;3618;4693
2610202;Panelas;1991;26666;7847;18819
2610301;Paranatama;1991;11415;1116;10299
2610400;Parnamirim;1991;18746;5833;12913
2610509;Passira;1991;29135;10203;18932
2610608;Paudalho;1991;39608;30314;9294
2610707;Paulista;1991;211491;207708;3783
2610806;Pedra;1991;19614;7464;12150
2610905;Pesqueira;1991;57622;39341;18281
2611002;Petrolândia;1991;32963;14319;18644
2611101;Petrolina;1991;175406;125273;50133
2611200;Poção;1991;9584;4874;4710
2611309;Pombos;1991;21250;10282;10968
2611408;Primavera;1991;10854;5235;5619
2611507;Quipapá;1991;21132;9876;11256
2611606;Recife;1991;1298229;1298229;0
2611705;Riacho das Almas;1991;17941;4715;13226
2611804;Ribeirão;1991;41022;26419;14603
2611903;Rio Formoso;1991;33833;13065;20768
2612000;Sairé;1991;11113;2870;8243
2612109;Salgadinho;1991;5923;1614;4309
2612208;Salgueiro;1991;47211;34759;12452
2612307;Saloá;1991;14837;4031;10806
2612406;Sanharó;1991;15024;6988;8036
2612505;Santa Cruz do Capibaribe;1991;38332;35027;3305
2612604;Santa Maria da Boa Vista;1991;42006;10183;31823
2612703;Santa Maria do Cambucá;1991;11415;1988;9427
2612802;Santa Terezinha;1991;9748;4508;5240
2612901;São Benedito do Sul;1991;9885;4347;5538
2613008;São Bento do Una;1991;42236;19428;22808
2613107;São Caitano;1991;29598;16710;12888
2613206;São João;1991;18912;5627;13285
2613305;São Joaquim do Monte;1991;17291;7943;9348
2613404;São José da Coroa Grande;1991;11533;6022;5511
2613503;São José do Belmonte;1991;31015;11385;19630
2613602;São José do Egito;1991;28676;15415;13261
2613701;São Lourenço da Mata;1991;85861;71323;14538
2613800;São Vicente Férrer;1991;14172;6431;7741
2613909;Serra Talhada;1991;72341;43394;28947
2614006;Serrita;1991;19009;3126;15883
2614105;Sertânia;1991;31510;15528;15982
2614204;Sirinhaém;1991;33258;10405;22853
2614303;Moreilândia;1991;11879;3775;8104
2614402;Solidão;1991;5779;986;4793
2614501;Surubim;1991;67572;29040;38532
2614600;Tabira;1991;22726;13054;9672
2614709;Tacaimbó;1991;11675;4417;7258
2614808;Tacaratu;1991;17352;5935;11417
2615003;Taquaritinga do Norte;1991;17093;8645;8448
2615102;Terezinha;1991;6789;1459;5330
2615201;Terra Nova;1991;6677;3131;3546
2615300;Timbaúba;1991;57256;40360;16896
2615409;Toritama;1991;14907;13751;1156
2615508;Tracunhaém;1991;11934;7322;4612
2615607;Trindade;1991;18799;14080;4719
2615706;Triunfo;1991;27674;9659;18015
2615805;Tupanatinga;1991;19148;3768;15380
2615904;Tuparetama;1991;7110;4937;2173
2616001;Venturosa;1991;12070;6713;5357
2616100;Verdejante;1991;8132;1547;6585
2616209;Vertentes;1991;14256;5224;9032
2616308;Vicência;1991;28018;9314;18704
2616407;Vitória de Santo Antão;1991;106848;85363;21485
2700102;Água Branca;1991;26560;5544;21016
2700201;Anadia;1991;16337;7903;8434
2700300;Arapiraca;1991;164921;130963;33958
2700409;Atalaia;1991;38563;14265;24298
2700508;Barra de Santo Antônio;1991;14334;5643;8691
2700607;Barra de São Miguel;1991;4950;3501;1449
2700706;Batalha;1991;13033;8278;4755
2700805;Belém;1991;5919;1827;4092
2700904;Belo Monte;1991;7067;1066;6001
2701001;Boca da Mata;1991;22188;11506;10682
2701100;Branquinha;1991;8305;2695;5610
2701209;Cacimbinhas;1991;13721;4060;9661
2701308;Cajueiro;1991;18597;12393;6204
2701407;Campo Alegre;1991;36770;11532;25238
2701506;Campo Grande;1991;10041;4004;6037
2701605;Canapi;1991;18630;3315;15315
2701704;Capela;1991;18777;9734;9043
2701803;Carneiros;1991;5687;2036;3651
2701902;Chã Preta;1991;8196;3019;5177
2702009;Coité do Nóia;1991;9799;2081;7718
2702108;Colônia Leopoldina;1991;16739;9540;7199
2702207;Coqueiro Seco;1991;4784;4203;581
2702306;Coruripe;1991;49240;13975;35265
2702355;Craíbas;1991;17816;5068;12748
2702405;Delmiro Gouveia;1991;41214;31957;9257
2702504;Dois Riachos;1991;10011;3413;6598
2702603;Feira Grande;1991;19052;2813;16239
2702702;Feliz Deserto;1991;3438;2641;797
2702801;Flexeiras;1991;12097;4535;7562
2702900;Girau do Ponciano;1991;27801;7553;20248
2703007;Ibateguara;1991;15620;7354;8266
2703106;Igaci;1991;26127;5058;21069
2703205;Igreja Nova;1991;19849;4010;15839
2703304;Inhapi;1991;14791;4046;10745
2703403;Jacaré dos Homens;1991;4746;2242;2504
2703502;Jacuípe;1991;7481;2302;5179
2703601;Japaratinga;1991;7093;2224;4869
2703700;Jaramataia;1991;4372;2128;2244
2703809;Joaquim Gomes;1991;24201;8544;15657
2703908;Jundiá;1991;15074;1402;13672
2704005;Junqueiro;1991;22221;5133;17088
2704104;Lagoa da Canoa;1991;15900;4909;10991
2704203;Limoeiro de Anadia;1991;19447;1528;17919
2704302;Maceió;1991;629041;583343;45698
2704401;Major Isidoro;1991;17257;7813;9444
2704500;Maragogi;1991;16403;8920;7483
2704609;Maravilha;1991;11380;3602;7778
2704708;Marechal Deodoro;1991;24810;14658;10152
2704807;Maribondo;1991;14966;9623;5343
2704906;Mar Vermelho;1991;3965;979;2986
2705002;Mata Grande;1991;26475;4430;22045
2705101;Matriz de Camaragibe;1991;21146;14340;6806
2705200;Messias;1991;10564;6308;4256
2705309;Minador do Negrão;1991;9355;1620;7735
2705408;Monteirópolis;1991;6140;1820;4320
2705507;Murici;1991;28724;13891;14833
2705606;Novo Lino;1991;14553;5150;9403
2705705;Olho d'Água das Flores;1991;15653;9430;6223
2705804;Olho d'Água do Casado;1991;6414;3773;2641
2705903;Olho d'Água Grande;1991;4413;920;3493
2706000;Olivença;1991;10130;1605;8525
2706109;Ouro Branco;1991;9346;4423;4923
2706208;Palestina;1991;3628;2213;1415
2706307;Palmeira dos Índios;1991;77204;46421;30783
2706406;Pão de Açúcar;1991;21506;9025;12481
2706505;Passo de Camaragibe;1991;14091;5354;8737
2706604;Paulo Jacinto;1991;7117;4483;2634
2706703;Penedo;1991;52245;38574;13671
2706802;Piaçabuçu;1991;16914;10297;6617
2706901;Pilar;1991;29254;22248;7006
2707008;Pindoba;1991;3748;1232;2516
2707107;Piranhas;1991;14458;1718;12740
2707206;Poço das Trincheiras;1991;11489;1215;10274
2707305;Porto Calvo;1991;22658;11182;11476
2707404;Porto de Pedras;1991;9615;4035;5580
2707503;Porto Real do Colégio;1991;17557;5731;11826
2707602;Quebrangulo;1991;11402;5487;5915
2707701;Rio Largo;1991;53924;38525;15399
2707800;Roteiro;1991;7445;4019;3426
2707909;Santa Luzia do Norte;1991;5796;5083;713
2708006;Santana do Ipanema;1991;36088;20146;15942
2708105;Santana do Mundaú;1991;12012;5666;6346
2708204;São Brás;1991;6313;2733;3580
2708303;São José da Laje;1991;21996;10950;11046
2708402;São José da Tapera;1991;27413;6363;21050
2708501;São Luís do Quitunde;1991;31238;13465;17773
2708600;São Miguel dos Campos;1991;50689;28121;22568
2708709;São Miguel dos Milagres;1991;4897;1138;3759
2708808;São Sebastião;1991;24696;7350;17346
2708907;Satuba;1991;9186;5790;3396
2708956;Senador Rui Palmeira;1991;9413;3062;6351
2709004;Tanque d'Arca;1991;7715;2044;5671
2709103;Taquarana;1991;16809;3491;13318
2709152;Teotônio Vilela;1991;29664;21830;7834
2709202;Traipu;1991;22680;6360;16320
2709301;União dos Palmares;1991;57425;34040;23385
2709400;Viçosa;1991;23571;14051;9520
2800100;Amparo de São Francisco;1991;1891;1049;842
2800209;Aquidabã;1991;16275;7643;8632
2800308;Aracaju;1991;402341;402341;0
2800407;Arauá;1991;10477;3581;6896
2800506;Areia Branca;1991;10542;3846;6696
2800605;Barra dos Coqueiros;1991;12727;7442;5285
2800670;Boquim;1991;23015;13151;9864
2800704;Brejo Grande;1991;6701;3433;3268
2801009;Campo do Brito;1991;13420;4911;8509
2801108;Canhoba;1991;3863;1353;2510
2801207;Canindé de São Francisco;1991;11473;5322;6151
2801306;Capela;1991;25105;14721;10384
2801405;Carira;1991;15418;7415;8003
2801504;Carmópolis;1991;6782;5361;1421
2801603;Cedro de São João;1991;5122;4021;1101
2801702;Cristinápolis;1991;10932;4921;6011
2801900;Cumbe;1991;3325;1822;1503
2802007;Divina Pastora;1991;2645;1555;1090
2802106;Estância;1991;53869;44356;9513
2802205;Feira Nova;1991;4417;2005;2412
2802304;Frei Paulo;1991;10278;4873;5405
2802403;Gararu;1991;10465;2379;8086
2802502;General Maynard;1991;2148;1340;808
2802601;Gracho Cardoso;1991;5176;1855;3321
2802700;Ilha das Flores;1991;7125;3181;3944
2802809;Indiaroba;1991;11607;3923;7684
2802908;Itabaiana;1991;64838;41045;23793
2803005;Itabaianinha;1991;30885;12131;18754
2803104;Itabi;1991;4834;2438;2396
2803203;Itaporanga d'Ajuda;1991;20324;7078;13246
2803302;Japaratuba;1991;13004;6190;6814
2803401;Japoatã;1991;10549;3325;7224
2803500;Lagarto;1991;72144;32538;39606
2803609;Laranjeiras;1991;18944;16020;2924
2803708;Macambira;1991;4968;1360;3608
2803807;Malhada dos Bois;1991;2550;1024;1526
2803906;Malhador;1991;9982;4327;5655
2804003;Maruim;1991;14683;11105;3578
2804102;Moita Bonita;1991;9232;2495;6737
2804201;Monte Alegre de Sergipe;1991;9589;5030;4559
2804300;Muribeca;1991;6682;2369;4313
2804409;Neópolis;1991;21411;9124;12287
2804458;Nossa Senhora Aparecida;1991;8584;1468;7116
2804508;Nossa Senhora da Glória;1991;23478;13675;9803
2804607;Nossa Senhora das Dores;1991;19606;10982;8624
2804706;Nossa Senhora de Lourdes;1991;4668;1969;2699
2804805;Nossa Senhora do Socorro;1991;67574;67516;58
2804904;Pacatuba;1991;11500;2017;9483
2805000;Pedra Mole;1991;2144;839;1305
2805109;Pedrinhas;1991;7306;4881;2425
2805208;Pinhão;1991;4430;2387;2043
2805307;Pirambu;1991;4838;2626;2212
2805406;Poço Redondo;1991;20155;4682;15473
2805505;Poço Verde;1991;17666;7849;9817
2805604;Porto da Folha;1991;23476;7078;16398
2805703;Propriá;1991;25091;21944;3147
2805802;Riachão do Dantas;1991;16992;3330;13662
2805901;Riachuelo;1991;7551;5405;2146
2806008;Ribeirópolis;1991;14032;7875;6157
2806107;Rosário do Catete;1991;5639;4454;1185
2806206;Salgado;1991;16717;3629;13088
2806305;Santa Luzia do Itanhy;1991;9874;1868;8006
2806503;Santa Rosa de Lima;1991;3363;1748;1615
2806602;Santo Amaro das Brotas;1991;10624;7723;2901
2806701;São Cristóvão;1991;47558;46233;1325
2806800;São Domingos;1991;7752;3049;4703
2806909;São Francisco;1991;2222;1737;485
2807006;São Miguel do Aleixo;1991;3132;1204;1928
2807105;Simão Dias;1991;32196;13138;19058
2807204;Siriri;1991;6297;2323;3974
2807303;Telha;1991;2205;837;1368
2807402;Tobias Barreto;1991;37577;21882;15695
2807501;Tomar do Geru;1991;11278;3027;8251
2807600;Umbaúba;1991;14593;8103;6490
2900108;Abaíra;1991;8754;2965;5789
2900207;Abaré;1991;11449;2952;8497
2900306;Acajutiba;1991;12894;9728;3166
2900355;Adustina;1991;13714;2279;11435
2900405;Água Fria;1991;14145;3122;11023
2900504;Érico Cardoso;1991;7307;1108;6199
2900603;Aiquara;1991;6612;2455;4157
2900702;Alagoinhas;1991;116894;99508;17386
2900801;Alcobaça;1991;15410;5464;9946
2900900;Almadina;1991;10004;6028;3976
2901007;Amargosa;1991;28026;15831;12195
2901106;Amélia Rodrigues;1991;22779;16444;6335
2901155;América Dourada;1991;15965;8247;7718
2901205;Anagé;1991;41544;4341;37203
2901304;Andaraí;1991;14285;5825;8460
2901353;Andorinha;1991;17170;3666;13504
2901403;Angical;1991;16052;3749;12303
2901502;Anguera;1991;7859;2983;4876
2901601;Antas;1991;17104;4026;13078
2901700;Antônio Cardoso;1991;11328;808;10520
2901809;Antônio Gonçalves;1991;14082;4540;9542
2901908;Aporá;1991;15742;5941;9801
2901957;Apuarema;1991;7647;3681;3966
2902005;Aracatu;1991;15464;2077;13387
2902054;Araçás;1991;8940;3759;5181
2902104;Araci;1991;45341;11584;33757
2902203;Aramari;1991;7636;3829;3807
2902252;Arataca;1991;13594;4456;9138
2902302;Aratuípe;1991;7811;3738;4073
2902401;Aurelino Leal;1991;15737;9268;6469
2902500;Baianópolis;1991;13823;2305;11518
2902609;Baixa Grande;1991;21634;6071;15563
2902658;Banzaê;1991;11489;939;10550
2902708;Barra;1991;39806;15767;24039
2902807;Barra da Estiva;1991;17246;4659;12587
2902906;Barra do Choça;1991;24844;11644;13200
2903003;Barra do Mendes;1991;14469;4817;9652
2903102;Barra do Rocha;1991;9690;3065;6625
2903201;Barreiras;1991;92640;70870;21770
2903235;Barro Alto;1991;12059;2448;9611
2903300;Barro Preto;1991;10601;4589;6012
2903409;Belmonte;1991;22070;10860;11210
2903508;Belo Campo;1991;14301;5713;8588
2903607;Biritinga;1991;14620;1781;12839
2903706;Boa Nova;1991;13505;2988;10517
2903805;Boa Vista do Tupim;1991;17160;4296;12864
2903904;Bom Jesus da Lapa;1991;48910;32390;16520
2903953;Bom Jesus da Serra;1991;10226;1127;9099
2904001;Boninal;1991;13643;2492;11151
2904050;Bonito;1991;11085;4349;6736
2904100;Boquira;1991;19444;5057;14387
2904209;Botuporã;1991;10254;1762;8492
2904308;Brejões;1991;13041;3352;9689
2904407;Brejolândia;1991;11268;1513;9755
2904506;Brotas de Macaúbas;1991;14263;2450;11813
2904605;Brumado;1991;57176;36013;21163
2904704;Buerarema;1991;20839;15959;4880
2904753;Buritirama;1991;12539;2785;9754
2904803;Caatiba;1991;9707;3106;6601
2904852;Cabaceiras do Paraguaçu;1991;14523;1846;12677
2904902;Cachoeira;1991;28290;14193;14097
2905008;Caculé;1991;17812;8697;9115
2905107;Caém;1991;17116;3824;13292
2905156;Caetanos;1991;10655;891;9764
2905206;Caetité;1991;40380;16925;23455
2905305;Cafarnaum;1991;13704;5883;7821
2905404;Cairu;1991;15217;5597;9620
2905503;Caldeirão Grande;1991;15815;4852;10963
2905602;Camacan;1991;37023;16364;20659
2905701;Camaçari;1991;113639;108232;5407
2905800;Camamu;1991;32850;8125;24725
2905909;Campo Alegre de Lourdes;1991;26125;4177;21948
2906006;Campo Formoso;1991;62104;16432;45672
2906105;Canápolis;1991;9475;1638;7837
2906204;Canarana;1991;22589;7549;15040
2906303;Canavieiras;1991;33019;20658;12361
2906402;Candeal;1991;10728;2541;8187
2906501;Candeias;1991;67941;61438;6503
2906600;Candiba;1991;12610;4087;8523
2906709;Cândido Sales;1991;23568;11883;11685
2906808;Cansanção;1991;30903;6926;23977
2906824;Canudos;1991;13762;5232;8530
2906857;Capela do Alto Alegre;1991;17142;3425;13717
2906873;Capim Grosso;1991;19659;12470;7189
2906899;Caraíbas;1991;17088;518;16570
2906907;Caravelas;1991;19763;8932;10831
2907004;Cardeal da Silva;1991;6400;2274;4126
2907103;Carinhanha;1991;25565;7325;18240
2907202;Casa Nova;1991;46838;18482;28356
2907301;Castro Alves;1991;26773;13187;13586
2907400;Catolândia;1991;3274;801;2473
2907509;Catu;1991;43430;33394;10036
2907558;Caturama;1991;9714;1192;8522
2907608;Central;1991;14696;6621;8075
2907707;Chorrochó;1991;9603;1528;8075
2907806;Cícero Dantas;1991;27201;12124;15077
2907905;Cipó;1991;12273;7770;4503
2908002;Coaraci;1991;31064;21659;9405
2908101;Cocos;1991;15983;4972;11011
2908200;Conceição da Feira;1991;16067;8035;8032
2908309;Conceição do Almeida;1991;18542;7659;10883
2908408;Conceição do Coité;1991;52338;20002;32336
2908507;Conceição do Jacuípe;1991;22905;16174;6731
2908606;Conde;1991;16149;5494;10655
2908705;Condeúba;1991;17898;5761;12137
2908804;Contendas do Sincorá;1991;4763;2181;2582
2908903;Coração de Maria;1991;21937;5570;16367
2909000;Cordeiros;1991;10664;2296;8368
2909109;Coribe;1991;14167;4825;9342
2909208;Coronel João Sá;1991;17133;2972;14161
2909307;Correntina;1991;28005;8636;19369
2909406;Cotegipe;1991;12480;5118;7362
2909505;Cravolândia;1991;4720;2475;2245
2909604;Crisópolis;1991;16778;4057;12721
2909703;Cristópolis;1991;12651;2252;10399
2909802;Cruz das Almas;1991;45858;30908;14950
2909901;Curaçá;1991;24895;7749;17146
2910008;Dário Meira;1991;13507;4102;9405
2910057;Dias d'Ávila;1991;31260;29478;1782
2910107;Dom Basílio;1991;9730;1109;8621
2910206;Dom Macedo Costa;1991;3904;853;3051
2910305;Elísio Medrado;1991;7839;1997;5842
2910404;Encruzilhada;1991;21362;3692;17670
2910503;Entre Rios;1991;27718;16897;10821
2910602;Esplanada;1991;23205;15198;8007
2910701;Euclides da Cunha;1991;51812;17778;34034
2910727;Eunápolis;1991;70545;63540;7005
2910750;Fátima;1991;17683;4344;13339
2910776;Feira da Mata;1991;6343;1470;4873
2910800;Feira de Santana;1991;406447;349557;56890
2910859;Filadélfia;1991;16994;4902;12092
2910909;Firmino Alves;1991;5523;3793;1730
2911006;Floresta Azul;1991;13940;7766;6174
2911105;Formosa do Rio Preto;1991;15418;5624;9794
2911204;Gandu;1991;26461;19597;6864
2911253;Gavião;1991;7118;2486;4632
2911303;Gentio do Ouro;1991;11093;4163;6930
2911402;Glória;1991;12815;1611;11204
2911501;Gongogi;1991;8951;5676;3275
2911600;Governador Mangabeira;1991;17859;5338;12521
2911659;Guajeru;1991;8534;1044;7490
2911709;Guanambi;1991;65592;45127;20465
2911808;Guaratinga;1991;25441;9159;16282
2911857;Heliópolis;1991;11376;2367;9009
2911907;Iaçu;1991;26065;18806;7259
2912004;Ibiassucê;1991;11898;2956;8942
2912103;Ibicaraí;1991;30560;19332;11228
2912202;Ibicoara;1991;8726;1253;7473
2912301;Ibicuí;1991;15636;9308;6328
2912400;Ibipeba;1991;17449;4973;12476
2912509;Ibipitanga;1991;13245;2199;11046
2912608;Ibiquera;1991;5838;2060;3778
2912707;Ibirapitanga;1991;26784;6697;20087
2912806;Ibirapuã;1991;8290;3413;4877
2912905;Ibirataia;1991;22694;15369;7325
2913002;Ibitiara;1991;17008;2921;14087
2913101;Ibititá;1991;17285;6588;10697
2913200;Ibotirama;1991;23270;15231;8039
2913309;Ichu;1991;8596;3124;5472
2913408;Igaporã;1991;13952;5903;8049
2913457;Igrapiúna;1991;12695;966;11729
2913507;Iguaí;1991;22984;9062;13922
2913606;Ilhéus;1991;223750;144232;79518
2913705;Inhambupe;1991;25777;10057;15720
2913804;Ipecaetá;1991;16376;1411;14965
2913903;Ipiaú;1991;45245;36408;8837
2914000;Ipirá;1991;62672;18088;44584
2914109;Ipupiara;1991;8034;4102;3932
2914208;Irajuba;1991;6354;1832;4522
2914307;Iramaia;1991;17199;6817;10382
2914406;Iraquara;1991;17006;4093;12913
2914505;Irará;1991;23869;7368;16501
2914604;Irecê;1991;50908;40069;10839
2914653;Itabela;1991;20848;13577;7271
2914703;Itaberaba;1991;53742;36934;16808
2914802;Itabuna;1991;185277;177561;7716
2914901;Itacaré;1991;18431;4275;14156
2915007;Itaeté;1991;14296;4676;9620
2915106;Itagi;1991;14554;8536;6018
2915205;Itagibá;1991;19916;7284;12632
2915304;Itagimirim;1991;7887;5078;2809
2915353;Itaguaçu da Bahia;1991;17341;1530;15811
2915403;Itaju do Colônia;1991;9773;2885;6888
2915502;Itajuípe;1991;24931;15972;8959
2915601;Itamaraju;1991;64308;44449;19859
2915700;Itamari;1991;8831;4649;4182
2915809;Itambé;1991;23901;18516;5385
2915908;Itanagra;1991;5553;1382;4171
2916005;Itanhém;1991;23225;13060;10165
2916104;Itaparica;1991;15055;15055;0
2916203;Itapé;1991;15644;7565;8079
2916302;Itapebi;1991;11078;6396;4682
2916401;Itapetinga;1991;53476;49340;4136
2916500;Itapicuru;1991;24851;3395;21456
2916609;Itapitanga;1991;10474;6095;4379
2916708;Itaquara;1991;7180;3070;4110
2916807;Itarantim;1991;17216;10127;7089
2916856;Itatim;1991;10039;6254;3785
2916906;Itiruçu;1991;12622;7700;4922
2917003;Itiúba;1991;34403;7068;27335
2917102;Itororó;1991;20510;15924;4586
2917201;Ituaçu;1991;16095;3014;13081
2917300;Ituberá;1991;20553;11806;8747
2917334;Iuiu;1991;10841;4227;6614
2917359;Jaborandi;1991;11692;1687;10005
2917409;Jacaraci;1991;13939;2439;11500
2917508;Jacobina;1991;76518;50009;26509
2917607;Jaguaquara;1991;39372;26977;12395
2917706;Jaguarari;1991;31141;6070;25071
2917805;Jaguaripe;1991;13840;3943;9897
2917904;Jandaíra;1991;8225;4471;3754
2918001;Jequié;1991;144772;116885;27887
2918100;Jeremoabo;1991;38449;13640;24809
2918209;Jiquiriçá;1991;11763;3386;8377
2918308;Jitaúna;1991;20831;6993;13838
2918357;João Dourado;1991;19211;9336;9875
2918407;Juazeiro;1991;128767;102266;26501
2918456;Jucuruçu;1991;16012;1299;14713
2918506;Jussara;1991;14002;8547;5455
2918555;Jussari;1991;8470;4609;3861
2918605;Jussiape;1991;10229;3902;6327
2918704;Lafaiete Coutinho;1991;5125;1771;3354
2918753;Lagoa Real;1991;10978;1148;9830
2918803;Laje;1991;18319;3849;14470
2918902;Lajedão;1991;3818;1663;2155
2919009;Lajedinho;1991;6225;892;5333
2919058;Lajedo do Tabocal;1991;6476;3291;3185
2919108;Lamarão;1991;10275;1521;8754
2919157;Lapão;1991;20913;6848;14065
2919207;Lauro de Freitas;1991;69270;44374;24896
2919306;Lençóis;1991;7584;3481;4103
2919405;Licínio de Almeida;1991;14089;5771;8318
2919504;Livramento de Nossa Senhora;1991;34345;13200;21145
2919603;Macajuba;1991;10479;3235;7244
2919702;Macarani;1991;14057;8881;5176
2919801;Macaúbas;1991;34558;8001;26557
2919900;Macururé;1991;6770;1353;5417
2919926;Madre de Deus;1991;9183;8792;391
2919959;Maetinga;1991;10399;1317;9082
2920007;Maiquinique;1991;7833;4056;3777
2920106;Mairi;1991;20769;6980;13789
2920205;Malhada;1991;15210;2688;12522
2920304;Malhada de Pedras;1991;7279;1501;5778
2920403;Manoel Vitorino;1991;17025;5186;11839
2920452;Mansidão;1991;10290;1844;8446
2920502;Maracás;1991;27154;12195;14959
2920601;Maragogipe;1991;38811;20472;18339
2920700;Maraú;1991;17496;2651;14845
2920809;Marcionílio Souza;1991;13661;3934;9727
2920908;Mascote;1991;20178;1573;18605
2921005;Mata de São João;1991;30535;24143;6392
2921054;Matina;1991;8999;1389;7610
2921104;Medeiros Neto;1991;23059;15704;7355
2921203;Miguel Calmon;1991;25260;11969;13291
2921302;Milagres;1991;9298;7200;2098
2921401;Mirangaba;1991;14651;4181;10470
2921450;Mirante;1991;8189;496;7693
2921500;Monte Santo;1991;51280;4855;46425
2921609;Morpará;1991;7411;3637;3774
2921708;Morro do Chapéu;1991;31766;15519;16247
2921807;Mortugaba;1991;12907;4149;8758
2921906;Mucugê;1991;10334;2230;8104
2922003;Mucuri;1991;17606;4810;12796
2922052;Mulungu do Morro;1991;13741;4931;8810
2922102;Mundo Novo;1991;30854;11983;18871
2922201;Muniz Ferreira;1991;6280;2524;3756
2922250;Muquém do São Francisco;1991;8257;807;7450
2922300;Muritiba;1991;24534;14709;9825
2922409;Mutuípe;1991;20491;6943;13548
2922508;Nazaré;1991;25954;20491;5463
2922607;Nilo Peçanha;1991;12290;1980;10310
2922656;Nordestina;1991;9315;1370;7945
2922706;Nova Canaã;1991;13815;5527;8288
2922730;Nova Fátima;1991;10445;3462;6983
2922755;Nova Ibiá;1991;10502;2358;8144
2922805;Nova Itarana;1991;6636;1960;4676
2922854;Nova Redenção;1991;10318;3581;6737
2922904;Nova Soure;1991;24674;10177;14497
2923001;Nova Viçosa;1991;25570;9374;16196
2923035;Novo Horizonte;1991;10184;1357;8827
2923050;Novo Triunfo;1991;11080;2398;8682
2923100;Olindina;1991;21462;9102;12360
2923209;Oliveira dos Brejinhos;1991;21105;4191;16914
2923308;Ouriçangas;1991;7043;1932;5111
2923357;Ourolândia;1991;12235;2356;9879
2923407;Palmas de Monte Alto;1991;20477;5312;15165
2923506;Palmeiras;1991;7142;3600;3542
2923605;Paramirim;1991;22577;5356;17221
2923704;Paratinga;1991;24181;7346;16835
2923803;Paripiranga;1991;26027;5454;20573
2923902;Pau Brasil;1991;16179;9279;6900
2924009;Paulo Afonso;1991;86619;74355;12264
2924058;Pé de Serra;1991;17048;3738;13310
2924108;Pedrão;1991;6813;1411;5402
2924207;Pedro Alexandre;1991;14801;1427;13374
2924306;Piatã;1991;18308;3306;15002
2924405;Pilão Arcado;1991;31949;4268;27681
2924504;Pindaí;1991;16575;3048;13527
2924603;Pindobaçu;1991;24047;5703;18344
2924652;Pintadas;1991;10405;2303;8102
2924678;Piraí do Norte;1991;13759;1848;11911
2924702;Piripá;1991;10416;3478;6938
2924801;Piritiba;1991;24176;8987;15189
2924900;Planaltino;1991;10332;2375;7957
2925006;Planalto;1991;23526;9957;13569
2925105;Poções;1991;37834;24873;12961
2925204;Pojuca;1991;22485;18510;3975
2925253;Ponto Novo;1991;17171;5542;11629
2925303;Porto Seguro;1991;34661;23315;11346
2925402;Potiraguá;1991;10389;5630;4759
2925501;Prado;1991;22632;9655;12977
2925600;Presidente Dutra;1991;13833;6352;7481
2925709;Presidente Jânio Quadros;1991;14125;1493;12632
2925758;Presidente Tancredo Neves;1991;18535;2136;16399
2925808;Queimadas;1991;23162;8431;14731
2925907;Quijingue;1991;23958;3389;20569
2925931;Quixabeira;1991;13927;2710;11217
2925956;Rafael Jambeiro;1991;22572;2549;20023
2926004;Remanso;1991;34381;17868;16513
2926103;Retirolândia;1991;11300;3882;7418
2926202;Riachão das Neves;1991;20282;8921;11361
2926301;Riachão do Jacuípe;1991;37610;14557;23053
2926400;Riacho de Santana;1991;27259;8373;18886
2926509;Ribeira do Amparo;1991;13942;754;13188
2926608;Ribeira do Pombal;1991;42509;20752;21757
2926657;Ribeirão do Largo;1991;10930;2436;8494
2926707;Rio de Contas;1991;14068;4539;9529
2926806;Rio do Antônio;1991;13322;3883;9439
2926905;Rio do Pires;1991;12101;3239;8862
2927002;Rio Real;1991;27783;13917;13866
2927101;Rodelas;1991;4298;3053;1245
2927200;Ruy Barbosa;1991;30052;17114;12938
2927309;Salinas da Margarida;1991;8891;3902;4989
2927408;Salvador;1991;2075273;2073510;1763
2927507;Santa Bárbara;1991;16768;4766;12002
2927606;Santa Brígida;1991;13290;2840;10450
2927705;Santa Cruz Cabrália;1991;6535;3197;3338
2927804;Santa Cruz da Vitória;1991;6653;4527;2126
2927903;Santa Inês;1991;10048;9049;999
2928000;Santaluz;1991;30634;12704;17930
2928059;Santa Luzia;1991;16319;7410;8909
2928109;Santa Maria da Vitória;1991;41528;20774;20754
2928208;Santana;1991;24669;11589;13080
2928307;Santanópolis;1991;9330;785;8545
2928406;Santa Rita de Cássia;1991;23240;10621;12619
2928505;Santa Terezinha;1991;8860;1378;7482
2928604;Santo Amaro;1991;54160;40894;13266
2928703;Santo Antônio de Jesus;1991;64331;52855;11476
2928802;Santo Estêvão;1991;37007;12654;24353
2928901;São Desidério;1991;18977;5539;13438
2928950;São Domingos;1991;10276;3442;6834
2929008;São Félix;1991;12182;7420;4762
2929057;São Félix do Coribe;1991;11916;6764;5152
2929107;São Felipe;1991;20107;6906;13201
2929206;São Francisco do Conde;1991;20238;15734;4504
2929255;São Gabriel;1991;17884;6997;10887
2929305;São Gonçalo dos Campos;1991;24288;11372;12916
2929354;São José da Vitória;1991;8768;5217;3551
2929370;São José do Jacuípe;1991;14100;3633;10467
2929404;São Miguel das Matas;1991;9311;2040;7271
2929503;São Sebastião do Passé;1991;36825;25806;11019
2929602;Sapeaçu;1991;15192;6347;8845
2929701;Sátiro Dias;1991;13679;2290;11389
2929750;Saubara;1991;8016;5469;2547
2929800;Saúde;1991;11389;5515;5874
2929909;Seabra;1991;37859;12432;25427
2930006;Sebastião Laranjeiras;1991;9090;2529;6561
2930105;Senhor do Bonfim;1991;83421;49087;34334
2930154;Serra do Ramalho;1991;33164;2159;31005
2930204;Sento Sé;1991;28387;12380;16007
2930303;Serra Dourada;1991;17473;4242;13231
2930402;Serra Preta;1991;17656;488;17168
2930501;Serrinha;1991;76013;37854;38159
2930600;Serrolândia;1991;11812;4743;7069
2930709;Simões Filho;1991;72526;44419;28107
2930758;Sítio do Mato;1991;8699;5665;3034
2930766;Sítio do Quinto;1991;12050;2147;9903
2930774;Sobradinho;1991;21208;19482;1726
2930808;Souto Soares;1991;18356;2802;15554
2930907;Tabocas do Brejo Velho;1991;11281;2766;8515
2931004;Tanhaçu;1991;18310;4969;13341
2931053;Tanque Novo;1991;12661;3346;9315
2931103;Tanquinho;1991;10280;5820;4460
2931202;Taperoá;1991;17046;7308;9738
2931301;Tapiramutá;1991;13691;8795;4896
2931350;Teixeira de Freitas;1991;85547;74221;11326
2931400;Teodoro Sampaio;1991;9601;6490;3111
2931509;Teofilândia;1991;21570;3779;17791
2931608;Teolândia;1991;12433;1759;10674
2931707;Terra Nova;1991;12238;10003;2235
2931806;Tremedal;1991;20867;2757;18110
2931905;Tucano;1991;46618;10131;36487
2932002;Uauá;1991;24343;7251;17092
2932101;Ubaíra;1991;20809;7085;13724
2932200;Ubaitaba;1991;21062;12508;8554
2932309;Ubatã;1991;25900;19430;6470
2932408;Uibaí;1991;13616;6818;6798
2932457;Umburanas;1991;11540;4564;6976
2932507;Una;1991;23757;5347;18410
2932606;Urandi;1991;15974;3472;12502
2932705;Uruçuca;1991;30763;9040;21723
2932804;Utinga;1991;17048;7449;9599
2932903;Valença;1991;66931;43699;23232
2933000;Valente;1991;17830;6438;11392
2933059;Várzea da Roça;1991;13448;3963;9485
2933109;Várzea do Poço;1991;9633;4276;5357
2933158;Várzea Nova;1991;17144;7117;10027
2933174;Varzedo;1991;8662;1704;6958
2933208;Vera Cruz;1991;22136;20308;1828
2933257;Vereda;1991;8914;961;7953
2933307;Vitória da Conquista;1991;225091;188351;36740
2933406;Wagner;1991;7834;4818;3016
2933455;Wanderley;1991;13637;4706;8931
2933505;Wenceslau Guimarães;1991;17254;4033;13221
2933604;Xique-Xique;1991;40373;26664;13709
3100104;Abadia dos Dourados;1991;6492;3512;2980
3100203;Abaeté;1991;20689;15944;4745
3100302;Abre Campo;1991;18961;5770;13191
3100401;Acaiaca;1991;3589;1910;1679
3100500;Açucena;1991;24849;14065;10784
3100609;Água Boa;1991;15769;2813;12956
3100708;Água Comprida;1991;1808;1029;779
3100807;Aguanil;1991;3197;1369;1828
3100906;Águas Formosas;1991;22156;11811;10345
3101003;Águas Vermelhas;1991;19185;9751;9434
3101102;Aimorés;1991;26440;18082;8358
3101201;Aiuruoca;1991;6616;2525;4091
3101300;Alagoa;1991;2756;875;1881
3101409;Albertina;1991;2486;1120;1366
3101508;Além Paraíba;1991;30932;26861;4071
3101607;Alfenas;1991;52700;47325;5375
3101706;Almenara;1991;45416;32350;13066
3101805;Alpercata;1991;6752;4358;2394
3101904;Alpinópolis;1991;19919;11549;8370
3102001;Alterosa;1991;11615;7754;3861
3102100;Alto Rio Doce;1991;14160;3959;10201
3102209;Alvarenga;1991;6004;1959;4045
3102308;Alvinópolis;1991;15324;9026;6298
3102407;Alvorada de Minas;1991;3893;1068;2825
3102506;Amparo do Serra;1991;6232;2181;4051
3102605;Andradas;1991;28377;19260;9117
3102704;Cachoeira de Pajeú;1991;8774;2496;6278
3102803;Andrelândia;1991;12497;8165;4332
3102902;Antônio Carlos;1991;9812;3473;6339
3103009;Antônio Dias;1991;9772;3698;6074
3103108;Antônio Prado de Minas;1991;2255;827;1428
3103207;Araçaí;1991;1978;1468;510
3103306;Aracitaba;1991;2400;1375;1025
3103405;Araçuaí;1991;33826;16590;17236
3103504;Araguari;1991;91283;82103;9180
3103603;Arantina;1991;2638;2205;433
3103702;Araponga;1991;7874;1631;6243
3103801;Arapuá;1991;3113;1495;1618
3103900;Araújos;1991;5507;4227;1280
3104007;Araxá;1991;69911;67972;1939
3104106;Arceburgo;1991;7259;4917;2342
3104205;Arcos;1991;27418;23469;3949
3104304;Areado;1991;10817;7788;3029
3104403;Argirita;1991;3091;1947;1144
3104502;Arinos;1991;17125;7434;9691
3104601;Astolfo Dutra;1991;11412;9053;2359
3104700;Ataléia;1991;17890;7039;10851
3104809;Augusto de Lima;1991;5726;1638;4088
3104908;Baependi;1991;16643;10403;6240
3105004;Baldim;1991;8383;4345;4038
3105103;Bambuí;1991;20573;15032;5541
3105202;Bandeira;1991;5813;1926;3887
3105301;Bandeira do Sul;1991;4100;3147;953
3105400;Barão de Cocais;1991;20291;18096;2195
3105509;Barão de Monte Alto;1991;6212;3416;2796
3105608;Barbacena;1991;99954;83319;16635
3105707;Barra Longa;1991;8902;2198;6704
3105905;Barroso;1991;17014;16274;740
3106002;Bela Vista de Minas;1991;9594;8910;684
3106101;Belmiro Braga;1991;3975;941;3034
3106200;Belo Horizonte;1991;2020161;2013257;6904
3106309;Belo Oriente;1991;16718;12485;4233
3106408;Belo Vale;1991;7040;2471;4569
3106507;Berilo;1991;17745;2110;15635
3106606;Bertópolis;1991;10573;4075;6498
3106705;Betim;1991;170934;162143;8791
3106804;Bias Fortes;1991;4852;1599;3253
3106903;Bicas;1991;11239;9591;1648
3107000;Biquinhas;1991;3055;1098;1957
3107109;Boa Esperança;1991;33015;25267;7748
3107208;Bocaina de Minas;1991;4944;2011;2933
3107307;Bocaiúva;1991;47045;29521;17524
3107406;Bom Despacho;1991;35330;30823;4507
3107505;Bom Jardim de Minas;1991;6236;4709;1527
3107604;Bom Jesus da Penha;1991;2922;1627;1295
3107703;Bom Jesus do Amparo;1991;4951;1868;3083
3107802;Bom Jesus do Galho;1991;17519;6840;10679
3107901;Bom Repouso;1991;8901;4092;4809
3108008;Bom Sucesso;1991;16472;12418;4054
3108107;Bonfim;1991;7183;2192;4991
3108206;Bonfinópolis de Minas;1991;14464;6875;7589
3108305;Borda da Mata;1991;15410;9077;6333
3108404;Botelhos;1991;14247;8840;5407
3108503;Botumirim;1991;7229;2303;4926
3108602;Brasília de Minas;1991;44979;19151;25828
3108701;Brás Pires;1991;5836;1404;4432
3108800;Braúnas;1991;6515;1271;5244
3108909;Brazópolis;1991;13711;7104;6607
3109006;Brumadinho;1991;19308;11583;7725
3109105;Bueno Brandão;1991;10787;4848;5939
3109204;Buenópolis;1991;9936;6227;3709
3109303;Buritis;1991;18417;10589;7828
3109402;Buritizeiro;1991;24477;18069;6408
3109501;Cabo Verde;1991;12223;5079;7144
3109600;Cachoeira da Prata;1991;3656;3407;249
3109709;Cachoeira de Minas;1991;9323;4480;4843
3109808;Cachoeira Dourada;1991;2284;1728;556
3109907;Caetanópolis;1991;7403;6230;1173
3110004;Caeté;1991;33251;29115;4136
3110103;Caiana;1991;4583;1265;3318
3110202;Cajuri;1991;3721;1711;2010
3110301;Caldas;1991;12372;6234;6138
3110400;Camacho;1991;3814;1160;2654
3110509;Camanducaia;1991;16927;10441;6486
3110608;Cambuí;1991;22302;15096;7206
3110707;Cambuquira;1991;11508;8988;2520
3110806;Campanário;1991;7914;4848;3066
3110905;Campanha;1991;12260;9654;2606
3111002;Campestre;1991;17440;8304;9136
3111101;Campina Verde;1991;20080;13498;6582
3111200;Campo Belo;1991;44527;39809;4718
3111309;Campo do Meio;1991;10883;8621;2262
3111408;Campo Florido;1991;4519;2747;1772
3111507;Campos Altos;1991;11112;9957;1155
3111606;Campos Gerais;1991;23946;12326;11620
3111705;Canaã;1991;5411;1116;4295
3111804;Canápolis;1991;15990;10225;5765
3111903;Cana Verde;1991;5602;2990;2612
3112000;Candeias;1991;13609;7100;6509
3112109;Caparaó;1991;7923;3083;4840
3112208;Capela Nova;1991;5140;2031;3109
3112307;Capelinha;1991;30338;16661;13677
3112406;Capetinga;1991;7300;5483;1817
3112505;Capim Branco;1991;6344;5526;818
3112604;Capinópolis;1991;15060;13172;1888
3112703;Capitão Enéas;1991;11731;8317;3414
3112802;Capitólio;1991;6823;4409;2414
3112901;Caputira;1991;7826;2502;5324
3113008;Caraí;1991;21778;4757;17021
3113107;Caranaíba;1991;3461;908;2553
3113206;Carandaí;1991;18833;13403;5430
3113305;Carangola;1991;40053;25071;14982
3113404;Caratinga;1991;125686;76503;49183
3113503;Carbonita;1991;8195;3631;4564
3113602;Careaçu;1991;5507;3566;1941
3113701;Carlos Chagas;1991;23287;13710;9577
3113800;Carmésia;1991;2242;978;1264
3113909;Carmo da Cachoeira;1991;10279;5661;4618
3114006;Carmo da Mata;1991;10231;6536;3695
3114105;Carmo de Minas;1991;11291;4874;6417
3114204;Carmo do Cajuru;1991;14415;10410;4005
3114303;Carmo do Paranaíba;1991;27358;20276;7082
3114402;Carmo do Rio Claro;1991;17470;10966;6504
3114501;Carmópolis de Minas;1991;13635;7623;6012
3114600;Carrancas;1991;4528;2022;2506
3114709;Carvalhópolis;1991;2575;1541;1034
3114808;Carvalhos;1991;4680;2066;2614
3114907;Casa Grande;1991;2093;755;1338
3115003;Cascalho Rico;1991;2629;982;1647
3115102;Cássia;1991;15818;11996;3822
3115201;Conceição da Barra de Minas;1991;3898;2203;1695
3115300;Cataguases;1991;58138;53426;4712
3115409;Catas Altas da Noruega;1991;3379;970;2409
3115508;Caxambu;1991;19491;19078;413
3115607;Cedro do Abaeté;1991;1402;1140;262
3115706;Central de Minas;1991;6443;4447;1996
3115805;Centralina;1991;13783;11088;2695
3115904;Chácara;1991;3257;2444;813
3116001;Chalé;1991;5529;1829;3700
3116100;Chapada do Norte;1991;15790;1553;14237
3116209;Chiador;1991;2900;1182;1718
3116308;Cipotânea;1991;6240;1625;4615
3116407;Claraval;1991;3409;1352;2057
3116506;Claro dos Poções;1991;8238;4440;3798
3116605;Cláudio;1991;18481;11656;6825
3116704;Coimbra;1991;5477;2955;2522
3116803;Coluna;1991;10342;2584;7758
3116902;Comendador Gomes;1991;2964;857;2107
3117009;Comercinho;1991;10240;2311;7929
3117108;Conceição da Aparecida;1991;9158;5021;4137
3117207;Conceição das Pedras;1991;2493;897;1596
3117306;Conceição das Alagoas;1991;14054;11155;2899
3117405;Conceição de Ipanema;1991;5163;1399;3764
3117504;Conceição do Mato Dentro;1991;18721;9104;9617
3117603;Conceição do Pará;1991;3899;1241;2658
3117702;Conceição do Rio Verde;1991;10472;8179;2293
3117801;Conceição dos Ouros;1991;7695;4009;3686
3117900;Congonhal;1991;7094;4167;2927
3118007;Congonhas;1991;35364;29486;5878
3118106;Congonhas do Norte;1991;4533;1229;3304
3118205;Conquista;1991;7048;4592;2456
3118304;Conselheiro Lafaiete;1991;89059;83451;5608
3118403;Conselheiro Pena;1991;30569;20496;10073
3118502;Consolação;1991;1708;811;897
3118601;Contagem;1991;449588;419975;29613
3118700;Coqueiral;1991;9214;5462;3752
3118809;Coração de Jesus;1991;32688;12898;19790
3118908;Cordisburgo;1991;8451;5326;3125
3119005;Cordislândia;1991;3030;2047;983
3119104;Corinto;1991;25096;19522;5574
3119203;Coroaci;1991;10800;3958;6842
3119302;Coromandel;1991;24954;16498;8456
3119401;Coronel Fabriciano;1991;87439;85747;1692
3119500;Coronel Murta;1991;9191;5217;3974
3119609;Coronel Pacheco;1991;3252;1679;1573
3119708;Coronel Xavier Chaves;1991;2988;1374;1614
3119807;Córrego Danta;1991;4368;2128;2240
3119906;Córrego do Bom Jesus;1991;3929;1266;2663
3120003;Córrego Novo;1991;7830;1335;6495
3120102;Couto de Magalhães de Minas;1991;4012;3180;832
3120201;Cristais;1991;8842;4808;4034
3120300;Cristália;1991;5003;1465;3538
3120409;Cristiano Otoni;1991;4214;2826;1388
3120508;Cristina;1991;9997;3870;6127
3120607;Crucilândia;1991;4579;1954;2625
3120706;Cruzeiro da Fortaleza;1991;3068;2469;599
3120805;Cruzília;1991;11674;9627;2047
3120904;Curvelo;1991;59015;47987;11028
3121001;Datas;1991;4702;2259;2443
3121100;Delfim Moreira;1991;7860;2376;5484
3121209;Delfinópolis;1991;6698;4623;2075
3121308;Descoberto;1991;4083;2501;1582
3121407;Desterro de Entre Rios;1991;6825;2431;4394
3121506;Desterro do Melo;1991;3525;964;2561
3121605;Diamantina;1991;44299;34609;9690
3121704;Diogo de Vasconcelos;1991;4161;748;3413
3121803;Dionísio;1991;10150;5155;4995
3121902;Divinésia;1991;3009;1015;1994
3122009;Divino;1991;21757;7127;14630
3122108;Divino das Laranjeiras;1991;5281;2518;2763
3122207;Divinolândia de Minas;1991;5790;2790;3000
3122306;Divinópolis;1991;151462;144429;7033
3122405;Divisa Nova;1991;4917;3398;1519
3122504;Dom Cavati;1991;6166;4733;1433
3122603;Dom Joaquim;1991;4960;2416;2544
3122702;Dom Silvério;1991;10028;4973;5055
3122801;Dom Viçoso;1991;2870;877;1993
3122900;Dona Eusébia;1991;4804;3776;1028
3123007;Dores de Campos;1991;7255;6036;1219
3123106;Dores de Guanhães;1991;5403;1118;4285
3123205;Dores do Indaiá;1991;13887;12738;1149
3123304;Dores do Turvo;1991;5043;1542;3501
3123403;Doresópolis;1991;1247;691;556
3123502;Douradoquara;1991;1583;826;757
3123601;Elói Mendes;1991;19373;12988;6385
3123700;Engenheiro Caldas;1991;8815;5540;3275
3123809;Engenheiro Navarro;1991;7566;4709;2857
3123908;Entre Rios de Minas;1991;12255;6902;5353
3124005;Ervália;1991;15551;5034;10517
3124104;Esmeraldas;1991;24298;7044;17254
3124203;Espera Feliz;1991;19543;7953;11590
3124302;Espinosa;1991;37594;15799;21795
3124401;Espírito Santo do Dourado;1991;4045;1231;2814
3124500;Estiva;1991;9681;3712;5969
3124609;Estrela Dalva;1991;2617;1475;1142
3124708;Estrela do Indaiá;1991;3982;2942;1040
3124807;Estrela do Sul;1991;7233;3787;3446
3124906;Eugenópolis;1991;9825;4525;5300
3125002;Ewbank da Câmara;1991;3286;2259;1027
3125101;Extrema;1991;14314;9088;5226
3125200;Fama;1991;2115;1236;879
3125309;Faria Lemos;1991;3103;1735;1368
3125408;Felício dos Santos;1991;5802;1387;4415
3125507;São Gonçalo do Rio Preto;1991;2996;1344;1652
3125606;Felisburgo;1991;6001;3845;2156
3125705;Felixlândia;1991;11926;7113;4813
3125804;Fernandes Tourinho;1991;3277;1692;1585
3125903;Ferros;1991;14128;4316;9812
3126000;Florestal;1991;5053;2976;2077
3126109;Formiga;1991;61755;49824;11931
3126208;Formoso;1991;7199;2285;4914
3126307;Fortaleza de Minas;1991;3800;2189;1611
3126406;Fortuna de Minas;1991;2285;1250;1035
3126505;Francisco Badaró;1991;17177;3102;14075
3126604;Francisco Dumont;1991;3666;1974;1692
3126703;Francisco Sá;1991;24993;11343;13650
3126802;Frei Gaspar;1991;7007;1318;5689
3126901;Frei Inocêncio;1991;7245;4687;2558
3127008;Fronteira;1991;7902;6278;1624
3127057;Fronteira dos Vales;1991;5103;2761;2342
3127107;Frutal;1991;41424;33232;8192
3127206;Funilândia;1991;2616;1122;1494
3127305;Galiléia;1991;10819;6877;3942
3127404;Gonçalves;1991;3877;926;2951
3127503;Gonzaga;1991;6163;2588;3575
3127602;Gouveia;1991;11457;7178;4279
3127701;Governador Valadares;1991;230524;215098;15426
3127800;Grão Mogol;1991;20284;6584;13700
3127909;Grupiara;1991;1265;960;305
3128006;Guanhães;1991;25173;17130;8043
3128105;Guapé;1991;11852;4718;7134
3128204;Guaraciaba;1991;10541;2101;8440
3128303;Guaranésia;1991;16251;12260;3991
3128402;Guarani;1991;8046;5094;2952
3128501;Guarará;1991;3814;3090;724
3128600;Guarda-Mor;1991;5919;2644;3275
3128709;Guaxupé;1991;39611;34368;5243
3128808;Guidoval;1991;7177;3605;3572
3128907;Guimarânia;1991;5739;3953;1786
3129004;Guiricema;1991;10297;3359;6938
3129103;Gurinhatã;1991;7640;2715;4925
3129202;Heliodora;1991;5256;3489;1767
3129301;Iapu;1991;14289;6905;7384
3129400;Ibertioga;1991;4854;2456;2398
3129509;Ibiá;1991;18317;14510;3807
3129608;Ibiaí;1991;7097;3454;3643
3129707;Ibiraci;1991;8522;4980;3542
3129806;Ibirité;1991;92675;91193;1482
3129905;Ibitiúra de Minas;1991;2691;1415;1276
3130002;Ibituruna;1991;2572;1944;628
3130101;Igarapé;1991;27400;19909;7491
3130200;Igaratinga;1991;5986;4170;1816
3130309;Iguatama;1991;8362;6084;2278
3130408;Ijaci;1991;4473;3214;1259
3130507;Ilicínea;1991;8783;5799;2984
3130606;Inconfidentes;1991;6221;2809;3412
3130705;Indianópolis;1991;4861;2652;2209
3130804;Ingaí;1991;2398;1223;1175
3130903;Inhapim;1991;33786;9462;24324
3131000;Inhaúma;1991;4766;2726;2040
3131109;Inimutaba;1991;6032;3629;2403
3131208;Ipanema;1991;18228;10886;7342
3131307;Ipatinga;1991;180069;178830;1239
3131406;Ipiaçu;1991;4122;3454;668
3131505;Ipuiúna;1991;7751;5264;2487
3131604;Iraí de Minas;1991;4476;2459;2017
3131703;Itabira;1991;85606;72954;12652
3131802;Itabirinha;1991;10210;5638;4572
3131901;Itabirito;1991;32091;28678;3413
3132008;Itacambira;1991;6807;450;6357
3132107;Itacarambi;1991;21775;11380;10395
3132206;Itaguara;1991;10671;6318;4353
3132305;Itaipé;1991;15684;3815;11869
3132404;Itajubá;1991;75014;68959;6055
3132503;Itamarandiba;1991;32506;14546;17960
3132602;Itamarati de Minas;1991;3439;2093;1346
3132701;Itambacuri;1991;21195;11996;9199
3132800;Itambé do Mato Dentro;1991;2755;451;2304
3132909;Itamogi;1991;9263;5535;3728
3133006;Itamonte;1991;10027;5476;4551
3133105;Itanhandu;1991;11273;9049;2224
3133204;Itanhomi;1991;16958;7913;9045
3133303;Itaobim;1991;20358;14739;5619
3133402;Itapagipe;1991;11203;5643;5560
3133501;Itapecerica;1991;22356;15202;7154
3133600;Itapeva;1991;5529;3013;2516
3133709;Itatiaiuçu;1991;7366;3735;3631
3133758;Itaú de Minas;1991;10953;10429;524
3133808;Itaúna;1991;66395;61946;4449
3133907;Itaverava;1991;6341;1854;4487
3134004;Itinga;1991;22612;6754;15858
3134103;Itueta;1991;6452;2219;4233
3134202;Ituiutaba;1991;84577;78205;6372
3134301;Itumirim;1991;6127;4133;1994
3134400;Iturama;1991;45699;31672;14027
3134509;Itutinga;1991;4305;2486;1819
3134608;Jaboticatubas;1991;12716;5009;7707
3134707;Jacinto;1991;12169;6630;5539
3134806;Jacuí;1991;6616;2898;3718
3134905;Jacutinga;1991;17535;10588;6947
3135001;Jaguaraçu;1991;2745;1257;1488
3135100;Janaúba;1991;53104;44316;8788
3135209;Januária;1991;87163;37149;50014
3135308;Japaraíba;1991;3315;1497;1818
3135407;Jeceaba;1991;6955;3037;3918
3135506;Jequeri;1991;15126;4877;10249
3135605;Jequitaí;1991;9346;5208;4138
3135704;Jequitibá;1991;5048;1365;3683
3135803;Jequitinhonha;1991;22738;15522;7216
3135902;Jesuânia;1991;4345;2339;2006
3136009;Joaíma;1991;18304;9663;8641
3136108;Joanésia;1991;6941;1436;5505
3136207;João Monlevade;1991;59340;57407;1933
3136306;João Pinheiro;1991;49956;28182;21774
3136405;Joaquim Felício;1991;4441;2284;2157
3136504;Jordânia;1991;9524;6209;3315
3136603;Nova União;1991;4865;1152;3713
3136702;Juiz de Fora;1991;385996;380249;5747
3136801;Juramento;1991;6389;2175;4214
3136900;Juruaia;1991;6578;2142;4436
3137007;Ladainha;1991;16601;3545;13056
3137106;Lagamar;1991;8130;4323;3807
3137205;Lagoa da Prata;1991;30816;28108;2708
3137304;Lagoa dos Patos;1991;4120;2205;1915
3137403;Lagoa Dourada;1991;10118;4733;5385
3137502;Lagoa Formosa;1991;15949;8630;7319
3137601;Lagoa Santa;1991;29824;27979;1845
3137700;Lajinha;1991;17231;7706;9525
3137809;Lambari;1991;16071;11525;4546
3137908;Lamim;1991;3572;1024;2548
3138005;Laranjal;1991;5948;3488;2460
3138104;Lassance;1991;6639;2503;4136
3138203;Lavras;1991;65893;60730;5163
3138302;Leandro Ferreira;1991;2928;1451;1477
3138401;Leopoldina;1991;46442;37587;8855
3138500;Liberdade;1991;6045;3468;2577
3138609;Lima Duarte;1991;14641;8990;5651
3138708;Luminárias;1991;5193;3104;2089
3138807;Luz;1991;16432;13370;3062
3138906;Machacalis;1991;6870;5449;1421
3139003;Machado;1991;30709;20082;10627
3139102;Madre de Deus de Minas;1991;3971;2520;1451
3139201;Malacacheta;1991;35153;10794;24359
3139300;Manga;1991;50391;15067;35324
3139409;Manhuaçu;1991;75259;46476;28783
3139508;Manhumirim;1991;27287;16207;11080
3139607;Mantena;1991;38134;19780;18354
3139706;Maravilhas;1991;5406;3243;2163
3139805;Mar de Espanha;1991;9710;7776;1934
3139904;Maria da Fé;1991;13629;7266;6363
3140001;Mariana;1991;38180;29848;8332
3140100;Marilac;1991;4417;3075;1342
3140209;Maripá de Minas;1991;2287;1446;841
3140308;Marliéria;1991;3540;769;2771
3140407;Marmelópolis;1991;2944;1237;1707
3140506;Martinho Campos;1991;11856;8892;2964
3140605;Materlândia;1991;4624;1429;3195
3140704;Mateus Leme;1991;27033;19580;7453
3140803;Matias Barbosa;1991;10955;10113;842
3140902;Matipó;1991;14351;9157;5194
3141009;Mato Verde;1991;19940;8811;11129
3141108;Matozinhos;1991;23606;21788;1818
3141207;Matutina;1991;3758;2368;1390
3141306;Medeiros;1991;2728;1257;1471
3141405;Medina;1991;21760;13186;8574
3141504;Mendes Pimentel;1991;11025;3668;7357
3141603;Mercês;1991;10074;5079;4995
3141702;Mesquita;1991;19963;12163;7800
3141801;Minas Novas;1991;33631;6463;27168
3141900;Minduri;1991;3874;3111;763
3142007;Mirabela;1991;16893;9297;7596
3142106;Miradouro;1991;10227;4228;5999
3142205;Miraí;1991;14700;8479;6221
3142304;Moeda;1991;3885;1319;2566
3142403;Moema;1991;5505;4831;674
3142502;Monjolos;1991;2941;979;1962
3142601;Monsenhor Paulo;1991;7051;4308;2743
3142700;Montalvânia;1991;16553;8395;8158
3142809;Monte Alegre de Minas;1991;17919;11819;6100
3142908;Monte Azul;1991;37706;17979;19727
3143005;Monte Belo;1991;13776;6813;6963
3143104;Monte Carmelo;1991;34705;29532;5173
3143203;Monte Santo de Minas;1991;19291;12717;6574
3143302;Montes Claros;1991;250062;227759;22303
3143401;Monte Sião;1991;17328;9111;8217
3143500;Morada Nova de Minas;1991;6659;4908;1751
3143609;Morro da Garça;1991;3054;1146;1908
3143708;Morro do Pilar;1991;3873;2228;1645
3143807;Munhoz;1991;5652;2839;2813
3143906;Muriaé;1991;84585;71651;12934
3144003;Mutum;1991;27039;9771;17268
3144102;Muzambinho;1991;17887;11424;6463
3144201;Nacip Raydan;1991;4003;2178;1825
3144300;Nanuque;1991;43090;38586;4504
3144409;Natércia;1991;4361;2116;2245
3144508;Nazareno;1991;6921;5058;1863
3144607;Nepomuceno;1991;24069;14580;9489
3144706;Nova Era;1991;17605;14729;2876
3144805;Nova Lima;1991;52400;44038;8362
3144904;Nova Módica;1991;4419;1811;2608
3145000;Nova Ponte;1991;10147;4340;5807
3145109;Nova Resende;1991;11742;5272;6470
3145208;Nova Serrana;1991;17913;15331;2582
3145307;Novo Cruzeiro;1991;30748;6499;24249
3145406;Olaria;1991;2283;723;1560
3145505;Olímpio Noronha;1991;1839;1151;688
3145604;Oliveira;1991;32222;26184;6038
3145703;Oliveira Fortes;1991;2183;894;1289
3145802;Onça de Pitangui;1991;3022;781;2241
3145901;Ouro Branco;1991;27423;23631;3792
3146008;Ouro Fino;1991;30593;16716;13877
3146107;Ouro Preto;1991;62514;48150;14364
3146206;Ouro Verde de Minas;1991;7923;2833;5090
3146305;Padre Paraíso;1991;17327;10123;7204
3146404;Paineiras;1991;5235;3241;1994
3146503;Pains;1991;8065;5365;2700
3146602;Paiva;1991;1416;921;495
3146701;Palma;1991;7054;4155;2899
3146909;Papagaios;1991;10119;6837;3282
3147006;Paracatu;1991;62774;49710;13064
3147105;Pará de Minas;1991;61193;54034;7159
3147204;Paraguaçu;1991;16498;12126;4372
3147303;Paraisópolis;1991;14614;10291;4323
3147402;Paraopeba;1991;17015;13821;3194
3147501;Passabém;1991;1683;464;1219
3147600;Passa Quatro;1991;13408;9149;4259
3147709;Passa Tempo;1991;8152;5052;3100
3147808;Passa Vinte;1991;2413;1194;1219
3147907;Passos;1991;84622;74223;10399
3148004;Patos de Minas;1991;102946;87403;15543
3148103;Patrocínio;1991;60753;47230;13523
3148202;Patrocínio do Muriaé;1991;4449;2611;1838
3148301;Paula Cândido;1991;8295;3011;5284
3148400;Paulistas;1991;5764;1830;3934
3148509;Pavão;1991;14973;5567;9406
3148608;Peçanha;1991;20915;7256;13659
3148707;Pedra Azul;1991;22068;17516;4552
3148806;Pedra do Anta;1991;4160;1554;2606
3148905;Pedra do Indaiá;1991;3986;1502;2484
3149002;Pedra Dourada;1991;1628;764;864
3149101;Pedralva;1991;10999;4547;6452
3149200;Pedrinópolis;1991;4391;2994;1397
3149309;Pedro Leopoldo;1991;41594;32891;8703
3149408;Pedro Teixeira;1991;1593;594;999
3149507;Pequeri;1991;2716;2402;314
3149606;Pequi;1991;3187;1935;1252
3149705;Perdigão;1991;4546;3153;1393
3149804;Perdizes;1991;10735;4558;6177
3149903;Perdões;1991;16300;12504;3796
3150000;Pescador;1991;4349;2828;1521
3150109;Piau;1991;3022;1465;1557
3150208;Piedade de Ponte Nova;1991;4374;2381;1993
3150307;Piedade do Rio Grande;1991;5035;2028;3007
3150406;Piedade dos Gerais;1991;4226;1087;3139
3150505;Pimenta;1991;6733;4862;1871
3150604;Piracema;1991;6060;2088;3972
3150703;Pirajuba;1991;3112;2308;804
3150802;Piranga;1991;16332;3860;12472
3150901;Piranguçu;1991;4581;1365;3216
3151008;Piranguinho;1991;6370;3528;2842
3151107;Pirapetinga;1991;8991;6279;2712
3151206;Pirapora;1991;46351;45492;859
3151305;Piraúba;1991;9142;6660;2482
3151404;Pitangui;1991;20173;16005;4168
3151503;Piumhi;1991;24938;20758;4180
3151602;Planura;1991;7309;6722;587
3151701;Poço Fundo;1991;13817;6911;6906
3151800;Poços de Caldas;1991;110123;105205;4918
3151909;Pocrane;1991;11200;4636;6564
3152006;Pompéu;1991;20350;16252;4098
3152105;Ponte Nova;1991;56678;45820;10858
3152204;Porteirinha;1991;53906;20876;33030
3152303;Porto Firme;1991;9439;2774;6665
3152402;Poté;1991;14676;6493;8183
3152501;Pouso Alegre;1991;81836;74322;7514
3152600;Pouso Alto;1991;5883;2840;3043
3152709;Prados;1991;7371;4247;3124
3152808;Prata;1991;24638;13125;11513
3152907;Pratápolis;1991;9395;7169;2226
3153004;Pratinha;1991;2503;1189;1314
3153103;Presidente Bernardes;1991;6420;993;5427
3153202;Presidente Juscelino;1991;4292;1235;3057
3153301;Presidente Kubitschek;1991;2932;1637;1295
3153400;Presidente Olegário;1991;23145;12400;10745
3153509;Alto Jequitibá;1991;7435;2890;4545
3153608;Prudente de Morais;1991;6819;5586;1233
3153707;Quartel Geral;1991;2952;2063;889
3153806;Queluzito;1991;1728;388;1340
3153905;Raposos;1991;14242;13317;925
3154002;Raul Soares;1991;29496;13597;15899
3154101;Recreio;1991;10578;8732;1846
3154200;Resende Costa;1991;9706;6029;3677
3154309;Resplendor;1991;17499;12194;5305
3154408;Ressaquinha;1991;9380;4483;4897
3154507;Riacho dos Machados;1991;10201;1804;8397
3154606;Ribeirão das Neves;1991;143853;119925;23928
3154705;Ribeirão Vermelho;1991;3614;3220;394
3154804;Rio Acima;1991;7066;5641;1425
3154903;Rio Casca;1991;15367;10429;4938
3155009;Rio Doce;1991;2629;1283;1346
3155108;Rio do Prado;1991;13401;6036;7365
3155207;Rio Espera;1991;7461;1993;5468
3155306;Rio Manso;1991;4461;2062;2399
3155405;Rio Novo;1991;11179;8249;2930
3155504;Rio Paranaíba;1991;9453;4481;4972
3155603;Rio Pardo de Minas;1991;48807;10500;38307
3155702;Rio Piracicaba;1991;13676;10277;3399
3155801;Rio Pomba;1991;14884;11136;3748
3155900;Rio Preto;1991;7271;3814;3457
3156007;Rio Vermelho;1991;15862;3390;12472
3156106;Ritápolis;1991;5753;3289;2464
3156205;Rochedo de Minas;1991;1546;1109;437
3156304;Rodeiro;1991;3749;2338;1411
3156403;Romaria;1991;3392;2397;995
3156502;Rubelita;1991;10006;1711;8295
3156601;Rubim;1991;10772;7269;3503
3156700;Sabará;1991;89740;74757;14983
3156809;Sabinópolis;1991;16054;8579;7475
3156908;Sacramento;1991;20406;13639;6767
3157005;Salinas;1991;50849;19543;31306
3157104;Salto da Divisa;1991;7788;5408;2380
3157203;Santa Bárbara;1991;25931;20969;4962
3157302;Santa Bárbara do Tugúrio;1991;5289;1374;3915
3157401;Santa Cruz do Escalvado;1991;6426;1431;4995
3157500;Santa Efigênia de Minas;1991;4987;1803;3184
3157609;Santa Fé de Minas;1991;4573;1273;3300
3157708;Santa Juliana;1991;7820;5986;1834
3157807;Santa Luzia;1991;137825;130186;7639
3157906;Santa Margarida;1991;12805;4705;8100
3158003;Santa Maria de Itabira;1991;10433;5005;5428
3158102;Santa Maria do Salto;1991;5312;3031;2281
3158201;Santa Maria do Suaçuí;1991;18306;8396;9910
3158300;Santana da Vargem;1991;6846;3552;3294
3158409;Santana de Cataguases;1991;3531;2233;1298
3158508;Santana de Pirapama;1991;9212;2335;6877
3158607;Santana do Deserto;1991;3417;917;2500
3158706;Santana do Garambéu;1991;1755;908;847
3158805;Santana do Jacaré;1991;3836;3435;401
3158904;Santana do Manhuaçu;1991;9156;3549;5607
3159001;Santana do Riacho;1991;3404;1184;2220
3159100;Santana dos Montes;1991;4144;1466;2678
3159209;Santa Rita de Caldas;1991;9258;4599;4659
3159308;Santa Rita de Jacutinga;1991;5122;3150;1972
3159407;Santa Rita de Ibitipoca;1991;4064;1652;2412
3159506;Santa Rita do Itueto;1991;6095;1185;4910
3159605;Santa Rita do Sapucaí;1991;26317;20091;6226
3159704;Santa Rosa da Serra;1991;2867;1579;1288
3159803;Santa Vitória;1991;16583;12196;4387
3159902;Santo Antônio do Amparo;1991;13753;9125;4628
3160009;Santo Antônio do Aventureiro;1991;3490;1513;1977
3160108;Santo Antônio do Grama;1991;4587;2569;2018
3160207;Santo Antônio do Itambé;1991;4447;840;3607
3160306;Santo Antônio do Jacinto;1991;12093;4225;7868
3160405;Santo Antônio do Monte;1991;17979;13322;4657
3160504;Santo Antônio do Rio Abaixo;1991;2101;610;1491
3160603;Santo Hipólito;1991;3705;2078;1627
3160702;Santos Dumont;1991;44965;38087;6878
3160801;São Bento Abade;1991;2556;2175;381
3160900;São Brás do Suaçuí;1991;3198;2477;721
3161007;São Domingos do Prata;1991;18742;7889;10853
3161106;São Francisco;1991;72481;21861;50620
3161205;São Francisco de Paula;1991;6152;3419;2733
3161304;São Francisco de Sales;1991;4941;2782;2159
3161403;São Francisco do Glória;1991;6365;2459;3906
3161502;São Geraldo;1991;7860;3951;3909
3161601;São Geraldo da Piedade;1991;5063;1028;4035
3161700;São Gonçalo do Abaeté;1991;9745;5897;3848
3161809;São Gonçalo do Pará;1991;7541;5682;1859
3161908;São Gonçalo do Rio Abaixo;1991;8322;3160;5162
3162005;São Gonçalo do Sapucaí;1991;19611;15228;4383
3162104;São Gotardo;1991;19697;16520;3177
3162203;São João Batista do Glória;1991;5352;3661;1691
3162302;São João da Mata;1991;2541;1289;1252
3162401;São João da Ponte;1991;32476;9904;22572
3162500;São João del Rei;1991;72747;66700;6047
3162609;São João do Oriente;1991;8166;4921;3245
3162708;São João do Paraíso;1991;28919;5179;23740
3162807;São João Evangelista;1991;15375;7784;7591
3162906;São João Nepomuceno;1991;21432;18955;2477
3163003;São José da Safira;1991;3701;2343;1358
3163102;São José da Varginha;1991;2690;1128;1562
3163201;São José do Alegre;1991;3320;1879;1441
3163300;São José do Divino;1991;4245;2149;2096
3163409;São José do Goiabal;1991;6170;3285;2885
3163508;São José do Jacuri;1991;10976;1527;9449
3163607;São José do Mantimento;1991;2224;910;1314
3163706;São Lourenço;1991;29870;29498;372
3163805;São Miguel do Anta;1991;6315;2782;3533
3163904;São Pedro da União;1991;5072;1901;3171
3164001;São Pedro dos Ferros;1991;10273;6733;3540
3164100;São Pedro do Suaçuí;1991;9286;2940;6346
3164209;São Romão;1991;14562;5893;8669
3164308;São Roque de Minas;1991;6323;2755;3568
3164407;São Sebastião da Bela Vista;1991;3866;1859;2007
3164506;São Sebastião do Maranhão;1991;12820;2578;10242
3164605;São Sebastião do Oeste;1991;5057;1089;3968
3164704;São Sebastião do Paraíso;1991;49053;41446;7607
3164803;São Sebastião do Rio Preto;1991;2116;648;1468
3164902;São Sebastião do Rio Verde;1991;1803;770;1033
3165008;São Tiago;1991;9642;6106;3536
3165107;São Tomás de Aquino;1991;6945;4619;2326
3165206;São Thomé das Letras;1991;5700;2029;3671
3165305;São Vicente de Minas;1991;5407;4413;994
3165404;Sapucaí-Mirim;1991;4274;1987;2287
3165503;Sardoá;1991;4269;1224;3045
3165602;Senador Cortes;1991;1847;821;1026
3165701;Senador Firmino;1991;6241;3092;3149
3165800;Senador José Bento;1991;2013;583;1430
3165909;Senador Modestino Gonçalves;1991;5309;1170;4139
3166006;Senhora de Oliveira;1991;5089;2298;2791
3166105;Senhora do Porto;1991;3702;1080;2622
3166204;Senhora dos Remédios;1991;9725;2732;6993
3166303;Sericita;1991;6382;2003;4379
3166402;Seritinga;1991;1723;1120;603
3166501;Serra Azul de Minas;1991;3874;1112;2762
3166600;Serra da Saudade;1991;852;479;373
3166709;Serra dos Aimorés;1991;10224;8081;2143
3166808;Serra do Salitre;1991;7984;4925;3059
3166907;Serrania;1991;6975;5255;1720
3167004;Serranos;1991;2036;1388;648
3167103;Serro;1991;19341;9766;9575
3167202;Sete Lagoas;1991;144014;140125;3889
3167301;Silveirânia;1991;2047;655;1392
3167400;Silvianópolis;1991;5825;2844;2981
3167509;Simão Pereira;1991;2414;856;1558
3167608;Simonésia;1991;16302;4086;12216
3167707;Sobrália;1991;6838;3373;3465
3167806;Soledade de Minas;1991;4929;2854;2075
3167905;Tabuleiro;1991;4361;2126;2235
3168002;Taiobeiras;1991;26673;18324;8349
3168101;Tapira;1991;2973;1676;1297
3168200;Tapiraí;1991;2240;951;1289
3168309;Taquaraçu de Minas;1991;3383;971;2412
3168408;Tarumirim;1991;18056;5522;12534
3168507;Teixeiras;1991;10024;5352;4672
3168606;Teófilo Otoni;1991;140833;101966;38867
3168705;Timóteo;1991;58298;54997;3301
3168804;Tiradentes;1991;10236;8892;1344
3168903;Tiros;1991;8647;4202;4445
3169000;Tocantins;1991;12836;8565;4271
3169109;Toledo;1991;4664;1430;3234
3169208;Tombos;1991;9767;6327;3440
3169307;Três Corações;1991;57045;49134;7911
3169356;Três Marias;1991;21399;20092;1307
3169406;Três Pontas;1991;45832;33740;12092
3169505;Tumiritinga;1991;5412;3420;1992
3169604;Tupaciguara;1991;26527;20030;6497
3169703;Turmalina;1991;19409;8547;10862
3169802;Turvolândia;1991;3660;1441;2219
3169901;Ubá;1991;66511;54051;12460
3170008;Ubaí;1991;13978;4962;9016
3170107;Uberaba;1991;211824;200705;11119
3170206;Uberlândia;1991;367061;358165;8896
3170305;Umburatiba;1991;2945;1522;1423
3170404;Unaí;1991;69612;42934;26678
3170503;Urucânia;1991;10513;5255;5258
3170602;Vargem Bonita;1991;2317;1041;1276
3170701;Varginha;1991;88022;82242;5780
3170800;Várzea da Palma;1991;29523;24464;5059
3170909;Varzelândia;1991;27081;9738;17343
3171006;Vazante;1991;18799;13364;5435
3171105;Veríssimo;1991;3057;1374;1683
3171204;Vespasiano;1991;54868;35390;19478
3171303;Viçosa;1991;51658;46456;5202
3171402;Vieiras;1991;3796;1275;2521
3171501;Mathias Lobato;1991;3658;2987;671
3171600;Virgem da Lapa;1991;13925;4075;9850
3171709;Virgínia;1991;8540;2482;6058
3171808;Virginópolis;1991;12089;4539;7550
3171907;Virgolândia;1991;6822;2972;3850
3172004;Visconde do Rio Branco;1991;28451;21040;7411
3172103;Volta Grande;1991;4531;2785;1746
3172202;Wenceslau Braz;1991;2487;1046;1441
3200102;Afonso Cláudio;1991;40001;12374;27627
3200136;Águia Branca;1991;9820;1380;8440
3200169;Água Doce do Norte;1991;12701;4723;7978
3200201;Alegre;1991;30422;16330;14092
3200300;Alfredo Chaves;1991;12647;4362;8285
3200359;Alto Rio Novo;1991;7488;2474;5014
3200409;Anchieta;1991;14934;8793;6141
3200508;Apiacá;1991;6995;3490;3505
3200607;Aracruz;1991;52433;43030;9403
3200706;Atílio Vivacqua;1991;6666;2390;4276
3200805;Baixo Guandu;1991;27121;17342;9779
3200904;Barra de São Francisco;1991;35738;16333;19405
3201001;Boa Esperança;1991;12555;7644;4911
3201100;Bom Jesus do Norte;1991;7963;7137;826
3201209;Cachoeiro de Itapemirim;1991;143449;117119;26330
3201308;Cariacica;1991;274532;261084;13448
3201407;Castelo;1991;29592;13465;16127
3201506;Colatina;1991;106845;77522;29323
3201605;Conceição da Barra;1991;22282;15514;6768
3201704;Conceição do Castelo;1991;10533;3137;7396
3201803;Divino de São Lourenço;1991;4090;925;3165
3201902;Domingos Martins;1991;35598;7650;27948
3202009;Dores do Rio Preto;1991;5265;1924;3341
3202108;Ecoporanga;1991;24432;10358;14074
3202207;Fundão;1991;10204;7890;2314
3202306;Guaçuí;1991;21964;15863;6101
3202405;Guarapari;1991;61719;55196;6523
3202454;Ibatiba;1991;15558;7695;7863
3202504;Ibiraçu;1991;9405;6599;2806
3202553;Ibitirama;1991;7655;1619;6036
3202603;Iconha;1991;10172;3483;6689
3202702;Itaguaçu;1991;13393;5983;7410
3202801;Itapemirim;1991;44492;27063;17429
3202900;Itarana;1991;10394;3168;7226
3203007;Iúna;1991;32508;12191;20317
3203056;Jaguaré;1991;17050;6777;10273
3203106;Jerônimo Monteiro;1991;8898;5291;3607
3203130;João Neiva;1991;13472;8994;4478
3203163;Laranja da Terra;1991;10635;2044;8591
3203205;Linhares;1991;119690;86005;33685
3203304;Mantenópolis;1991;13935;5941;7994
3203353;Marilândia;1991;9004;2562;6442
3203403;Mimoso do Sul;1991;24041;10475;13566
3203502;Montanha;1991;18133;12652;5481
3203601;Mucurici;1991;11331;3685;7646
3203700;Muniz Freire;1991;20156;6184;13972
3203809;Muqui;1991;13619;7410;6209
3203908;Nova Venécia;1991;47624;22887;24737
3204005;Pancas;1991;21004;7740;13264
3204054;Pedro Canário;1991;21348;19218;2130
3204104;Pinheiros;1991;21307;14039;7268
3204203;Piúma;1991;9430;8562;868
3204302;Presidente Kennedy;1991;9433;1914;7519
3204351;Rio Bananal;1991;15428;2963;12465
3204401;Rio Novo do Sul;1991;10004;4932;5072
3204500;Santa Leopoldina;1991;11122;1676;9446
3204559;Santa Maria de Jetibá;1991;23268;3941;19327
3204609;Santa Teresa;1991;29356;9388;19968
3204708;São Gabriel da Palha;1991;30148;17055;13093
3204807;São José do Calçado;1991;10208;5644;4564
3204906;São Mateus;1991;73903;51190;22713
3205002;Serra;1991;222158;220615;1543
3205036;Vargem Alta;1991;13082;3619;9463
3205069;Venda Nova do Imigrante;1991;12036;5034;7002
3205101;Viana;1991;43866;39888;3978
3205200;Vila Velha;1991;265586;264236;1350
3205309;Vitória;1991;258777;258777;0
3300100;Angra dos Reis;1991;85571;78445;7126
3300209;Araruama;1991;59024;43373;15651
3300258;Arraial do Cabo;1991;19866;19866;0
3300308;Barra do Piraí;1991;79199;74118;5081
3300407;Barra Mansa;1991;172216;166673;5543
3300506;Bom Jardim;1991;20630;9485;11145
3300605;Bom Jesus do Itabapoana;1991;29873;21180;8693
3300704;Cabo Frio;1991;84915;79217;5698
3300803;Cachoeiras de Macacu;1991;40208;32036;8172
3300902;Cambuci;1991;21011;9362;11649
3301009;Campos dos Goytacazes;1991;389109;324667;64442
3301108;Cantagalo;1991;19672;11890;7782
3301207;Carmo;1991;14509;9439;5070
3301306;Casimiro de Abreu;1991;33845;30386;3459
3301405;Conceição de Macabu;1991;16963;13982;2981
3301504;Cordeiro;1991;20781;18491;2290
3301603;Duas Barras;1991;9875;4438;5437
3301702;Duque de Caxias;1991;667821;664145;3676
3301801;Engenheiro Paulo de Frontin;1991;12061;7269;4792
3301900;Itaboraí;1991;162742;147249;15493
3302007;Itaguaí;1991;113057;96083;16974
3302056;Italva;1991;12764;6352;6412
3302106;Itaocara;1991;22933;13494;9439
3302205;Itaperuna;1991;78000;61742;16258
3302254;Itatiaia;1991;16073;9831;6242
3302304;Laje do Muriaé;1991;7464;3804;3660
3302403;Macaé;1991;100895;89336;11559
3302502;Magé;1991;191734;172255;19479
3302601;Mangaratiba;1991;17925;13394;4531
3302700;Maricá;1991;46545;32708;13837
3302809;Mendes;1991;16598;16486;112
3302908;Miguel Pereira;1991;19446;15942;3504
3303005;Miracema;1991;25091;20954;4137
3303104;Natividade;1991;21765;12136;9629
3303203;Nilópolis;1991;158092;158092;0
3303302;Niterói;1991;436155;436155;0
3303401;Nova Friburgo;1991;167081;144354;22727
3303500;Nova Iguaçu;1991;1297704;1294352;3352
3303609;Paracambi;1991;36427;33520;2907
3303708;Paraíba do Sul;1991;33922;27766;6156
3303807;Paraty;1991;23928;11465;12463
3303856;Paty do Alferes;1991;21095;12967;8128
3303906;Petrópolis;1991;255468;249080;6388
3304003;Piraí;1991;33782;26290;7492
3304102;Porciúncula;1991;14561;9535;5026
3304151;Quissamã;1991;10467;4410;6057
3304201;Resende;1991;91757;75704;16053
3304300;Rio Bonito;1991;45161;27165;17996
3304409;Rio Claro;1991;13665;8644;5021
3304508;Rio das Flores;1991;6451;3866;2585
3304557;Rio de Janeiro;1991;5480768;5480768;0
3304607;Santa Maria Madalena;1991;10850;4627;6223
3304706;Santo Antônio de Pádua;1991;39600;28025;11575
3304805;São Fidélis;1991;34581;22160;12421
3304904;São Gonçalo;1991;779832;779832;0
3305000;São João da Barra;1991;59561;29791;29770
3305109;São João de Meriti;1991;425772;425772;0
3305158;São José do Vale do Rio Preto;1991;15472;7192;8280
3305208;São Pedro da Aldeia;1991;50474;42144;8330
3305307;São Sebastião do Alto;1991;8108;2945;5163
3305406;Sapucaia;1991;15429;9980;5449
3305505;Saquarema;1991;37888;35263;2625
3305604;Silva Jardim;1991;18141;9793;8348
3305703;Sumidouro;1991;12977;2011;10966
3305802;Teresópolis;1991;120709;101219;19490
3305901;Trajano de Moraes;1991;10640;3389;7251
3306008;Três Rios;1991;81248;73291;7957
3306107;Valença;1991;60805;50285;10520
3306206;Vassouras;1991;28649;17464;11185
3306305;Volta Redonda;1991;220305;220097;208
3500105;Adamantina;1991;32091;27662;4429
3500204;Adolfo;1991;3272;2437;835
3500303;Aguaí;1991;23363;19230;4133
3500402;Águas da Prata;1991;6692;5258;1434
3500501;Águas de Lindóia;1991;11966;11359;607
3500550;Águas de Santa Bárbara;1991;6049;3540;2509
3500600;Águas de São Pedro;1991;1697;1697;0
3500709;Agudos;1991;31706;28054;3652
3500808;Alfredo Marcondes;1991;3493;2290;1203
3500907;Altair;1991;3239;2168;1071
3501004;Altinópolis;1991;13642;9549;4093
3501103;Alto Alegre;1991;4787;2614;2173
3501202;Álvares Florence;1991;5050;2408;2642
3501301;Álvares Machado;1991;18865;15387;3478
3501400;Álvaro de Carvalho;1991;3133;1796;1337
3501509;Alvinlândia;1991;2541;1902;639
3501608;Americana;1991;153840;153653;187
3501707;Américo Brasiliense;1991;20067;18215;1852
3501806;Américo de Campos;1991;5590;3658;1932
3501905;Amparo;1991;50797;41419;9378
3502002;Analândia;1991;3020;1592;1428
3502101;Andradina;1991;52409;47550;4859
3502200;Angatuba;1991;21127;13343;7784
3502309;Anhembi;1991;3537;2121;1416
3502408;Anhumas;1991;3242;1882;1360
3502507;Aparecida;1991;33247;32570;677
3502606;Aparecida d'Oeste;1991;5100;3409;1691
3502705;Apiaí;1991;35185;16805;18380
3502804;Araçatuba;1991;159557;150905;8652
3502903;Araçoiaba da Serra;1991;14544;8868;5676
3503000;Aramina;1991;4064;2916;1148
3503109;Arandu;1991;5620;2947;2673
3503208;Araraquara;1991;166731;156465;10266
3503307;Araras;1991;87459;79111;8348
3503406;Arealva;1991;6892;4203;2689
3503505;Areias;1991;3284;1746;1538
3503604;Areiópolis;1991;9991;7869;2122
3503703;Ariranha;1991;5845;4949;896
3503802;Artur Nogueira;1991;28053;13584;14469
3503901;Arujá;1991;37622;34333;3289
3504008;Assis;1991;85391;80084;5307
3504107;Atibaia;1991;86336;74751;11585
3504206;Auriflama;1991;12765;10184;2581
3504305;Avaí;1991;4644;2457;2187
3504404;Avanhandava;1991;7973;6876;1097
3504503;Avaré;1991;61101;56264;4837
3504602;Bady Bassitt;1991;5717;3951;1766
3504701;Balbinos;1991;1221;769;452
3504800;Bálsamo;1991;6771;5483;1288
3504909;Bananal;1991;11368;7587;3781
3505005;Barão de Antonina;1991;3028;1576;1452
3505104;Barbosa;1991;5379;3905;1474
3505203;Bariri;1991;24542;21469;3073
3505302;Barra Bonita;1991;30841;29064;1777
3505401;Barra do Turvo;1991;7124;1987;5137
3505500;Barretos;1991;95414;89311;6103
3505609;Barrinha;1991;18853;18330;523
3505708;Barueri;1991;130799;130799;0
3505807;Bastos;1991;19116;15191;3925
3505906;Batatais;1991;44106;39902;4204
3506003;Bauru;1991;261112;255669;5443
3506102;Bebedouro;1991;67763;61996;5767
3506201;Bento de Abreu;1991;2397;1875;522
3506300;Bernardino de Campos;1991;10049;8139;1910
3506409;Bilac;1991;5460;4414;1046
3506508;Birigui;1991;75125;70567;4558
3506607;Biritiba Mirim;1991;17833;14759;3074
3506706;Boa Esperança do Sul;1991;11867;8845;3022
3506805;Bocaina;1991;7254;6060;1194
3506904;Bofete;1991;5666;3644;2022
3507001;Boituva;1991;23140;19346;3794
3507100;Bom Jesus dos Perdões;1991;9854;8996;858
3507209;Borá;1991;751;437;314
3507308;Boracéia;1991;3460;2519;941
3507407;Borborema;1991;12109;8709;3400
3507506;Botucatu;1991;90761;84853;5908
3507605;Bragança Paulista;1991;108980;92409;16571
3507704;Braúna;1991;4264;2829;1435
3507803;Brodowski;1991;13788;11796;1992
3507902;Brotas;1991;14402;10902;3500
3508009;Buri;1991;14325;8882;5443
3508108;Buritama;1991;12766;11346;1420
3508207;Buritizal;1991;3797;2390;1407
3508306;Cabrália Paulista;1991;3862;2849;1013
3508405;Cabreúva;1991;18814;13323;5491
3508504;Caçapava;1991;66058;58316;7742
3508603;Cachoeira Paulista;1991;23212;18724;4488
3508702;Caconde;1991;17283;9571;7712
3508801;Cafelândia;1991;15257;9420;5837
3508900;Caiabu;1991;3854;2396;1458
3509007;Caieiras;1991;39069;37776;1293
3509106;Caiuá;1991;3341;1460;1881
3509205;Cajamar;1991;33736;32005;1731
3509304;Cajobi;1991;11154;9114;2040
3509403;Cajuru;1991;20246;15686;4560
3509502;Campinas;1991;847595;824924;22671
3509601;Campo Limpo Paulista;1991;45387;44455;932
3509700;Campos do Jordão;1991;37135;36727;408
3509809;Campos Novos Paulista;1991;4015;2466;1549
3509908;Cananéia;1991;10144;8034;2110
3510005;Cândido Mota;1991;25450;21836;3614
3510104;Cândido Rodrigues;1991;2328;1608;720
3510203;Capão Bonito;1991;52612;35520;17092
3510302;Capela do Alto;1991;10771;8060;2711
3510401;Capivari;1991;34220;28845;5375
3510500;Caraguatatuba;1991;52878;52729;149
3510609;Carapicuíba;1991;283661;283661;0
3510708;Cardoso;1991;12282;9843;2439
3510807;Casa Branca;1991;25308;19090;6218
3510906;Cássia dos Coqueiros;1991;2719;1152;1567
3511003;Castilho;1991;14608;10837;3771
3511102;Catanduva;1991;93317;89905;3412
3511201;Catiguá;1991;6261;4887;1374
3511300;Cedral;1991;5704;3524;2180
3511409;Cerqueira César;1991;12852;10017;2835
3511508;Cerquilho;1991;20048;17871;2177
3511607;Cesário Lange;1991;11153;6475;4678
3511706;Charqueada;1991;10735;8674;2061
3511904;Clementina;1991;4883;4093;790
3512001;Colina;1991;15909;13170;2739
3512100;Colômbia;1991;5282;3725;1557
3512209;Conchal;1991;19272;15750;3522
3512308;Conchas;1991;11890;8376;3514
3512407;Cordeirópolis;1991;13338;10095;3243
3512506;Coroados;1991;6009;3876;2133
3512605;Coronel Macedo;1991;5750;3522;2228
3512704;Corumbataí;1991;3156;1269;1887
3512803;Cosmópolis;1991;36684;32803;3881
3512902;Cosmorama;1991;7830;3481;4349
3513009;Cotia;1991;107453;107453;0
3513108;Cravinhos;1991;22561;20596;1965
3513207;Cristais Paulista;1991;5649;2401;3248
3513306;Cruzália;1991;5251;3162;2089
3513405;Cruzeiro;1991;68643;65976;2667
3513504;Cubatão;1991;91136;90659;477
3513603;Cunha;1991;23462;8970;14492
3513702;Descalvado;1991;25750;20081;5669
3513801;Diadema;1991;305287;305287;0
3513900;Divinolândia;1991;11811;5533;6278
3514007;Dobrada;1991;6920;5722;1198
3514106;Dois Córregos;1991;18838;16347;2491
3514205;Dolcinópolis;1991;2094;1575;519
3514304;Dourado;1991;7743;6459;1284
3514403;Dracena;1991;39693;34863;4830
3514502;Duartina;1991;11897;8893;3004
3514601;Dumont;1991;4980;4336;644
3514700;Echaporã;1991;6318;4166;2152
3514809;Eldorado;1991;13120;5785;7335
3514908;Elias Fausto;1991;11632;6913;4719
3515004;Embu das Artes;1991;155990;155990;0
3515103;Embu-Guaçu;1991;36277;35414;863
3515186;Espírito Santo do Pinhal;1991;37178;28973;8205
3515202;Estrela d'Oeste;1991;8493;5274;3219
3515301;Estrela do Norte;1991;2777;1653;1124
3515400;Fartura;1991;14333;9237;5096
3515509;Fernandópolis;1991;56144;52022;4122
3515608;Fernando Prestes;1991;5175;3386;1789
3515707;Ferraz de Vasconcelos;1991;96166;94970;1196
3515806;Flora Rica;1991;2380;1476;904
3515905;Floreal;1991;3547;2349;1198
3516002;Flórida Paulista;1991;12510;8257;4253
3516101;Florínea;1991;3012;2408;604
3516200;Franca;1991;233098;227854;5244
3516309;Francisco Morato;1991;83885;83637;248
3516408;Franco da Rocha;1991;85535;79492;6043
3516507;Gabriel Monteiro;1991;2472;1273;1199
3516606;Gália;1991;10497;5403;5094
3516705;Garça;1991;41492;32500;8992
3516804;Gastão Vidigal;1991;3834;2786;1048
3516903;General Salgado;1991;12911;9072;3839
3517000;Getulina;1991;10121;7001;3120
3517109;Glicério;1991;4234;2527;1707
3517208;Guaiçara;1991;6366;4652;1714
3517307;Guaimbê;1991;5138;3563;1575
3517406;Guaíra;1991;31071;26932;4139
3517505;Guapiaçu;1991;10660;8086;2574
3517604;Guapiara;1991;18281;5707;12574
3517703;Guará;1991;16362;15175;1187
3517802;Guaraçaí;1991;8294;5275;3019
3517901;Guaraci;1991;7813;5964;1849
3518008;Guarani d'Oeste;1991;6779;4741;2038
3518107;Guarantã;1991;5538;3909;1629
3518206;Guararapes;1991;26689;22748;3941
3518305;Guararema;1991;17961;14186;3775
3518404;Guaratinguetá;1991;102072;94421;7651
3518503;Guareí;1991;8470;4172;4298
3518602;Guariba;1991;28911;27615;1296
3518701;Guarujá;1991;210207;210192;15
3518800;Guarulhos;1991;787866;777921;9945
3518909;Guzolândia;1991;5052;3380;1672
3519006;Herculândia;1991;7036;5216;1820
3519105;Iacanga;1991;7567;6038;1529
3519204;Iacri;1991;7038;4039;2999
3519303;Ibaté;1991;18827;16387;2440
3519402;Ibirá;1991;8713;6945;1768
3519501;Ibirarema;1991;5523;4481;1042
3519600;Ibitinga;1991;38242;34471;3771
3519709;Ibiúna;1991;49187;17698;31489
3519808;Icém;1991;6100;5350;750
3519907;Iepê;1991;10013;7587;2426
3520004;Igaraçu do Tietê;1991;20869;20460;409
3520103;Igarapava;1991;22324;18724;3600
3520202;Igaratá;1991;6292;4150;2142
3520301;Iguape;1991;27937;21279;6658
3520400;Ilhabela;1991;13538;13286;252
3520509;Indaiatuba;1991;100948;91849;9099
3520608;Indiana;1991;4622;3464;1158
3520707;Indiaporã;1991;4767;3643;1124
3520806;Inúbia Paulista;1991;3355;2468;887
3520905;Ipaussu;1991;11406;8922;2484
3521002;Iperó;1991;10575;7868;2707
3521101;Ipeúna;1991;2698;1779;919
3521200;Iporanga;1991;4614;1655;2959
3521309;Ipuã;1991;10356;8972;1384
3521408;Iracemápolis;1991;11752;10561;1191
3521507;Irapuã;1991;6092;4287;1805
3521606;Irapuru;1991;8257;5399;2858
3521705;Itaberá;1991;17899;9283;8616
3521804;Itaí;1991;17822;12287;5535
3521903;Itajobi;1991;15014;8914;6100
3522000;Itaju;1991;2359;1009;1350
3522109;Itanhaém;1991;46074;44820;1254
3522208;Itapecerica da Serra;1991;93146;91106;2040
3522307;Itapetininga;1991;105132;88146;16986
3522406;Itapeva;1991;81858;58241;23617
3522505;Itapevi;1991;107976;107976;0
3522604;Itapira;1991;56586;49802;6784
3522703;Itápolis;1991;33053;25558;7495
3522802;Itaporanga;1991;14412;8828;5584
3522901;Itapuí;1991;9051;7453;1598
3523008;Itapura;1991;3754;3228;526
3523107;Itaquaquecetuba;1991;164957;164957;0
3523206;Itararé;1991;44167;37065;7102
3523305;Itariri;1991;11608;6572;5036
3523404;Itatiba;1991;61645;54078;7567
3523503;Itatinga;1991;13769;10708;3061
3523602;Itirapina;1991;9953;7512;2441
3523701;Itirapuã;1991;5043;3545;1498
3523800;Itobi;1991;6783;5094;1689
3523909;Itu;1991;107314;96816;10498
3524006;Itupeva;1991;18142;11614;6528
3524105;Ituverava;1991;33003;29832;3171
3524204;Jaborandi;1991;6336;5433;903
3524303;Jaboticabal;1991;59133;53942;5191
3524402;Jacareí;1991;163869;157026;6843
3524501;Jaci;1991;3237;1805;1432
3524600;Jacupiranga;1991;38076;21108;16968
3524709;Jaguariúna;1991;24999;19087;5912
3524808;Jales;1991;45956;39313;6643
3524907;Jambeiro;1991;3285;1369;1916
3525003;Jandira;1991;62697;62697;0
3525102;Jardinópolis;1991;24123;21040;3083
3525201;Jarinu;1991;10878;5459;5419
3525300;Jaú;1991;94116;86823;7293
3525409;Jeriquara;1991;3249;2492;757
3525508;Joanópolis;1991;8186;7159;1027
3525607;João Ramalho;1991;3056;1989;1067
3525706;José Bonifácio;1991;26488;21003;5485
3525805;Júlio Mesquita;1991;3843;3189;654
3525904;Jundiaí;1991;289269;266235;23034
3526001;Junqueirópolis;1991;17708;12769;4939
3526100;Juquiá;1991;16954;10418;6536
3526209;Juquitiba;1991;19969;19969;0
3526308;Lagoinha;1991;4635;2160;2475
3526407;Laranjal Paulista;1991;19144;15901;3243
3526506;Lavínia;1991;5437;3938;1499
3526605;Lavrinhas;1991;4674;3668;1006
3526704;Leme;1991;68215;64546;3669
3526803;Lençóis Paulista;1991;46246;43155;3091
3526902;Limeira;1991;207770;177934;29836
3527009;Lindóia;1991;4118;3541;577
3527108;Lins;1991;58606;54404;4202
3527207;Lorena;1991;73146;69675;3471
3527306;Louveira;1991;16259;14131;2128
3527405;Lucélia;1991;19286;15731;3555
3527504;Lucianópolis;1991;2354;1158;1196
3527603;Luís Antônio;1991;5840;3809;2031
3527702;Luiziânia;1991;4157;3351;806
3527801;Lupércio;1991;4082;1634;2448
3527900;Lutécia;1991;2640;1511;1129
3528007;Macatuba;1991;13468;10109;3359
3528106;Macaubal;1991;7380;5188;2192
3528205;Macedônia;1991;3956;2282;1674
3528304;Magda;1991;3679;2513;1166
3528403;Mairinque;1991;43205;36026;7179
3528502;Mairiporã;1991;39937;33935;6002
3528601;Manduri;1991;7277;4784;2493
3528700;Marabá Paulista;1991;3494;1904;1590
3528809;Maracaí;1991;12467;9902;2565
3528908;Mariápolis;1991;4352;2498;1854
3529005;Marília;1991;161149;150520;10629
3529104;Marinópolis;1991;2088;1365;723
3529203;Martinópolis;1991;19673;15186;4487
3529302;Matão;1991;63613;60530;3083
3529401;Mauá;1991;294998;294998;0
3529500;Mendonça;1991;3501;1892;1609
3529609;Meridiano;1991;3784;1987;1797
3529708;Miguelópolis;1991;17407;14967;2440
3529807;Mineiros do Tietê;1991;9467;8727;740
3529906;Miracatu;1991;18970;8595;10375
3530003;Mira Estrela;1991;2667;1735;932
3530102;Mirandópolis;1991;24433;19476;4957
3530201;Mirante do Paranapanema;1991;15179;10545;4634
3530300;Mirassol;1991;39286;36617;2669
3530409;Mirassolândia;1991;3020;1297;1723
3530508;Mococa;1991;58374;48519;9855
3530607;Mogi das Cruzes;1991;273175;246845;26330
3530706;Mogi Guaçu;1991;107454;100010;7444
3530805;Mogi Mirim;1991;64753;58669;6084
3530904;Mombuca;1991;2597;1273;1324
3531001;Monções;1991;2108;1452;656
3531100;Mongaguá;1991;19026;18904;122
3531209;Monte Alegre do Sul;1991;5439;2750;2689
3531308;Monte Alto;1991;39742;35605;4137
3531407;Monte Aprazível;1991;17504;13941;3563
3531506;Monte Azul Paulista;1991;17698;14792;2906
3531605;Monte Castelo;1991;4718;2897;1821
3531704;Monteiro Lobato;1991;3380;1185;2195
3531803;Monte Mor;1991;25559;22044;3515
3531902;Morro Agudo;1991;21253;17176;4077
3532009;Morungaba;1991;8210;6249;1961
3532108;Murutinga do Sul;1991;3782;2213;1569
3532207;Narandiba;1991;3138;1926;1212
3532306;Natividade da Serra;1991;6458;2266;4192
3532405;Nazaré Paulista;1991;11671;4162;7509
3532504;Neves Paulista;1991;8313;6450;1863
3532603;Nhandeara;1991;10343;7215;3128
3532702;Nipoã;1991;2796;2096;700
3532801;Nova Aliança;1991;4194;2657;1537
3532900;Nova Europa;1991;5381;3650;1731
3533007;Nova Granada;1991;14895;12548;2347
3533106;Nova Guataporanga;1991;2133;1527;606
3533205;Nova Independência;1991;1994;1283;711
3533304;Nova Luzitânia;1991;2646;1903;743
3533403;Nova Odessa;1991;34063;31973;2090
3533502;Novo Horizonte;1991;30446;25604;4842
3533601;Nuporanga;1991;5789;4512;1277
3533700;Ocauçu;1991;4311;2071;2240
3533809;Óleo;1991;2801;1289;1512
3533908;Olímpia;1991;42907;37567;5340
3534005;Onda Verde;1991;2829;1787;1042
3534104;Oriente;1991;6803;3801;3002
3534203;Orindiúva;1991;3046;2402;644
3534302;Orlândia;1991;31319;27543;3776
3534401;Osasco;1991;568225;568225;0
3534500;Oscar Bressane;1991;2532;1623;909
3534609;Osvaldo Cruz;1991;28918;23663;5255
3534708;Ourinhos;1991;76923;70707;6216
3534807;Ouro Verde;1991;7093;5666;1427
3534906;Pacaembu;1991;12365;8317;4048
3535002;Palestina;1991;9011;6020;2991
3535101;Palmares Paulista;1991;7321;6554;767
3535200;Palmeira d'Oeste;1991;10950;6521;4429
3535309;Palmital;1991;18683;13892;4791
3535408;Panorama;1991;12343;10702;1641
3535507;Paraguaçu Paulista;1991;33840;30119;3721
3535606;Paraibuna;1991;14891;5818;9073
3535705;Paraíso;1991;4733;3255;1478
3535804;Paranapanema;1991;12796;7205;5591
3535903;Paranapuã;1991;5777;3966;1811
3536000;Parapuã;1991;11418;7477;3941
3536109;Pardinho;1991;3444;1746;1698
3536208;Pariquera-Açu;1991;13164;8437;4727
3536307;Patrocínio Paulista;1991;9715;6343;3372
3536406;Paulicéia;1991;4157;3074;1083
3536505;Paulínia;1991;36706;32907;3799
3536604;Paulo de Faria;1991;8319;6835;1484
3536703;Pederneiras;1991;32021;26932;5089
3536802;Pedra Bela;1991;5142;887;4255
3536901;Pedranópolis;1991;3105;1583;1522
3537008;Pedregulho;1991;13729;9073;4656
3537107;Pedreira;1991;27972;26804;1168
3537206;Pedro de Toledo;1991;7836;3888;3948
3537305;Penápolis;1991;48285;42637;5648
3537404;Pereira Barreto;1991;49932;45688;4244
3537503;Pereiras;1991;4447;2696;1751
3537602;Peruíbe;1991;32773;31311;1462
3537701;Piacatu;1991;4539;3319;1220
3537800;Piedade;1991;43581;18327;25254
3537909;Pilar do Sul;1991;19488;13613;5875
3538006;Pindamonhangaba;1991;102063;95611;6452
3538105;Pindorama;1991;12374;10641;1733
3538204;Pinhalzinho;1991;8433;3796;4637
3538303;Piquerobi;1991;3268;2304;964
3538501;Piquete;1991;14749;13787;962
3538600;Piracaia;1991;18999;18999;0
3538709;Piracicaba;1991;283833;269961;13872
3538808;Piraju;1991;26076;21222;4854
3538907;Pirajuí;1991;18829;15549;3280
3539004;Pirangi;1991;9867;7927;1940
3539103;Pirapora do Bom Jesus;1991;7956;7956;0
3539202;Pirapozinho;1991;20992;19028;1964
3539301;Pirassununga;1991;56746;47174;9572
3539400;Piratininga;1991;9656;6767;2889
3539509;Pitangueiras;1991;29490;26334;3156
3539608;Planalto;1991;5458;3526;1932
3539707;Platina;1991;2829;1773;1056
3539806;Poá;1991;76302;75572;730
3539905;Poloni;1991;4526;3635;891
3540002;Pompéia;1991;17236;14979;2257
3540101;Pongaí;1991;3581;2491;1090
3540200;Pontal;1991;22805;20853;1952
3540309;Pontes Gestal;1991;2965;1950;1015
3540408;Populina;1991;4673;3308;1365
3540507;Porangaba;1991;6841;3598;3243
3540606;Porto Feliz;1991;36936;28236;8700
3540705;Porto Ferreira;1991;38492;36504;1988
3540804;Potirendaba;1991;11201;8057;3144
3540903;Pradópolis;1991;9870;8812;1058
3541000;Praia Grande;1991;123492;123492;0
3541109;Presidente Alves;1991;4504;3058;1446
3541208;Presidente Bernardes;1991;16311;10885;5426
3541307;Presidente Epitácio;1991;34851;30727;4124
3541406;Presidente Prudente;1991;165484;160227;5257
3541505;Presidente Venceslau;1991;36120;34388;1732
3541604;Promissão;1991;27981;22093;5888
3541703;Quatá;1991;11358;8671;2687
3541802;Queiroz;1991;1936;1300;636
3541901;Queluz;1991;7710;6425;1285
3542008;Quintana;1991;5188;4344;844
3542107;Rafard;1991;8588;6552;2036
3542206;Rancharia;1991;26913;23076;3837
3542305;Redenção da Serra;1991;4008;1677;2331
3542404;Regente Feijó;1991;14963;12293;2670
3542503;Reginópolis;1991;4774;3217;1557
3542602;Registro;1991;48953;37849;11104
3542701;Restinga;1991;4407;2726;1681
3542800;Ribeira;1991;7336;2256;5080
3542909;Ribeirão Bonito;1991;10329;8189;2140
3543006;Ribeirão Branco;1991;19278;6504;12774
3543105;Ribeirão Corrente;1991;3229;2155;1074
3543204;Ribeirão do Sul;1991;3606;2331;1275
3543303;Ribeirão Pires;1991;85085;85085;0
3543402;Ribeirão Preto;1991;436682;426819;9863
3543501;Riversul;1991;9399;5058;4341
3543600;Rifaina;1991;2897;2383;514
3543709;Rincão;1991;10356;7721;2635
3543808;Rinópolis;1991;11169;7768;3401
3543907;Rio Claro;1991;138243;132739;5504
3544004;Rio das Pedras;1991;19104;16683;2421
3544103;Rio Grande da Serra;1991;29901;29901;0
3544202;Riolândia;1991;7760;6843;917
3544301;Roseira;1991;6217;4997;1220
3544400;Rubiácea;1991;2639;1218;1421
3544509;Rubinéia;1991;2236;1306;930
3544608;Sabino;1991;4571;3059;1512
3544707;Sagres;1991;2653;1214;1439
3544806;Sales;1991;3758;2424;1334
3544905;Sales Oliveira;1991;7632;6036;1596
3545001;Salesópolis;1991;11359;6735;4624
3545100;Salmourão;1991;4462;3212;1250
3545209;Salto;1991;72333;72333;0
3545308;Salto de Pirapora;1991;25344;19127;6217
3545407;Salto Grande;1991;7678;5915;1763
3545506;Sandovalina;1991;2403;1645;758
3545605;Santa Adélia;1991;12615;10685;1930
3545704;Santa Albertina;1991;5870;4076;1794
3545803;Santa Bárbara d'Oeste;1991;145266;141181;4085
3546009;Santa Branca;1991;10306;9125;1181
3546108;Santa Clara d'Oeste;1991;2497;1438;1059
3546207;Santa Cruz da Conceição;1991;2937;1441;1496
3546306;Santa Cruz das Palmeiras;1991;21819;19356;2463
3546405;Santa Cruz do Rio Pardo;1991;39544;31559;7985
3546504;Santa Ernestina;1991;5613;4064;1549
3546603;Santa Fé do Sul;1991;23110;20707;2403
3546702;Santa Gertrudes;1991;10485;9694;791
3546801;Santa Isabel;1991;37975;28235;9740
3546900;Santa Lúcia;1991;6284;4806;1478
3547007;Santa Maria da Serra;1991;4303;3466;837
3547106;Santa Mercedes;1991;2982;2044;938
3547205;Santana da Ponte Pensa;1991;2365;1067;1298
3547304;Santana de Parnaíba;1991;37762;37762;0
3547403;Santa Rita d'Oeste;1991;3487;1681;1806
3547502;Santa Rita do Passa Quatro;1991;24124;18501;5623
3547601;Santa Rosa de Viterbo;1991;19195;17534;1661
3547700;Santo Anastácio;1991;22079;19051;3028
3547809;Santo André;1991;616991;616991;0
3547908;Santo Antônio da Alegria;1991;5155;2998;2157
3548005;Santo Antônio de Posse;1991;14327;11231;3096
3548104;Santo Antônio do Jardim;1991;5687;2278;3409
3548203;Santo Antônio do Pinhal;1991;5355;2415;2940
3548302;Santo Expedito;1991;2222;1629;593
3548401;Santópolis do Aguapeí;1991;3845;3477;368
3548500;Santos;1991;428923;427273;1650
3548609;São Bento do Sapucaí;1991;8695;4164;4531
3548708;São Bernardo do Campo;1991;566893;555495;11398
3548807;São Caetano do Sul;1991;149519;149519;0
3548906;São Carlos;1991;158221;148408;9813
3549003;São Francisco;1991;4445;2399;2046
3549102;São João da Boa Vista;1991;69148;60897;8251
3549201;São João das Duas Pontes;1991;2791;1479;1312
3549300;São João do Pau d'Alho;1991;2814;1673;1141
3549409;São Joaquim da Barra;1991;35964;33622;2342
3549508;São José da Bela Vista;1991;7119;5221;1898
3549607;São José do Barreiro;1991;3933;2099;1834
3549706;São José do Rio Pardo;1991;44579;31488;13091
3549805;São José do Rio Preto;1991;283761;275450;8311
3549904;São José dos Campos;1991;442370;425515;16855
3550001;São Luiz do Paraitinga;1991;9922;5065;4857
3550100;São Manuel;1991;35438;30222;5216
3550209;São Miguel Arcanjo;1991;25382;13615;11767
3550308;São Paulo;1991;9646185;9412894;233291
3550407;São Pedro;1991;20176;15660;4516
3550506;São Pedro do Turvo;1991;7038;3632;3406
3550605;São Roque;1991;63900;48359;15541
3550704;São Sebastião;1991;33890;33702;188
3550803;São Sebastião da Grama;1991;11810;5731;6079
3550902;São Simão;1991;11987;10281;1706
3551009;São Vicente;1991;268618;268353;265
3551108;Sarapuí;1991;6477;3197;3280
3551207;Sarutaiá;1991;3023;1893;1130
3551306;Sebastianópolis do Sul;1991;2516;1215;1301
3551405;Serra Azul;1991;6172;5470;702
3551504;Serrana;1991;23219;22233;986
3551603;Serra Negra;1991;21704;17431;4273
3551702;Sertãozinho;1991;78776;73567;5209
3551801;Sete Barras;1991;12527;4367;8160
3551900;Severínia;1991;10280;8117;2163
3552007;Silveiras;1991;4914;1676;3238
3552106;Socorro;1991;30763;16999;13764
3552205;Sorocaba;1991;379006;374108;4898
3552304;Sud Mennucci;1991;7205;5581;1624
3552403;Sumaré;1991;226870;225528;1342
3552502;Suzano;1991;158839;152003;6836
3552601;Tabapuã;1991;13051;9610;3441
3552700;Tabatinga;1991;10793;6994;3799
3552809;Taboão da Serra;1991;160084;160084;0
3552908;Taciba;1991;4750;3311;1439
3553005;Taguaí;1991;6428;4716;1712
3553104;Taiaçu;1991;5015;4089;926
3553203;Taiúva;1991;5218;4206;1012
3553302;Tambaú;1991;19857;16072;3785
3553401;Tanabi;1991;21513;15219;6294
3553500;Tapiraí;1991;5734;2781;2953
3553609;Tapiratiba;1991;11799;6137;5662
3553708;Taquaritinga;1991;46922;40544;6378
3553807;Taquarituba;1991;18537;13610;4927
3553906;Tarabai;1991;4714;3931;783
3554003;Tatuí;1991;76816;69368;7448
3554102;Taubaté;1991;206965;197801;9164
3554201;Tejupá;1991;4732;751;3981
3554300;Teodoro Sampaio;1991;49236;26921;22315
3554409;Terra Roxa;1991;6635;5740;895
3554508;Tietê;1991;26446;22147;4299
3554607;Timburi;1991;2850;1543;1307
3554706;Torrinha;1991;7503;5627;1876
3554805;Tremembé;1991;27572;24317;3255
3554904;Três Fronteiras;1991;7859;4146;3713
3555000;Tupã;1991;61302;55578;5724
3555109;Tupi Paulista;1991;14045;10621;3424
3555208;Turiúba;1991;3752;2428;1324
3555307;Turmalina;1991;2750;1413;1337
3555406;Ubatuba;1991;47398;46333;1065
3555505;Ubirajara;1991;4191;2622;1569
3555604;Uchoa;1991;8335;6269;2066
3555703;União Paulista;1991;1320;842;478
3555802;Urânia;1991;12090;7600;4490
3555901;Uru;1991;1349;696;653
3556008;Urupês;1991;11011;7786;3225
3556107;Valentim Gentil;1991;5905;4518;1387
3556206;Valinhos;1991;67886;59912;7974
3556305;Valparaíso;1991;16550;14070;2480
3556404;Vargem Grande do Sul;1991;30952;27817;3135
3556453;Vargem Grande Paulista;1991;15870;15870;0
3556503;Várzea Paulista;1991;68921;68036;885
3556602;Vera Cruz;1991;11042;8014;3028
3556701;Vinhedo;1991;33612;32999;613
3556800;Viradouro;1991;13091;11775;1316
3556909;Vista Alegre do Alto;1991;3614;2923;691
3557006;Votorantim;1991;80728;79197;1531
3557105;Votuporanga;1991;66166;61380;4786
3557204;Chavantes;1991;14160;9744;4416
4100103;Abatiá;1991;10238;5109;5129
4100202;Adrianópolis;1991;8935;1589;7346
4100301;Agudos do Sul;1991;6076;779;5297
4100400;Almirante Tamandaré;1991;66159;59080;7079
4100459;Altamira do Paraná;1991;7437;1821;5616
4100509;Altônia;1991;24589;11925;12664
4100608;Alto Paraná;1991;12047;8359;3688
4100707;Alto Piquiri;1991;17229;11582;5647
4100806;Alvorada do Sul;1991;9685;5922;3763
4100905;Amaporã;1991;3948;3087;861
4101002;Ampére;1991;13213;6037;7176
4101101;Andirá;1991;19584;17114;2470
4101200;Antonina;1991;17070;14018;3052
4101309;Antônio Olinto;1991;7733;618;7115
4101408;Apucarana;1991;95064;86079;8985
4101507;Arapongas;1991;64556;60025;4531
4101606;Arapoti;1991;20603;11413;9190
4101705;Araruna;1991;12387;5858;6529
4101804;Araucária;1991;61889;54262;7627
4101903;Assaí;1991;20325;12964;7361
4102000;Assis Chateaubriand;1991;39737;28835;10902
4102109;Astorga;1991;22458;18534;3924
4102208;Atalaia;1991;4129;2841;1288
4102307;Balsa Nova;1991;7515;2430;5085
4102406;Bandeirantes;1991;34310;24422;9888
4102505;Barbosa Ferraz;1991;18389;10872;7517
4102604;Barracão;1991;14692;4491;10201
4102703;Barra do Jacaré;1991;3151;1390;1761
4102802;Bela Vista do Paraíso;1991;15098;13070;2028
4102901;Bituruna;1991;12852;5575;7277
4103008;Boa Esperança;1991;6954;2639;4315
4103057;Boa Vista da Aparecida;1991;10370;3228;7142
4103107;Bocaiúva do Sul;1991;10657;3242;7415
4103206;Bom Sucesso;1991;7116;4588;2528
4103305;Borrazópolis;1991;11481;5480;6001
4103354;Braganey;1991;8069;3017;5052
4103404;Cafeara;1991;2398;1603;795
4103453;Cafelândia;1991;8093;5185;2908
4103503;Califórnia;1991;7329;4525;2804
4103602;Cambará;1991;21343;16491;4852
4103701;Cambé;1991;73842;66817;7025
4103800;Cambira;1991;9793;3868;5925
4103909;Campina da Lagoa;1991;20506;12677;7829
4104006;Campina Grande do Sul;1991;19343;12722;6621
4104055;Campo Bonito;1991;5059;1479;3580
4104105;Campo do Tenente;1991;5241;2043;3198
4104204;Campo Largo;1991;72523;53892;18631
4104303;Campo Mourão;1991;82318;72335;9983
4104402;Cândido de Abreu;1991;21607;3958;17649
4104451;Cantagalo;1991;25497;5690;19807
4104501;Capanema;1991;19368;7936;11432
4104600;Capitão Leônidas Marques;1991;17843;7783;10060
4104709;Carlópolis;1991;12357;6519;5838
4104808;Cascavel;1991;192990;177766;15224
4104907;Castro;1991;64058;39125;24933
4105003;Catanduvas;1991;9821;3712;6109
4105102;Centenário do Sul;1991;14269;9990;4279
4105201;Cerro Azul;1991;21073;3599;17474
4105300;Céu Azul;1991;10586;5831;4755
4105409;Chopinzinho;1991;24587;8282;16305
4105508;Cianorte;1991;49846;37850;11996
4105607;Cidade Gaúcha;1991;8472;6522;1950
4105706;Clevelândia;1991;18057;13347;4710
4105805;Colombo;1991;117767;110273;7494
4105904;Colorado;1991;18972;15616;3356
4106001;Congonhinhas;1991;7773;4044;3729
4106100;Conselheiro Mairinck;1991;3493;2226;1267
4106209;Contenda;1991;8941;4823;4118
4106308;Corbélia;1991;22813;13926;8887
4106407;Cornélio Procópio;1991;46644;40036;6608
4106506;Coronel Vivida;1991;25140;12339;12801
4106555;Corumbataí do Sul;1991;6642;1762;4880
4106605;Cruzeiro do Oeste;1991;23660;16754;6906
4106704;Cruzeiro do Sul;1991;5006;2715;2291
4106803;Cruz Machado;1991;16568;2473;14095
4106902;Curitiba;1991;1315035;1315035;0
4107009;Curiúva;1991;10503;3989;6514
4107108;Diamante do Norte;1991;7604;4537;3067
4107157;Diamante D'Oeste;1991;9253;2876;6377
4107207;Dois Vizinhos;1991;40267;22202;18065
4107256;Douradina;1991;6578;3248;3330
4107306;Doutor Camargo;1991;5942;4379;1563
4107405;Enéas Marques;1991;12396;2115;10281
4107504;Engenheiro Beltrão;1991;14671;8378;6293
4107603;Faxinal;1991;19926;11108;8818
4107702;Fênix;1991;5983;4016;1967
4107751;Figueira;1991;9585;7180;2405
4107801;Floraí;1991;5500;4240;1260
4107900;Floresta;1991;4527;3469;1058
4108007;Florestópolis;1991;11998;8545;3453
4108106;Flórida;1991;2096;1652;444
4108205;Formosa do Oeste;1991;15196;7227;7969
4108304;Foz do Iguaçu;1991;190123;186385;3738
4108320;Francisco Alves;1991;9205;4313;4892
4108403;Francisco Beltrão;1991;61272;45622;15650
4108502;General Carneiro;1991;11287;6078;5209
4108551;Godoy Moreira;1991;5294;1262;4032
4108601;Goioerê;1991;45131;29840;15291
4108700;Grandes Rios;1991;12156;4332;7824
4108809;Guaíra;1991;30000;22790;7210
4108908;Guairaçá;1991;5556;3129;2427
4109005;Guapirama;1991;3806;2410;1396
4109104;Guaporema;1991;2290;1116;1174
4109203;Guaraci;1991;5549;4059;1490
4109302;Guaraniaçu;1991;26012;8623;17389
4109401;Guarapuava;1991;159634;116210;43424
4109500;Guaraqueçaba;1991;7762;1742;6020
4109609;Guaratuba;1991;17998;14019;3979
4109708;Ibaiti;1991;26026;15245;10781
4109757;Ibema;1991;6106;3795;2311
4109807;Ibiporã;1991;35168;30728;4440
4109906;Icaraíma;1991;11970;6711;5259
4110003;Iguaraçu;1991;5691;4029;1662
4110102;Imbituva;1991;25621;7874;17747
4110201;Inácio Martins;1991;13776;2513;11263
4110300;Inajá;1991;2642;2026;616
4110409;Indianópolis;1991;6742;2862;3880
4110508;Ipiranga;1991;12590;3214;9376
4110607;Iporã;1991;26032;15412;10620
4110706;Irati;1991;47854;31278;16576
4110805;Iretama;1991;15814;6522;9292
4110904;Itaguajé;1991;5054;3473;1581
4111001;Itambaracá;1991;9717;6070;3647
4111100;Itambé;1991;6169;4711;1458
4111209;Itapejara d'Oeste;1991;9045;3909;5136
4111308;Itaúna do Sul;1991;4555;3050;1505
4111407;Ivaí;1991;11454;2958;8496
4111506;Ivaiporã;1991;45564;27928;17636
4111605;Ivatuba;1991;2508;1779;729
4111704;Jaboti;1991;4376;1863;2513
4111803;Jacarezinho;1991;40858;30111;10747
4111902;Jaguapitã;1991;10613;7474;3139
4112009;Jaguariaíva;1991;25149;19241;5908
4112108;Jandaia do Sul;1991;18574;15340;3234
4112207;Janiópolis;1991;10614;4237;6377
4112306;Japira;1991;4834;1842;2992
4112405;Japurá;1991;8115;4253;3862
4112504;Jardim Alegre;1991;20446;8580;11866
4112603;Jardim Olinda;1991;1405;1041;364
4112702;Jataizinho;1991;10428;8390;2038
4112751;Jesuítas;1991;12841;5537;7304
4112801;Joaquim Távora;1991;9875;6287;3588
4112900;Jundiaí do Sul;1991;4223;2238;1985
4112959;Juranda;1991;8796;3582;5214
4113007;Jussara;1991;6046;4753;1293
4113106;Kaloré;1991;6568;2815;3753
4113205;Lapa;1991;40150;19472;20678
4113304;Laranjeiras do Sul;1991;54102;21994;32108
4113403;Leópolis;1991;4761;2248;2513
4113452;Lindoeste;1991;6877;938;5939
4113502;Loanda;1991;17757;14305;3452
4113601;Lobato;1991;3762;2827;935
4113700;Londrina;1991;390100;366676;23424
4113734;Luiziana;1991;9103;3187;5916
4113759;Lunardelli;1991;7530;2872;4658
4113809;Lupionópolis;1991;4459;3677;782
4113908;Mallet;1991;11808;5528;6280
4114005;Mamborê;1991;16032;8314;7718
4114104;Mandaguaçu;1991;14697;11122;3575
4114203;Mandaguari;1991;28086;21250;6836
4114302;Mandirituba;1991;38336;26237;12099
4114401;Mangueirinha;1991;25604;4982;20622
4114500;Manoel Ribas;1991;11956;4552;7404
4114609;Marechal Cândido Rondon;1991;49430;26455;22975
4114708;Maria Helena;1991;8439;2873;5566
4114807;Marialva;1991;22625;16177;6448
4114906;Marilândia do Sul;1991;13764;7790;5974
4115002;Marilena;1991;6725;3496;3229
4115101;Mariluz;1991;11053;8326;2727
4115200;Maringá;1991;240292;234079;6213
4115309;Mariópolis;1991;6280;2855;3425
4115408;Marmeleiro;1991;17113;5763;11350
4115507;Marumbi;1991;5007;3051;1956
4115606;Matelândia;1991;17329;10385;6944
4115705;Matinhos;1991;11325;10866;459
4115804;Medianeira;1991;38665;29572;9093
4115903;Mirador;1991;2337;1420;917
4116000;Miraselva;1991;5326;3085;2241
4116059;Missal;1991;10372;3679;6693
4116109;Moreira Sales;1991;17004;10236;6768
4116208;Morretes;1991;13135;6194;6941
4116307;Munhoz de Melo;1991;3628;1994;1634
4116406;Nossa Senhora das Graças;1991;3480;2222;1258
4116505;Nova Aliança do Ivaí;1991;1206;766;440
4116604;Nova América da Colina;1991;4105;1828;2277
4116703;Nova Aurora;1991;15494;8367;7127
4116802;Nova Cantu;1991;11260;4068;7192
4116901;Nova Esperança;1991;24189;17941;6248
4117008;Nova Fátima;1991;8385;5979;2406
4117107;Nova Londrina;1991;12854;11077;1777
4117206;Nova Olímpia;1991;5397;4065;1332
4117222;Nova Santa Rosa;1991;7042;3155;3887
4117255;Nova Prata do Iguaçu;1991;11615;4171;7444
4117271;Nova Tebas;1991;17587;2148;15439
4117305;Ortigueira;1991;27504;5412;22092
4117404;Ourizona;1991;3750;2583;1167
4117453;Ouro Verde do Oeste;1991;6330;3368;2962
4117503;Paiçandu;1991;22197;20997;1200
4117602;Palmas;1991;35262;24890;10372
4117701;Palmeira;1991;29046;14878;14168
4117800;Palmital;1991;24317;5369;18948
4117909;Palotina;1991;30705;19700;11005
4118006;Paraíso do Norte;1991;8875;7197;1678
4118105;Paranacity;1991;8528;5087;3441
4118204;Paranaguá;1991;107675;94689;12986
4118303;Paranapoema;1991;2455;1983;472
4118402;Paranavaí;1991;71052;64354;6698
4118501;Pato Branco;1991;55675;43406;12269
4118600;Paula Freitas;1991;4665;1473;3192
4118709;Paulo Frontin;1991;6558;1573;4985
4118808;Peabiru;1991;14161;9147;5014
4118907;Pérola;1991;15046;7473;7573
4119004;Pérola d'Oeste;1991;12255;3234;9021
4119103;Piên;1991;7745;1432;6313
4119202;Pinhalão;1991;5728;2706;3022
4119301;Pinhão;1991;35010;10666;24344
4119400;Piraí do Sul;1991;19414;12314;7100
4119509;Piraquara;1991;106882;91438;15444
4119608;Pitanga;1991;64514;17106;47408
4119707;Planaltina do Paraná;1991;3796;2320;1476
4119806;Planalto;1991;15092;4075;11017
4119905;Ponta Grossa;1991;233984;221671;12313
4120002;Porecatu;1991;17102;11961;5141
4120101;Porto Amazonas;1991;3579;2393;1186
4120200;Porto Rico;1991;3211;1495;1716
4120309;Porto Vitória;1991;3772;1854;1918
4120358;Pranchita;1991;8604;2609;5995
4120408;Presidente Castelo Branco;1991;3633;2187;1446
4120507;Primeiro de Maio;1991;11910;9773;2137
4120606;Prudentópolis;1991;47014;11392;35622
4120705;Quatiguá;1991;5766;4499;1267
4120804;Quatro Barras;1991;10007;8132;1875
4120903;Quedas do Iguaçu;1991;31509;16155;15354
4121000;Querência do Norte;1991;10384;6820;3564
4121109;Quinta do Sol;1991;5599;3372;2227
4121208;Quitandinha;1991;14418;2476;11942
4121307;Rancho Alegre;1991;4509;3264;1245
4121406;Realeza;1991;17146;9300;7846
4121505;Rebouças;1991;12948;5396;7552
4121604;Renascença;1991;7546;2161;5385
4121703;Reserva;1991;25084;7192;17892
4121802;Ribeirão Claro;1991;11385;6098;5287
4121901;Ribeirão do Pinhal;1991;13841;8757;5084
4122008;Rio Azul;1991;12406;3206;9200
4122107;Rio Bom;1991;4197;1726;2471
4122206;Rio Branco do Sul;1991;38296;23714;14582
4122305;Rio Negro;1991;26315;20200;6115
4122404;Rolândia;1991;43776;35276;8500
4122503;Roncador;1991;17573;5994;11579
4122602;Rondon;1991;8647;4266;4381
4122651;Rosário do Ivaí;1991;9908;2392;7516
4122701;Sabáudia;1991;5293;2980;2313
4122800;Salgado Filho;1991;13829;2062;11767
4122909;Salto do Itararé;1991;6360;3142;3218
4123006;Salto do Lontra;1991;14297;4624;9673
4123105;Santa Amélia;1991;4628;2309;2319
4123204;Santa Cecília do Pavão;1991;8642;4748;3894
4123303;Santa Cruz de Monte Castelo;1991;10209;6251;3958
4123402;Santa Fé;1991;8708;6452;2256
4123501;Santa Helena;1991;18861;6501;12360
4123600;Santa Inês;1991;2044;1012;1032
4123709;Santa Isabel do Ivaí;1991;12858;7026;5832
4123808;Santa Izabel do Oeste;1991;12510;4647;7863
4123907;Santa Mariana;1991;14711;8455;6256
4124004;Santana do Itararé;1991;6030;3069;2961
4124020;Santa Tereza do Oeste;1991;6118;3307;2811
4124053;Santa Terezinha de Itaipu;1991;14149;11655;2494
4124103;Santo Antônio da Platina;1991;38714;27345;11369
4124202;Santo Antônio do Caiuá;1991;3111;1927;1184
4124301;Santo Antônio do Paraíso;1991;2488;1206;1282
4124400;Santo Antônio do Sudoeste;1991;20290;8992;11298
4124509;Santo Inácio;1991;5514;4035;1479
4124608;São Carlos do Ivaí;1991;4972;3430;1542
4124707;São Jerônimo da Serra;1991;13275;4892;8383
4124806;São João;1991;13661;4775;8886
4124905;São João do Caiuá;1991;6008;4874;1134
4125001;São João do Ivaí;1991;16663;9819;6844
4125100;São João do Triunfo;1991;12320;2830;9490
4125209;São Jorge d'Oeste;1991;10321;3847;6474
4125308;São Jorge do Ivaí;1991;6087;4297;1790
4125357;São Jorge do Patrocínio;1991;9137;2649;6488
4125407;São José da Boa Vista;1991;8507;3308;5199
4125456;São José das Palmeiras;1991;5596;2355;3241
4125506;São José dos Pinhais;1991;127455;111952;15503
4125605;São Mateus do Sul;1991;33138;15927;17211
4125704;São Miguel do Iguaçu;1991;24721;10773;13948
4125803;São Pedro do Ivaí;1991;9333;6857;2476
4125902;São Pedro do Paraná;1991;3247;1374;1873
4126009;São Sebastião da Amoreira;1991;7943;4516;3427
4126108;São Tomé;1991;5115;2576;2539
4126207;Sapopema;1991;7095;2861;4234
4126256;Sarandi;1991;47981;46208;1773
4126306;Sengés;1991;14995;8244;6751
4126405;Sertaneja;1991;6708;4880;1828
4126504;Sertanópolis;1991;14291;9998;4293
4126603;Siqueira Campos;1991;14226;9027;5199
4126652;Sulina;1991;5222;951;4271
4126702;Tamboara;1991;4579;2850;1729
4126801;Tapejara;1991;12057;8123;3934
4126900;Tapira;1991;8528;3266;5262
4127007;Teixeira Soares;1991;14021;4556;9465
4127106;Telêmaco Borba;1991;64963;54649;10314
4127205;Terra Boa;1991;14249;9048;5201
4127304;Terra Rica;1991;13909;10212;3697
4127403;Terra Roxa;1991;19820;11797;8023
4127502;Tibagi;1991;22759;10466;12293
4127601;Tijucas do Sul;1991;10224;1271;8953
4127700;Toledo;1991;94879;72402;22477
4127809;Tomazina;1991;11912;3821;8091
4127858;Três Barras do Paraná;1991;14982;4104;10878
4127908;Tuneiras do Oeste;1991;11460;4745;6715
4127957;Tupãssi;1991;8829;5361;3468
4127965;Turvo;1991;14146;2844;11302
4128005;Ubiratã;1991;26828;18311;8517
4128104;Umuarama;1991;100249;77541;22708
4128203;União da Vitória;1991;44008;40201;3807
4128302;Uniflor;1991;2662;1540;1122
4128401;Uraí;1991;13299;9195;4104
4128500;Wenceslau Braz;1991;18872;12926;5946
4128559;Vera Cruz do Oeste;1991;11370;6579;4791
4128609;Verê;1991;10212;2657;7555
4128708;Vitorino;1991;6478;2604;3874
4128807;Xambrê;1991;8771;2428;6343
4200051;Abdon Batista;1991;3245;416;2829
4200101;Abelardo Luz;1991;19236;6697;12539
4200200;Agrolândia;1991;7181;3650;3531
4200309;Agronômica;1991;3772;701;3071
4200408;Água Doce;1991;7133;2678;4455
4200507;Águas de Chapecó;1991;6443;1884;4559
4200606;Águas Mornas;1991;4611;1042;3569
4200705;Alfredo Wagner;1991;9795;2172;7623
4200804;Anchieta;1991;9599;2385;7214
4200903;Angelina;1991;6268;733;5535
4201000;Anita Garibaldi;1991;11021;3477;7544
4201109;Anitápolis;1991;3564;1030;2534
4201208;Antônio Carlos;1991;5613;977;4636
4201257;Apiúna;1991;7731;2739;4992
4201307;Araquari;1991;15998;13627;2371
4201406;Araranguá;1991;48415;39490;8925
4201505;Armazém;1991;6096;1940;4156
4201604;Arroio Trinta;1991;3335;1532;1803
4201703;Ascurra;1991;6162;4638;1524
4201802;Atalanta;1991;3702;980;2722
4201901;Aurora;1991;6066;661;5405
4202008;Balneário Camboriú;1991;40308;39888;420
4202107;Barra Velha;1991;13231;10692;2539
4202206;Benedito Novo;1991;8385;3673;4712
4202305;Biguaçu;1991;34063;28207;5856
4202404;Blumenau;1991;212025;186327;25698
4202503;Bom Jardim da Serra;1991;4153;2067;2086
4202602;Bom Retiro;1991;7253;4047;3206
4202701;Botuverá;1991;4287;521;3766
4202800;Braço do Norte;1991;16540;11227;5313
4202909;Brusque;1991;57971;53488;4483
4203006;Caçador;1991;52684;43492;9192
4203105;Caibi;1991;7428;2355;5073
4203204;Camboriú;1991;25806;23538;2268
4203303;Campo Alegre;1991;10074;5760;4314
4203402;Campo Belo do Sul;1991;12811;3987;8824
4203501;Campo Erê;1991;26272;6390;19882
4203600;Campos Novos;1991;42811;23828;18983
4203709;Canelinha;1991;8165;3726;4439
4203808;Canoinhas;1991;55376;36832;18544
4203907;Capinzal;1991;13694;9358;4336
4204004;Catanduvas;1991;12180;5043;7137
4204103;Caxambu do Sul;1991;8532;2392;6140
4204152;Celso Ramos;1991;3457;750;2707
4204202;Chapecó;1991;123050;96751;26299
4204301;Concórdia;1991;64338;36271;28067
4204400;Coronel Freitas;1991;11886;3853;8033
4204509;Corupá;1991;10389;7264;3125
4204558;Correia Pinto;1991;17092;12593;4499
4204608;Criciúma;1991;146320;132313;14007
4204707;Cunha Porã;1991;10776;4565;6211
4204806;Curitibanos;1991;42234;32689;9545
4204905;Descanso;1991;17028;4430;12598
4205001;Dionísio Cerqueira;1991;13720;5233;8487
4205100;Dona Emma;1991;3616;983;2633
4205159;Doutor Pedrinho;1991;2997;1360;1637
4205209;Erval Velho;1991;4626;2080;2546
4205308;Faxinal dos Guedes;1991;9266;5068;4198
4205407;Florianópolis;1991;255390;239996;15394
4205456;Forquilhinha;1991;14059;4416;9643
4205506;Fraiburgo;1991;26649;19685;6964
4205605;Galvão;1991;7069;2627;4442
4205704;Garopaba;1991;9918;5178;4740
4205803;Garuva;1991;8771;5956;2815
4205902;Gaspar;1991;35614;23364;12250
4206009;Governador Celso Ramos;1991;9629;7472;2157
4206108;Grão Pará;1991;5387;2008;3379
4206207;Gravatal;1991;8272;2256;6016
4206306;Guabiruba;1991;9905;5841;4064
4206405;Guaraciaba;1991;12434;3530;8904
4206504;Guaramirim;1991;17640;13874;3766
4206603;Guarujá do Sul;1991;4776;1835;2941
4206702;Herval d'Oeste;1991;17832;14230;3602
4206801;Ibicaré;1991;3936;995;2941
4206900;Ibirama;1991;13773;9657;4116
4207007;Içara;1991;38095;27367;10728
4207106;Ilhota;1991;9448;5504;3944
4207205;Imaruí;1991;15431;4221;11210
4207304;Imbituba;1991;30942;25790;5152
4207403;Imbuia;1991;4614;1521;3093
4207502;Indaial;1991;30158;28234;1924
4207601;Ipira;1991;4765;1211;3554
4207650;Iporã do Oeste;1991;7718;2222;5496
4207700;Ipumirim;1991;7253;1800;5453
4207759;Iraceminha;1991;5727;1142;4585
4207809;Irani;1991;7600;3291;4309
4207908;Irineópolis;1991;9762;2646;7116
4208005;Itá;1991;8426;1922;6504
4208104;Itaiópolis;1991;26240;7498;18742
4208203;Itajaí;1991;119631;114555;5076
4208302;Itapema;1991;12176;11248;928
4208401;Itapiranga;1991;21355;5360;15995
4208450;Itapoá;1991;4007;3309;698
4208500;Ituporanga;1991;21152;9804;11348
4208609;Jaborá;1991;4407;1156;3251
4208708;Jacinto Machado;1991;11514;3602;7912
4208807;Jaguaruna;1991;18427;10114;8313
4208906;Jaraguá do Sul;1991;76968;62565;14403
4209003;Joaçaba;1991;28139;23211;4928
4209102;Joinville;1991;347151;334674;12477
4209151;José Boiteux;1991;4044;866;3178
4209201;Lacerdópolis;1991;2080;836;1244
4209300;Lages;1991;151235;138575;12660
4209409;Laguna;1991;44862;34174;10688
4209508;Laurentino;1991;4326;2288;2038
4209607;Lauro Müller;1991;13936;9818;4118
4209706;Lebon Régis;1991;10804;4415;6389
4209805;Leoberto Leal;1991;4268;481;3787
4209854;Lindóia do Sul;1991;5278;1172;4106
4209904;Lontras;1991;7578;4417;3161
4210001;Luiz Alves;1991;6440;1575;4865
4210100;Mafra;1991;47042;32952;14090
4210209;Major Gercino;1991;3785;1104;2681
4210308;Major Vieira;1991;7326;1825;5501
4210407;Maracajá;1991;4642;2497;2145
4210506;Maravilha;1991;24107;12171;11936
4210555;Marema;1991;6644;1356;5288
4210605;Massaranduba;1991;11168;3703;7465
4210704;Matos Costa;1991;4995;1882;3113
4210803;Meleiro;1991;9755;3047;6708
4210902;Modelo;1991;9798;2524;7274
4211009;Mondaí;1991;16436;4470;11966
4211108;Monte Castelo;1991;8600;4127;4473
4211207;Morro da Fumaça;1991;12373;8752;3621
4211306;Navegantes;1991;23662;20498;3164
4211405;Nova Erechim;1991;3114;1288;1826
4211504;Nova Trento;1991;9122;5236;3886
4211603;Nova Veneza;1991;10376;4578;5798
4211702;Orleans;1991;20041;8915;11126
4211751;Otacílio Costa;1991;14576;10595;3981
4211801;Ouro;1991;6977;3088;3889
4211900;Palhoça;1991;68430;65791;2639
4212007;Palma Sola;1991;8857;2743;6114
4212106;Palmitos;1991;17749;6859;10890
4212205;Papanduva;1991;16232;6817;9415
4212304;Paulo Lopes;1991;5530;2818;2712
4212403;Pedras Grandes;1991;5062;745;4317
4212502;Penha;1991;13108;10513;2595
4212601;Peritiba;1991;3189;1052;2137
4212700;Petrolândia;1991;7067;1394;5673
4212809;Balneário Piçarras;1991;7935;5446;2489
4212908;Pinhalzinho;1991;10673;6695;3978
4213005;Pinheiro Preto;1991;2374;789;1585
4213104;Piratuba;1991;4909;1338;3571
4213203;Pomerode;1991;18771;13747;5024
4213302;Ponte Alta;1991;4752;3045;1707
4213401;Ponte Serrada;1991;12259;5551;6708
4213500;Porto Belo;1991;11689;11036;653
4213609;Porto União;1991;29883;22638;7245
4213708;Pouso Redondo;1991;11465;4368;7097
4213807;Praia Grande;1991;7579;3321;4258
4213906;Presidente Castello Branco;1991;1796;462;1334
4214003;Presidente Getúlio;1991;11372;6310;5062
4214102;Presidente Nereu;1991;2775;776;1999
4214201;Quilombo;1991;19362;4642;14720
4214300;Rancho Queimado;1991;2359;937;1422
4214409;Rio das Antas;1991;5753;1837;3916
4214508;Rio do Campo;1991;6887;1807;5080
4214607;Rio do Oeste;1991;6966;1935;5031
4214706;Rio dos Cedros;1991;8642;2504;6138
4214805;Rio do Sul;1991;45679;42766;2913
4214904;Rio Fortuna;1991;4174;1000;3174
4215000;Rio Negrinho;1991;28460;24778;3682
4215109;Rodeio;1991;9371;6056;3315
4215208;Romelândia;1991;9419;1714;7705
4215307;Salete;1991;7129;3176;3953
4215406;Salto Veloso;1991;3510;2133;1377
4215505;Santa Cecília;1991;12611;7997;4614
4215604;Santa Rosa de Lima;1991;1896;332;1564
4215653;Santa Rosa do Sul;1991;7227;1667;5560
4215703;Santo Amaro da Imperatriz;1991;13392;7701;5691
4215802;São Bento do Sul;1991;50328;45103;5225
4215901;São Bonifácio;1991;3373;656;2717
4216008;São Carlos;1991;12230;4955;7275
4216107;São Domingos;1991;14093;5101;8992
4216206;São Francisco do Sul;1991;29593;27342;2251
4216305;São João Batista;1991;12765;8281;4484
4216404;São João do Sul;1991;8985;2766;6219
4216503;São Joaquim;1991;22295;14722;7573
4216602;São José;1991;139493;128375;11118
4216701;São José do Cedro;1991;17673;5830;11843
4216800;São José do Cerrito;1991;11595;1808;9787
4216909;São Lourenço do Oeste;1991;23181;10178;13003
4217006;São Ludgero;1991;6007;2970;3037
4217105;São Martinho;1991;3378;723;2655
4217204;São Miguel do Oeste;1991;42242;25638;16604
4217303;Saudades;1991;9072;2297;6775
4217402;Schroeder;1991;6607;3526;3081
4217501;Seara;1991;18093;7565;10528
4217550;Serra Alta;1991;3861;714;3147
4217600;Siderópolis;1991;13388;8814;4574
4217709;Sombrio;1991;22253;15065;7188
4217808;Taió;1991;19369;7833;11536
4217907;Tangará;1991;11833;4083;7750
4218004;Tijucas;1991;19650;14334;5316
4218103;Timbé do Sul;1991;5705;1320;4385
4218202;Timbó;1991;23806;19155;4651
4218251;Timbó Grande;1991;4960;948;4012
4218301;Três Barras;1991;15636;12490;3146
4218400;Treze de Maio;1991;6201;1199;5002
4218509;Treze Tílias;1991;4027;1788;2239
4218608;Trombudo Central;1991;8389;3780;4609
4218707;Tubarão;1991;95062;83264;11798
4218756;Tunápolis;1991;5546;1047;4499
4218806;Turvo;1991;12494;4695;7799
4218855;União do Oeste;1991;7234;584;6650
4218905;Urubici;1991;11506;5521;5985
4218954;Urupema;1991;2474;1187;1287
4219002;Urussanga;1991;29882;19203;10679
4219101;Vargeão;1991;2784;1103;1681
4219200;Vidal Ramos;1991;7587;1417;6170
4219309;Videira;1991;35922;27234;8688
4219358;Vitor Meireles;1991;6203;447;5756
4219408;Witmarsum;1991;3649;487;3162
4219507;Xanxerê;1991;37638;27766;9872
4219606;Xavantina;1991;4961;884;4077
4219705;Xaxim;1991;21298;10501;10797
4300059;Água Santa;1991;4082;789;3293
4300109;Agudo;1991;16718;3411;13307
4300208;Ajuricaba;1991;11059;3433;7626
4300307;Alecrim;1991;10379;1333;9046
4300406;Alegrete;1991;78918;68191;10727
4300455;Alegria;1991;6247;1355;4892
4300505;Alpestre;1991;13567;2277;11290
4300554;Alto Alegre;1991;2139;596;1543
4300604;Alvorada;1991;142046;141881;165
4300638;Amaral Ferrador;1991;5917;729;5188
4300661;André da Rocha;1991;1047;293;754
4300703;Anta Gorda;1991;6947;1248;5699
4300802;Antônio Prado;1991;10989;6320;4669
4300901;Aratiba;1991;10714;2449;8265
4301008;Arroio do Meio;1991;19072;10094;8978
4301057;Arroio do Sal;1991;3031;2860;171
4301107;Arroio dos Ratos;1991;11824;10610;1214
4301206;Arroio do Tigre;1991;15581;3881;11700
4301305;Arroio Grande;1991;18150;13499;4651
4301404;Arvorezinha;1991;12636;4441;8195
4301503;Augusto Pestana;1991;8615;2707;5908
4301552;Áurea;1991;7423;1295;6128
4301602;Bagé;1991;118967;92324;26643
4301651;Barão;1991;6835;971;5864
4301701;Barão de Cotegipe;1991;7370;2280;5090
4301800;Barracão;1991;6233;2183;4050
4301909;Barra do Ribeiro;1991;11775;6964;4811
4302006;Barros Cassal;1991;13271;2426;10845
4302105;Bento Gonçalves;1991;78643;65755;12888
4302204;Boa Vista do Buricá;1991;9086;3128;5958
4302303;Bom Jesus;1991;16190;9199;6991
4302352;Bom Princípio;1991;7471;3366;4105
4302402;Bom Retiro do Sul;1991;11470;6977;4493
4302451;Boqueirão do Leão;1991;7359;1168;6191
4302501;Bossoroca;1991;7934;3739;4195
4302600;Braga;1991;4924;1764;3160
4302659;Brochier;1991;6066;1238;4828
4302709;Butiá;1991;25534;23612;1922
4302808;Caçapava do Sul;1991;34618;20349;14269
4302907;Cacequi;1991;15834;12753;3081
4303004;Cachoeira do Sul;1991;89148;71510;17638
4303103;Cachoeirinha;1991;88195;87951;244
4303202;Cacique Doble;1991;5704;1423;4281
4303301;Caibaté;1991;7830;2670;5160
4303400;Caiçara;1991;6202;1236;4966
4303509;Camaquã;1991;61704;39753;21951
4303558;Camargo;1991;2526;656;1870
4303608;Cambará do Sul;1991;7092;2281;4811
4303707;Campina das Missões;1991;8056;2046;6010
4303806;Campinas do Sul;1991;8554;3449;5105
4303905;Campo Bom;1991;47876;46481;1395
4304002;Campo Novo;1991;9410;5384;4026
4304101;Campos Borges;1991;3868;2010;1858
4304200;Candelária;1991;28012;10878;17134
4304309;Cândido Godói;1991;7454;1498;5956
4304408;Canela;1991;24801;23582;1219
4304507;Canguçu;1991;50367;13811;36556
4304606;Canoas;1991;279127;270672;8455
4304630;Capão da Canoa;1991;24755;24562;193
4304663;Capão do Leão;1991;18894;16194;2700
4304689;Capela de Santana;1991;7476;4813;2663
4304705;Carazinho;1991;58767;50742;8025
4304804;Carlos Barbosa;1991;15921;10395;5526
4304903;Casca;1991;10232;3221;7011
4304952;Caseiros;1991;2867;763;2104
4305009;Catuípe;1991;10988;5895;5093
4305108;Caxias do Sul;1991;290925;264775;26150
4305132;Cerro Branco;1991;3901;867;3034
4305157;Cerro Grande;1991;2973;435;2538
4305173;Cerro Grande do Sul;1991;8023;618;7405
4305207;Cerro Largo;1991;18901;10155;8746
4305306;Chapada;1991;10538;4181;6357
4305355;Charqueadas;1991;24756;24349;407
4305405;Chiapetta;1991;6670;3414;3256
4305454;Cidreira;1991;8967;7639;1328
4305504;Ciríaco;1991;7154;2039;5115
4305603;Colorado;1991;4395;1311;3084
4305702;Condor;1991;6421;2701;3720
4305801;Constantina;1991;15063;4991;10072
4305900;Coronel Bicaco;1991;9598;4318;5280
4305959;Cotiporã;1991;4159;1273;2886
4306007;Crissiumal;1991;18183;6487;11696
4306056;Cristal;1991;6075;2647;3428
4306106;Cruz Alta;1991;68793;62490;6303
4306205;Cruzeiro do Sul;1991;10798;4729;6069
4306304;David Canabarro;1991;5093;1021;4072
4306353;Dezesseis de Novembro;1991;3978;445;3533
4306403;Dois Irmãos;1991;18951;17851;1100
4306452;Dois Lajeados;1991;5615;1283;4332
4306502;Dom Feliciano;1991;12407;1712;10695
4306601;Dom Pedrito;1991;38054;32291;5763
4306700;Dona Francisca;1991;3586;1945;1641
4306734;Doutor Maurício Cardoso;1991;7208;2353;4855
4306767;Eldorado do Sul;1991;17703;12480;5223
4306809;Encantado;1991;18156;13461;4695
4306908;Encruzilhada do Sul;1991;21479;10358;11121
4306932;Entre-Ijuís;1991;9955;3697;6258
4306957;Entre Rios do Sul;1991;4041;1629;2412
4306973;Erebango;1991;3209;2030;1179
4307005;Erechim;1991;72318;62377;9941
4307054;Ernestina;1991;3849;747;3102
4307104;Herval;1991;7169;3695;3474
4307203;Erval Grande;1991;7272;1930;5342
4307302;Erval Seco;1991;13021;3199;9822
4307401;Esmeralda;1991;5800;2035;3765
4307500;Espumoso;1991;17010;9173;7837
4307559;Estação;1991;5531;4358;1173
4307609;Estância Velha;1991;28190;26713;1477
4307708;Esteio;1991;70547;70468;79
4307807;Estrela;1991;26686;19635;7051
4307831;Eugênio de Castro;1991;3541;929;2612
4307864;Fagundes Varela;1991;2553;772;1781
4307906;Farroupilha;1991;45364;31025;14339
4308003;Faxinal do Soturno;1991;9084;4611;4473
4308052;Faxinalzinho;1991;3085;254;2831
4308102;Feliz;1991;15565;8362;7203
4308201;Flores da Cunha;1991;19869;8701;11168
4308300;Fontoura Xavier;1991;12092;1940;10152
4308409;Formigueiro;1991;7696;1928;5768
4308458;Fortaleza dos Valos;1991;4660;2020;2640
4308508;Frederico Westphalen;1991;24935;14766;10169
4308607;Garibaldi;1991;25926;16191;9735
4308706;Gaurama;1991;6499;2675;3824
4308805;General Câmara;1991;11548;4910;6638
4308904;Getúlio Vargas;1991;20042;13118;6924
4309001;Giruá;1991;26828;13389;13439
4309050;Glorinha;1991;4587;632;3955
4309100;Gramado;1991;22095;17920;4175
4309209;Gravataí;1991;181035;167863;13172
4309258;Guabiju;1991;1737;580;1157
4309308;Guaíba;1991;83102;73778;9324
4309407;Guaporé;1991;19825;14028;5797
4309506;Guarani das Missões;1991;11500;4798;6702
4309555;Harmonia;1991;3074;1103;1971
4309605;Horizontina;1991;17023;12474;4549
4309704;Humaitá;1991;6030;2695;3335
4309753;Ibarama;1991;5111;744;4367
4309803;Ibiaçá;1991;5893;2333;3560
4309902;Ibiraiaras;1991;7806;2296;5510
4309951;Ibirapuitã;1991;5897;1556;4341
4310009;Ibirubá;1991;17816;11702;6114
4310108;Igrejinha;1991;20514;18997;1517
4310207;Ijuí;1991;75157;60859;14298
4310306;Ilópolis;1991;3860;1250;2610
4310330;Imbé;1991;7352;7227;125
4310363;Imigrante;1991;3961;1001;2960
4310405;Independência;1991;7491;3237;4254
4310439;Ipê;1991;5718;1816;3902
4310462;Ipiranga do Sul;1991;2348;566;1782
4310504;Iraí;1991;11583;5577;6006
4310553;Itacurubi;1991;3370;875;2495
4310603;Itaqui;1991;40057;31483;8574
4310702;Itatiba do Sul;1991;6657;1523;5134
4310751;Ivorá;1991;2563;596;1967
4310801;Ivoti;1991;16326;9201;7125
4310850;Jaboticaba;1991;5748;1183;4565
4310900;Jacutinga;1991;6307;1826;4481
4311007;Jaguarão;1991;27755;22961;4794
4311106;Jaguari;1991;12749;6206;6543
4311122;Jaquirana;1991;4053;1450;2603
4311155;Jóia;1991;7507;1584;5923
4311205;Júlio de Castilhos;1991;25133;16790;8343
4311254;Lagoão;1991;6037;822;5215
4311304;Lagoa Vermelha;1991;28733;20400;8333
4311403;Lajeado;1991;63944;47921;16023
4311502;Lavras do Sul;1991;8830;4812;4018
4311601;Liberato Salzano;1991;8662;1337;7325
4311700;Machadinho;1991;7338;2637;4701
4311809;Marau;1991;25167;15851;9316
4311908;Marcelino Ramos;1991;7080;3028;4052
4312005;Mariano Moro;1991;2997;848;2149
4312104;Mata;1991;5578;2199;3379
4312203;Maximiliano de Almeida;1991;6633;2500;4133
4312302;Miraguaí;1991;5999;1911;4088
4312351;Montauri;1991;1786;384;1402
4312401;Montenegro;1991;49099;36917;12182
4312450;Morro Redondo;1991;6070;2048;4022
4312500;Mostardas;1991;9089;4311;4778
4312609;Muçum;1991;7127;3594;3533
4312658;Não-Me-Toque;1991;14028;10206;3822
4312708;Nonoai;1991;20929;7628;13301
4312757;Nova Alvorada;1991;2653;484;2169
4312807;Nova Araçá;1991;2868;1430;1438
4312906;Nova Bassano;1991;6762;2763;3999
4313003;Nova Bréscia;1991;5174;1243;3931
4313037;Nova Esperança do Sul;1991;3589;1758;1831
4313060;Nova Hartz;1991;10013;8121;1892
4313102;Nova Palma;1991;7656;2085;5571
4313201;Nova Petrópolis;1991;16767;8343;8424
4313300;Nova Prata;1991;15076;10448;4628
4313359;Nova Roma do Sul;1991;2959;863;2096
4313409;Novo Hamburgo;1991;205668;201502;4166
4313508;Osório;1991;36857;26345;10512
4313607;Paim Filho;1991;5395;2035;3360
4313656;Palmares do Sul;1991;11248;7384;3864
4313706;Palmeira das Missões;1991;52968;30262;22706
4313805;Palmitinho;1991;11669;1701;9968
4313904;Panambi;1991;29379;24089;5290
4313953;Pantano Grande;1991;10017;7896;2121
4314001;Paraí;1991;5110;1316;3794
4314027;Paraíso do Sul;1991;6565;1039;5526
4314050;Parobé;1991;31995;30771;1224
4314100;Passo Fundo;1991;147318;137288;10030
4314159;Paverama;1991;7202;1894;5308
4314209;Pedro Osório;1991;14862;10694;4168
4314308;Pejuçara;1991;4039;2210;1829
4314407;Pelotas;1991;291100;265192;25908
4314456;Pinhal;1991;2740;817;1923
4314506;Pinheiro Machado;1991;15396;8465;6931
4314555;Pirapó;1991;3819;551;3268
4314605;Piratini;1991;17655;7024;10631
4314704;Planalto;1991;17875;5505;12370
4314753;Poço das Antas;1991;1558;413;1145
4314803;Portão;1991;19489;16445;3044
4314902;Porto Alegre;1991;1263403;1247529;15874
4315008;Porto Lucena;1991;9415;2692;6723
4315107;Porto Xavier;1991;10934;4242;6692
4315131;Pouso Novo;1991;2215;470;1745
4315156;Progresso;1991;6923;1202;5721
4315172;Protásio Alves;1991;2340;299;2041
4315206;Putinga;1991;5243;1107;4136
4315305;Quaraí;1991;22083;19480;2603
4315354;Quinze de Novembro;1991;3430;1189;2241
4315404;Redentora;1991;9176;2423;6753
4315453;Relvado;1991;2566;517;2049
4315503;Restinga Sêca;1991;15242;6693;8549
4315602;Rio Grande;1991;172422;165025;7397
4315701;Rio Pardo;1991;42924;23565;19359
4315750;Riozinho;1991;3389;1768;1621
4315800;Roca Sales;1991;9557;3609;5948
4315909;Rodeio Bonito;1991;10852;2409;8443
4316006;Rolante;1991;13420;9970;3450
4316105;Ronda Alta;1991;11689;4026;7663
4316204;Rondinha;1991;7126;1944;5182
4316303;Roque Gonzales;1991;8808;2086;6722
4316402;Rosário do Sul;1991;40464;34123;6341
4316436;Saldanha Marinho;1991;3330;1651;1679
4316451;Salto do Jacuí;1991;10876;7479;3397
4316501;Salvador do Sul;1991;8388;2713;5675
4316600;Sananduva;1991;14448;7401;7047
4316709;Santa Bárbara do Sul;1991;9941;6142;3799
4316808;Santa Cruz do Sul;1991;117773;78955;38818
4316907;Santa Maria;1991;217592;196342;21250
4316956;Santa Maria do Herval;1991;5185;1173;4012
4317004;Santana da Boa Vista;1991;8408;2861;5547
4317103;Sant'Ana do Livramento;1991;80252;73557;6695
4317202;Santa Rosa;1991;58287;48356;9931
4317301;Santa Vitória do Palmar;1991;34462;25896;8566
4317400;Santiago;1991;51755;40962;10793
4317509;Santo Ângelo;1991;76592;61165;15427
4317608;Santo Antônio da Patrulha;1991;40607;21065;19542
4317707;Santo Antônio das Missões;1991;13257;5742;7515
4317806;Santo Augusto;1991;17832;9697;8135
4317905;Santo Cristo;1991;15147;5491;9656
4318002;São Borja;1991;63783;52562;11221
4318051;São Domingos do Sul;1991;2561;1015;1546
4318101;São Francisco de Assis;1991;26667;16702;9965
4318200;São Francisco de Paula;1991;19251;11191;8060
4318309;São Gabriel;1991;59040;47967;11073
4318408;São Jerônimo;1991;27684;13610;14074
4318424;São João da Urtiga;1991;5212;1222;3990
4318440;São Jorge;1991;2874;864;2010
4318465;São José do Herval;1991;2456;469;1987
4318481;São José do Hortêncio;1991;2800;1009;1791
4318507;São José do Norte;1991;22071;13510;8561
4318606;São José do Ouro;1991;11464;4321;7143
4318705;São Leopoldo;1991;167907;160358;7549
4318804;São Lourenço do Sul;1991;41420;18918;22502
4318903;São Luiz Gonzaga;1991;41671;33564;8107
4319000;São Marcos;1991;15857;12412;3445
4319109;São Martinho;1991;7352;3048;4304
4319158;São Miguel das Missões;1991;7413;1720;5693
4319208;São Nicolau;1991;6874;3782;3092
4319307;São Paulo das Missões;1991;8523;1949;6574
4319406;São Pedro do Sul;1991;20381;9939;10442
4319505;São Sebastião do Caí;1991;16833;11952;4881
4319604;São Sepé;1991;28075;19195;8880
4319703;São Valentim;1991;7709;1589;6120
4319752;São Vendelino;1991;1458;519;939
4319802;São Vicente do Sul;1991;7576;4331;3245
4319901;Sapiranga;1991;58675;52907;5768
4320008;Sapucaia do Sul;1991;104885;104486;399
4320107;Sarandi;1991;22351;11677;10674
4320206;Seberi;1991;13532;4357;9175
4320230;Sede Nova;1991;3734;1391;2343
4320263;Segredo;1991;6950;1221;5729
4320305;Selbach;1991;4579;2054;2525
4320404;Serafina Corrêa;1991;8458;5437;3021
4320503;Sertão;1991;8938;3192;5746
4320602;Severiano de Almeida;1991;4430;957;3473
4320651;Silveira Martins;1991;2380;737;1643
4320701;Sobradinho;1991;20140;9645;10495
4320800;Soledade;1991;30582;20972;9610
4320909;Tapejara;1991;18887;8918;9969
4321006;Tapera;1991;10937;7653;3284
4321105;Tapes;1991;19762;11821;7941
4321204;Taquara;1991;42467;35100;7367
4321303;Taquari;1991;25024;15876;9148
4321329;Taquaruçu do Sul;1991;3060;790;2270
4321352;Tavares;1991;5075;1748;3327
4321402;Tenente Portela;1991;23674;10828;12846
4321436;Terra de Areia;1991;10407;3933;6474
4321451;Teutônia;1991;17578;11636;5942
4321501;Torres;1991;37474;21478;15996
4321600;Tramandaí;1991;20130;18171;1959
4321634;Três Arroios;1991;3288;509;2779
4321667;Três Cachoeiras;1991;7999;3465;4534
4321709;Três Coroas;1991;15087;11862;3225
4321808;Três de Maio;1991;26535;15957;10578
4321857;Três Palmeiras;1991;5030;822;4208
4321907;Três Passos;1991;40761;18764;21997
4321956;Trindade do Sul;1991;6927;1503;5424
4322004;Triunfo;1991;17923;9980;7943
4322103;Tucunduva;1991;12538;4350;8188
4322152;Tunas;1991;4388;641;3747
4322202;Tupanciretã;1991;23240;15788;7452
4322251;Tupandi;1991;2325;632;1693
4322301;Tuparendi;1991;12481;5074;7407
4322400;Uruguaiana;1991;117456;105822;11634
4322509;Vacaria;1991;58610;45643;12967
4322558;Vanini;1991;1826;671;1155
4322608;Venâncio Aires;1991;55482;25933;29549
4322707;Vera Cruz;1991;17912;7141;10771
4322806;Veranópolis;1991;16916;11637;5279
4322905;Viadutos;1991;8889;2342;6547
4323002;Viamão;1991;169176;156145;13031
4323101;Vicente Dutra;1991;6624;1940;4684
4323200;Victor Graeff;1991;3872;981;2891
4323309;Vila Flores;1991;2650;694;1956
4323408;Vila Maria;1991;4059;1067;2992
4323507;Vista Alegre;1991;3148;700;2448
4323606;Vista Alegre do Prata;1991;1783;280;1503
4323705;Vista Gaúcha;1991;2749;380;2369
5000203;Água Clara;1991;6539;2265;4274
5000609;Amambai;1991;25951;15279;10672
5000708;Anastácio;1991;19940;14376;5564
5000807;Anaurilândia;1991;7270;3167;4103
5000856;Angélica;1991;8834;6385;2449
5000906;Antônio João;1991;6636;5494;1142
5001003;Aparecida do Taboado;1991;15172;11813;3359
5001102;Aquidauana;1991;39342;29294;10048
5001243;Aral Moreira;1991;8064;2949;5115
5001508;Bandeirantes;1991;6169;4088;2081
5001904;Bataguassu;1991;11450;8418;3032
5002001;Batayporã;1991;7971;3599;4372
5002100;Bela Vista;1991;19135;16121;3014
5002159;Bodoquena;1991;8120;4125;3995
5002209;Bonito;1991;15543;10322;5221
5002308;Brasilândia;1991;10349;4885;5464
5002407;Caarapó;1991;22492;14265;8227
5002605;Camapuã;1991;15501;9503;5998
5002704;Campo Grande;1991;526126;518687;7439
5002803;Caracol;1991;3930;1892;2038
5002902;Cassilândia;1991;17861;15055;2806
5002951;Chapadão do Sul;1991;5383;2328;3055
5003108;Corguinho;1991;3679;1055;2624
5003157;Coronel Sapucaia;1991;11609;5787;5822
5003207;Corumbá;1991;88411;76660;11751
5003256;Costa Rica;1991;13973;9005;4968
5003306;Coxim;1991;33549;23612;9937
5003454;Deodápolis;1991;13713;8920;4793
5003488;Dois Irmãos do Buriti;1991;8749;3931;4818
5003504;Douradina;1991;4741;2487;2254
5003702;Dourados;1991;135984;122856;13128
5003751;Eldorado;1991;11025;7460;3565
5003801;Fátima do Sul;1991;22155;16953;5202
5004007;Glória de Dourados;1991;11889;7990;3899
5004106;Guia Lopes da Laguna;1991;9167;7058;2109
5004304;Iguatemi;1991;11100;6997;4103
5004403;Inocência;1991;6279;2986;3293
5004502;Itaporã;1991;15935;9971;5964
5004601;Itaquiraí;1991;13090;5285;7805
5004700;Ivinhema;1991;32426;14993;17433
5004908;Jaraguari;1991;4496;911;3585
5005004;Jardim;1991;19325;17601;1724
5005103;Jateí;1991;4986;1347;3639
5005152;Juti;1991;5273;3074;2199
5005202;Ladário;1991;11981;11060;921
5005400;Maracaju;1991;22999;17356;5643
5005608;Miranda;1991;20176;10677;9499
5005681;Mundo Novo;1991;22417;15737;6680
5005707;Naviraí;1991;30670;25192;5478
5005806;Nioaque;1991;11057;4769;6288
5006200;Nova Andradina;1991;29848;22294;7554
5006309;Paranaíba;1991;37654;28491;9163
5006358;Paranhos;1991;9481;5793;3688
5006408;Pedro Gomes;1991;8319;6026;2293
5006606;Ponta Porã;1991;55541;47040;8501
5006903;Porto Murtinho;1991;12808;6184;6624
5007109;Ribas do Rio Pardo;1991;13423;5577;7846
5007208;Rio Brilhante;1991;22509;14734;7775
5007307;Rio Negro;1991;5604;3598;2006
5007406;Rio Verde de Mato Grosso;1991;15075;12311;2764
5007505;Rochedo;1991;3522;1402;2120
5007554;Santa Rita do Pardo;1991;5534;2276;3258
5007695;São Gabriel do Oeste;1991;12034;8861;3173
5007703;Sete Quedas;1991;14994;8532;6462
5007802;Selvíria;1991;5967;3786;2181
5007901;Sidrolândia;1991;16340;10794;5546
5007935;Sonora;1991;5879;4974;905
5007950;Tacuru;1991;7233;3338;3895
5007976;Taquarussu;1991;4533;2402;2131
5008008;Terenos;1991;9998;4695;5303
5008305;Três Lagoas;1991;68162;61650;6512
5008404;Vicentina;1991;7283;3649;3634
5100102;Acorizal;1991;5308;2848;2460
5100201;Água Boa;1991;16561;7513;9048
5100250;Alta Floresta;1991;66926;37504;29422
5100300;Alto Araguaia;1991;10770;8365;2405
5100409;Alto Garças;1991;8306;6975;1331
5100508;Alto Paraguai;1991;13854;9846;4008
5100607;Alto Taquari;1991;3014;2126;888
5100805;Apiacás;1991;7361;4582;2779
5101001;Araguaiana;1991;3386;1991;1395
5101209;Araguainha;1991;1416;1128;288
5101258;Araputanga;1991;12560;7276;5284
5101308;Arenápolis;1991;19617;16160;3457
5101407;Aripuanã;1991;13614;4467;9147
5101605;Barão de Melgaço;1991;9858;3222;6636
5101704;Barra do Bugres;1991;22264;15219;7045
5101803;Barra do Garças;1991;45651;41469;4182
5101902;Brasnorte;1991;6622;3710;2912
5102504;Cáceres;1991;77540;54535;23005
5102603;Campinápolis;1991;11818;4497;7321
5102637;Campo Novo do Parecis;1991;6311;2211;4100
5102678;Campo Verde;1991;5975;2848;3127
5102702;Canarana;1991;11909;6655;5254
5102850;Castanheira;1991;8362;3629;4733
5103007;Chapada dos Guimarães;1991;12888;5249;7639
5103056;Cláudia;1991;9099;3713;5386
5103106;Cocalinho;1991;5457;2423;3034
5103205;Colíder;1991;31160;15716;15444
5103304;Comodoro;1991;9278;5255;4023
5103403;Cuiabá;1991;402813;395662;7151
5103452;Denise;1991;4785;3609;1176
5103502;Diamantino;1991;16620;12556;4064
5103601;Dom Aquino;1991;8934;7048;1886
5103809;Figueirópolis D'Oeste;1991;5413;1784;3629
5103908;General Carneiro;1991;4307;2023;2284
5104104;Guarantã do Norte;1991;23825;11097;12728
5104203;Guiratinga;1991;14798;12307;2491
5104500;Indiavaí;1991;2023;1035;988
5104559;Itaúba;1991;7143;2062;5081
5104609;Itiquira;1991;8005;2975;5030
5104807;Jaciara;1991;21917;19641;2276
5104906;Jangada;1991;5227;2122;3105
5105002;Jauru;1991;13247;5659;7588
5105101;Juara;1991;21712;15134;6578
5105150;Juína;1991;36581;25822;10759
5105176;Juruena;1991;5956;2726;3230
5105200;Juscimeira;1991;10948;7628;3320
5105259;Lucas do Rio Verde;1991;6693;4332;2361
5105309;Luciara;1991;5604;3035;2569
5105507;Vila Bela da Santíssima Trindade;1991;13693;4116;9577
5105580;Marcelândia;1991;8889;4219;4670
5105606;Matupá;1991;10221;7108;3113
5105622;Mirassol d'Oeste;1991;25864;20954;4910
5105903;Nobres;1991;15174;10807;4367
5106000;Nortelândia;1991;10068;9178;890
5106109;Nossa Senhora do Livramento;1991;10472;3456;7016
5106208;Nova Brasilândia;1991;9612;4931;4681
5106216;Nova Canaã do Norte;1991;14033;5202;8831
5106224;Nova Mutum;1991;5542;2108;3434
5106232;Nova Olímpia;1991;7030;5012;2018
5106257;Nova Xavantina;1991;18509;13376;5133
5106273;Novo Horizonte do Norte;1991;4267;1282;2985
5106281;Novo São Joaquim;1991;7170;2567;4603
5106299;Paranaíta;1991;12173;6626;5547
5106307;Paranatinga;1991;18383;9663;8720
5106372;Pedra Preta;1991;11225;7638;3587
5106422;Peixoto de Azevedo;1991;37240;32535;4705
5106505;Poconé;1991;29856;21303;8553
5106703;Ponte Branca;1991;3724;2749;975
5106752;Pontes e Lacerda;1991;34603;21790;12813
5106778;Porto Alegre do Norte;1991;10151;5068;5083
5106802;Porto dos Gaúchos;1991;6558;3145;3413
5106828;Porto Esperidião;1991;8586;2187;6399
5107008;Poxoréu;1991;23878;16555;7323
5107040;Primavera do Leste;1991;12523;9758;2765
5107107;São José dos Quatro Marcos;1991;22011;14120;7891
5107156;Reserva do Cabaçal;1991;3186;1828;1358
5107180;Ribeirão Cascalheira;1991;8610;3552;5058
5107206;Rio Branco;1991;11845;5167;6678
5107305;São José do Rio Claro;1991;16333;10631;5702
5107602;Rondonópolis;1991;126627;113032;13595
5107701;Rosário Oeste;1991;20050;10839;9211
5107750;Salto do Céu;1991;7410;2580;4830
5107776;Santa Terezinha;1991;8902;2640;6262
5107800;Santo Antônio do Leverger;1991;15389;4503;10886
5107859;São Félix do Araguaia;1991;14810;5657;9153
5107909;Sinop;1991;38374;33253;5121
5107925;Sorriso;1991;16107;11325;4782
5107958;Tangará da Serra;1991;39848;32053;7795
5108006;Tapurah;1991;7323;1250;6073
5108055;Terra Nova do Norte;1991;22448;7935;14513
5108105;Tesouro;1991;4548;3295;1253
5108204;Torixoréu;1991;8352;5529;2823
5108402;Várzea Grande;1991;161958;155307;6651
5108501;Vera;1991;10759;3303;7456
5108600;Vila Rica;1991;9461;4589;4872
5200100;Abadiânia;1991;9402;5141;4261
5200134;Acreúna;1991;14059;11549;2510
5200159;Adelândia;1991;2339;1555;784
5200175;Água Fria de Goiás;1991;3976;944;3032
5200209;Água Limpa;1991;1937;1171;766
5200308;Alexânia;1991;16472;9500;6972
5200506;Aloândia;1991;1992;1459;533
5200605;Alto Paraíso de Goiás;1991;4193;2331;1862
5200803;Alvorada do Norte;1991;7391;5707;1684
5200852;Americano do Brasil;1991;4861;4132;729
5200902;Amorinópolis;1991;4428;2337;2091
5201108;Anápolis;1991;239378;226925;12453
5201207;Anhanguera;1991;869;789;80
5201306;Anicuns;1991;18206;12081;6125
5201405;Aparecida de Goiânia;1991;178483;175555;2928
5201504;Aporé;1991;4979;1600;3379
5201603;Araçu;1991;3691;2619;1072
5201702;Aragarças;1991;13742;13192;550
5201801;Aragoiânia;1991;4910;2831;2079
5202155;Araguapaz;1991;7372;5097;2275
5202353;Arenópolis;1991;4147;2033;2114
5202502;Aruanã;1991;4909;3580;1329
5202601;Aurilândia;1991;4265;2830;1435
5202809;Avelinópolis;1991;2336;1328;1008
5203104;Baliza;1991;4128;1204;2924
5203203;Barro Alto;1991;9919;3587;6332
5203302;Bela Vista de Goiás;1991;17316;9652;7664
5203401;Bom Jardim de Goiás;1991;7986;4938;3048
5203500;Bom Jesus de Goiás;1991;13851;11818;2033
5203559;Bonfinópolis;1991;3324;2743;581
5203609;Brazabrantes;1991;2334;1271;1063
5203807;Britânia;1991;4686;3389;1297
5203906;Buriti Alegre;1991;8742;7347;1395
5204003;Cabeceiras;1991;6464;4183;2281
5204102;Cachoeira Alta;1991;8605;4441;4164
5204201;Cachoeira de Goiás;1991;1435;881;554
5204250;Cachoeira Dourada;1991;8502;3703;4799
5204300;Caçu;1991;11228;8016;3212
5204409;Caiapônia;1991;13915;9589;4326
5204508;Caldas Novas;1991;24159;21238;2921
5204607;Campestre de Goiás;1991;2316;1411;905
5204656;Campinaçu;1991;4483;1575;2908
5204706;Campinorte;1991;8257;5033;3224
5204805;Campo Alegre de Goiás;1991;4536;2094;2442
5204904;Campos Belos;1991;14746;11728;3018
5204953;Campos Verdes;1991;16648;14169;2479
5205000;Carmo do Rio Verde;1991;10292;4759;5533
5205109;Catalão;1991;54525;47152;7373
5205208;Caturaí;1991;4134;2489;1645
5205307;Cavalcante;1991;8156;2001;6155
5205406;Ceres;1991;22874;16951;5923
5205455;Cezarina;1991;5744;2793;2951
5205521;Colinas do Sul;1991;3458;1173;2285
5205703;Córrego do Ouro;1991;3289;1490;1799
5205802;Corumbá de Goiás;1991;19663;3847;15816
5205901;Corumbaíba;1991;5529;3275;2254
5206206;Cristalina;1991;24937;17652;7285
5206305;Cristianópolis;1991;2383;1792;591
5206404;Crixás;1991;22213;10122;12091
5206503;Cromínia;1991;3400;2228;1172
5206602;Cumari;1991;2883;2112;771
5206701;Damianópolis;1991;3675;1083;2592
5206800;Damolândia;1991;2593;1674;919
5206909;Davinópolis;1991;2118;946;1172
5207105;Diorama;1991;2637;1068;1569
5207253;Doverlândia;1991;10213;5017;5196
5207352;Edealina;1991;4039;2161;1878
5207402;Edéia;1991;8999;7127;1872
5207501;Estrela do Norte;1991;3387;2798;589
5207535;Faina;1991;8003;2669;5334
5207600;Fazenda Nova;1991;7165;3893;3272
5207808;Firminópolis;1991;9757;7148;2609
5207907;Flores de Goiás;1991;5071;1585;3486
5208004;Formosa;1991;62982;49659;13323
5208103;Formoso;1991;6158;4243;1915
5208301;Divinópolis de Goiás;1991;5025;2209;2816
5208400;Goianápolis;1991;10716;8594;2122
5208509;Goiandira;1991;5368;4269;1099
5208608;Goianésia;1991;43535;36768;6767
5208707;Goiânia;1991;922222;913485;8737
5208806;Goianira;1991;12896;10135;2761
5208905;Goiás;1991;27782;20140;7642
5209101;Goiatuba;1991;32469;27694;4775
5209150;Gouvelândia;1991;4136;2452;1684
5209200;Guapó;1991;11785;8249;3536
5209408;Guarani de Goiás;1991;5611;1486;4125
5209457;Guarinos;1991;3711;1333;2378
5209606;Heitoraí;1991;3021;1940;1081
5209705;Hidrolândia;1991;10254;4665;5589
5209804;Hidrolina;1991;4979;2859;2120
5209903;Iaciara;1991;9709;6720;2989
5209952;Indiara;1991;9843;6714;3129
5210000;Inhumas;1991;38368;32722;5646
5210109;Ipameri;1991;20794;16904;3890
5210208;Iporá;1991;29688;25540;4148
5210307;Israelândia;1991;3356;2450;906
5210406;Itaberaí;1991;24852;17255;7597
5210562;Itaguari;1991;4085;3023;1062
5210604;Itaguaru;1991;6450;3940;2510
5210802;Itajá;1991;6141;3552;2589
5210901;Itapaci;1991;12652;8339;4313
5211008;Itapirapuã;1991;9052;6276;2776
5211206;Itapuranga;1991;31215;19885;11330
5211305;Itarumã;1991;5859;2785;3074
5211404;Itauçu;1991;8678;5912;2766
5211503;Itumbiara;1991;79533;72335;7198
5211602;Ivolândia;1991;3014;1403;1611
5211701;Jandaia;1991;6474;3524;2950
5211800;Jaraguá;1991;28184;15635;12549
5211909;Jataí;1991;65957;55593;10364
5212006;Jaupaci;1991;3154;2285;869
5212105;Joviânia;1991;6538;5222;1316
5212204;Jussara;1991;20917;14373;6544
5212303;Leopoldo de Bulhões;1991;7376;4103;3273
5212501;Luziânia;1991;207674;194345;13329
5212600;Mairipotaba;1991;2665;1338;1327
5212709;Mambaí;1991;6999;3012;3987
5212808;Mara Rosa;1991;21291;7676;13615
5212907;Marzagão;1991;1405;1123;282
5212956;Matrinchã;1991;3869;2149;1720
5213004;Maurilândia;1991;7321;6462;859
5213053;Mimoso de Goiás;1991;3750;975;2775
5213087;Minaçu;1991;32288;26112;6176
5213103;Mineiros;1991;31144;26662;4482
5213400;Moiporá;1991;2254;1250;1004
5213509;Monte Alegre de Goiás;1991;7966;2275;5691
5213707;Montes Claros de Goiás;1991;8450;4772;3678
5213756;Montividiu;1991;5595;3061;2534
5213806;Morrinhos;1991;32592;25395;7197
5213855;Morro Agudo de Goiás;1991;2526;1306;1220
5213905;Mossâmedes;1991;9056;4802;4254
5214002;Mozarlândia;1991;10078;8212;1866
5214051;Mundo Novo;1991;5476;4003;1473
5214101;Mutunópolis;1991;4064;2564;1500
5214408;Nazário;1991;6244;4480;1764
5214507;Nerópolis;1991;12987;11306;1681
5214606;Niquelândia;1991;40751;23786;16965
5214705;Nova América;1991;2022;1118;904
5214804;Nova Aurora;1991;1845;1469;376
5214838;Nova Crixás;1991;11102;6327;4775
5214861;Nova Glória;1991;8506;4926;3580
5214903;Nova Roma;1991;4715;1287;3428
5215009;Nova Veneza;1991;5003;3658;1345
5215207;Novo Brasil;1991;4798;2646;2152
5215256;Novo Planalto;1991;4394;3190;1204
5215306;Orizona;1991;12471;5319;7152
5215405;Ouro Verde de Goiás;1991;4259;2144;2115
5215504;Ouvidor;1991;3703;2518;1185
5215603;Padre Bernardo;1991;16500;9311;7189
5215652;Palestina de Goiás;1991;3174;1649;1525
5215702;Palmeiras de Goiás;1991;16635;11194;5441
5215801;Palmelo;1991;2123;1980;143
5215900;Palminópolis;1991;3629;1902;1727
5216007;Panamá;1991;2501;1501;1000
5216304;Paranaiguara;1991;7479;6449;1030
5216403;Paraúna;1991;9832;6755;3077
5216809;Petrolina de Goiás;1991;10741;5347;5394
5216908;Pilar de Goiás;1991;4845;1180;3665
5217104;Piracanjuba;1991;25273;15785;9488
5217203;Piranhas;1991;12810;10168;2642
5217302;Pirenópolis;1991;25056;9277;15779
5217401;Pires do Rio;1991;22131;20537;1594
5217609;Planaltina;1991;40201;37499;2702
5217708;Pontalina;1991;15409;11336;4073
5218003;Porangatu;1991;41086;31905;9181
5218102;Portelândia;1991;3021;2220;801
5218300;Posse;1991;23518;13265;10253
5218508;Quirinópolis;1991;34276;26656;7620
5218607;Rialma;1991;8912;7943;969
5218706;Rianápolis;1991;4290;3598;692
5218789;Rio Quente;1991;837;462;375
5218805;Rio Verde;1991;96309;84142;12167
5218904;Rubiataba;1991;16686;12594;4092
5219001;Sanclerlândia;1991;7353;4938;2415
5219100;Santa Bárbara de Goiás;1991;3916;3267;649
5219209;Santa Cruz de Goiás;1991;3261;819;2442
5219258;Santa Fé de Goiás;1991;3523;1969;1554
5219308;Santa Helena de Goiás;1991;33142;29404;3738
5219357;Santa Isabel;1991;3887;1172;2715
5219407;Santa Rita do Araguaia;1991;4534;3960;574
5219506;Santa Rosa de Goiás;1991;3982;2297;1685
5219605;Santa Tereza de Goiás;1991;5102;4084;1018
5219704;Santa Terezinha de Goiás;1991;16522;11980;4542
5219753;Santo Antônio do Descoberto;1991;35509;28606;6903
5219803;São Domingos;1991;10330;3573;6757
5219902;São Francisco de Goiás;1991;8097;3105;4992
5220009;São João d'Aliança;1991;5116;2503;2613
5220058;São João da Paraúna;1991;1878;1123;755
5220108;São Luís de Montes Belos;1991;25039;19218;5821
5220157;São Luiz do Norte;1991;4162;1924;2238
5220207;São Miguel do Araguaia;1991;19169;15657;3512
5220264;São Miguel do Passa Quatro;1991;2820;815;2005
5220405;São Simão;1991;11096;10611;485
5220454;Senador Canedo;1991;23905;8753;15152
5220504;Serranópolis;1991;7855;4106;3749
5220603;Silvânia;1991;18000;8208;9792
5220686;Simolândia;1991;5578;4306;1272
5220702;Sítio d'Abadia;1991;2748;472;2276
5221007;Taquaral de Goiás;1991;4069;2361;1708
5221080;Teresina de Goiás;1991;1373;897;476
5221304;Três Ranchos;1991;2260;1313;947
5221403;Trindade;1991;54072;48927;5145
5221452;Trombas;1991;6493;2005;4488
5221502;Turvânia;1991;5385;3557;1828
5221551;Turvelândia;1991;2437;1267;1170
5221601;Uruaçu;1991;33929;28191;5738
5221700;Uruana;1991;13757;9397;4360
5221809;Urutaí;1991;2834;2036;798
5221908;Varjão;1991;3424;1911;1513
5222005;Vianópolis;1991;9067;5157;3910
5222054;Vicentinópolis;1991;5149;3493;1656
5300108;Brasília;1991;1601094;1515889;85205
1100015;Alta Floresta D'Oeste;2000;26533;12341;14192
1100023;Ariquemes;2000;74503;55118;19385
1100031;Cabixi;2000;7518;2672;4846
1100049;Cacoal;2000;73568;51398;22170
1100056;Cerejeiras;2000;18207;14846;3361
1100064;Colorado do Oeste;2000;21892;14576;7316
1100072;Corumbiara;2000;10459;2073;8386
1100080;Costa Marques;2000;10208;6758;3450
1100098;Espigão D'Oeste;2000;25688;14262;11426
1100106;Guajará-Mirim;2000;38045;33035;5010
1100114;Jaru;2000;53600;29577;24023
1100122;Ji-Paraná;2000;106800;91013;15787
1100130;Machadinho D'Oeste;2000;22739;10981;11758
1100148;Nova Brasilândia D'Oeste;2000;17067;6424;10643
1100155;Ouro Preto do Oeste;2000;40884;26541;14343
1100189;Pimenta Bueno;2000;31752;26423;5329
1100205;Porto Velho;2000;334661;273709;60952
1100254;Presidente Médici;2000;26365;12174;14191
1100262;Rio Crespo;2000;2937;872;2065
1100288;Rolim de Moura;2000;47382;34421;12961
1100296;Santa Luzia D'Oeste;2000;11603;4887;6716
1100304;Vilhena;2000;53598;50601;2997
1100320;São Miguel do Guaporé;2000;23874;6476;17398
1100338;Nova Mamoré;2000;14778;7247;7531
1100346;Alvorada D'Oeste;2000;19832;8546;11286
1100379;Alto Alegre dos Parecis;2000;13070;2295;10775
1100403;Alto Paraíso;2000;13118;4036;9082
1100452;Buritis;2000;25668;15334;10334
1100502;Novo Horizonte do Oeste;2000;12276;1344;10932
1100601;Cacaulândia;2000;5372;2160;3212
1100700;Campo Novo de Rondônia;2000;11463;3000;8463
1100809;Candeias do Jamari;2000;13107;9354;3753
1100908;Castanheiras;2000;4212;774;3438
1100924;Chupinguaia;2000;5521;1954;3567
1100940;Cujubim;2000;6536;3311;3225
1101005;Governador Jorge Teixeira;2000;13961;1558;12403
1101104;Itapuã do Oeste;2000;6822;3677;3145
1101203;Ministro Andreazza;2000;11610;2160;9450
1101302;Mirante da Serra;2000;13154;5733;7421
1101401;Monte Negro;2000;12627;5722;6905
1101435;Nova União;2000;8233;1329;6904
1101450;Parecis;2000;3622;999;2623
1101468;Pimenteiras do Oeste;2000;2527;1518;1009
1101476;Primavera de Rondônia;2000;4311;1159;3152
1101484;São Felipe D'Oeste;2000;7056;1031;6025
1101492;São Francisco do Guaporé;2000;11085;5226;5859
1101500;Seringueiras;2000;11655;3792;7863
1101559;Teixeirópolis;2000;5618;1154;4464
1101609;Theobroma;2000;11355;1515;9840
1101708;Urupá;2000;14880;4002;10878
1101757;Vale do Anari;2000;7737;1836;5901
1101807;Vale do Paraíso;2000;9863;1840;8023
1200013;Acrelândia;2000;7935;3506;4429
1200054;Assis Brasil;2000;3490;2248;1242
1200104;Brasiléia;2000;17013;9026;7987
1200138;Bujari;2000;5826;1628;4198
1200179;Capixaba;2000;5206;1521;3685
1200203;Cruzeiro do Sul;2000;67441;38971;28470
1200252;Epitaciolândia;2000;11028;7404;3624
1200302;Feijó;2000;27078;11240;15838
1200328;Jordão;2000;4454;863;3591
1200336;Mâncio Lima;2000;11095;5794;5301
1200344;Manoel Urbano;2000;6374;3281;3093
1200351;Marechal Thaumaturgo;2000;8295;1844;6451
1200385;Plácido de Castro;2000;15172;6979;8193
1200393;Porto Walter;2000;5485;1441;4044
1200401;Rio Branco;2000;253059;226298;26761
1200427;Rodrigues Alves;2000;8093;2632;5461
1200435;Santa Rosa do Purus;2000;2246;518;1728
1200450;Senador Guiomard;2000;19761;8640;11121
1200500;Sena Madureira;2000;29420;16155;13265
1200609;Tarauacá;2000;26037;13946;12091
1200708;Xapuri;2000;11956;5995;5961
1200807;Porto Acre;2000;11418;1293;10125
1300029;Alvarães;2000;12150;5314;6836
1300060;Amaturá;2000;7308;3930;3378
1300086;Anamã;2000;6563;2064;4499
1300102;Anori;2000;11320;6583;4737
1300144;Apuí;2000;13864;6126;7738
1300201;Atalaia do Norte;2000;10049;4314;5735
1300300;Autazes;2000;24345;10150;14195
1300409;Barcelos;2000;24197;7954;16243
1300508;Barreirinha;2000;22579;9248;13331
1300607;Benjamin Constant;2000;23219;14171;9048
1300631;Beruri;2000;11038;4959;6079
1300680;Boa Vista do Ramos;2000;10653;4975;5677
1300706;Boca do Acre;2000;26959;14614;12345
1300805;Borba;2000;28619;11246;17373
1300839;Caapiranga;2000;8803;3115;5688
1300904;Canutama;2000;10737;5439;5298
1301001;Carauari;2000;23421;16876;6545
1301100;Careiro;2000;27554;5877;21677
1301159;Careiro da Várzea;2000;17267;757;16510
1301209;Coari;2000;67096;39504;27592
1301308;Codajás;2000;17507;11289;6218
1301407;Eirunepé;2000;26074;16781;9293
1301506;Envira;2000;19060;6745;12315
1301605;Fonte Boa;2000;33045;11633;21412
1301654;Guajará;2000;13220;6220;7000
1301704;Humaitá;2000;32796;23850;8946
1301803;Ipixuna;2000;14759;5765;8994
1301852;Iranduba;2000;32303;9940;22363
1301902;Itacoatiara;2000;72105;46465;25640
1301951;Itamarati;2000;8406;3103;5303
1302009;Itapiranga;2000;7309;5295;2014
1302108;Japurá;2000;10285;2283;8002
1302207;Juruá;2000;6584;3052;3532
1302306;Jutaí;2000;23267;8419;14848
1302405;Lábrea;2000;28956;19276;9680
1302504;Manacapuru;2000;73695;47662;26033
1302553;Manaquiri;2000;12711;4853;7858
1302603;Manaus;2000;1405835;1396768;9067
1302702;Manicoré;2000;38038;15339;22699
1302801;Maraã;2000;17079;4521;12558
1302900;Maués;2000;40036;21179;18857
1303007;Nhamundá;2000;15355;6505;8850
1303106;Nova Olinda do Norte;2000;23725;10262;13463
1303205;Novo Airão;2000;9651;6984;2667
1303304;Novo Aripuanã;2000;17119;10468;6651
1303403;Parintins;2000;92118;58125;33993
1303502;Pauini;2000;17092;6970;10122
1303536;Presidente Figueiredo;2000;17394;8383;9011
1303569;Rio Preto da Eva;2000;17582;6232;11350
1303601;Santa Isabel do Rio Negro;2000;10561;4220;6341
1303700;Santo Antônio do Içá;2000;28213;8727;19486
1303809;São Gabriel da Cachoeira;2000;29947;12373;17574
1303908;São Paulo de Olivença;2000;23113;8770;14343
1303957;São Sebastião do Uatumã;2000;7414;4786;2628
1304005;Silves;2000;7785;3363;4422
1304062;Tabatinga;2000;37919;26637;11282
1304104;Tapauá;2000;20595;9414;11181
1304203;Tefé;2000;64457;47698;16759
1304237;Tonantins;2000;15512;4996;10516
1304260;Uarini;2000;10254;3822;6432
1304302;Urucará;2000;18372;8098;10274
1304401;Urucurituba;2000;12264;6759;5505
1400027;Amajari;2000;5294;799;4495
1400050;Alto Alegre;2000;17907;5195;12712
1400100;Boa Vista;2000;200568;197098;3470
1400159;Bonfim;2000;9326;3000;6326
1400175;Cantá;2000;8571;1155;7416
1400209;Caracaraí;2000;14286;8236;6050
1400233;Caroebe;2000;5692;1977;3715
1400282;Iracema;2000;4781;3228;1553
1400308;Mucajaí;2000;11247;7279;3968
1400407;Normandia;2000;6138;1500;4638
1400456;Pacaraima;2000;6990;2760;4230
1400472;Rorainópolis;2000;17393;7729;9664
1400506;São João da Baliza;2000;5091;3882;1209
1400605;São Luiz;2000;5311;3447;1864
1400704;Uiramutã;2000;5802;525;5277
1500107;Abaetetuba;2000;119152;70843;48309
1500131;Abel Figueiredo;2000;5957;4897;1060
1500206;Acará;2000;52126;9745;42381
1500305;Afuá;2000;29505;6782;22723
1500347;Água Azul do Norte;2000;22084;2811;19273
1500404;Alenquer;2000;41784;25160;16624
1500503;Almeirim;2000;33957;18916;15041
1500602;Altamira;2000;77439;62285;15154
1500701;Anajás;2000;18322;4613;13709
1500800;Ananindeua;2000;393569;392627;942
1500859;Anapu;2000;9407;3083;6324
1500909;Augusto Corrêa;2000;33011;13356;19655
1500958;Aurora do Pará;2000;19728;5022;14706
1501006;Aveiro;2000;15518;2940;12578
1501105;Bagre;2000;13708;4395;9313
1501204;Baião;2000;21119;10865;10254
1501253;Bannach;2000;3780;1189;2591
1501303;Barcarena;2000;63268;27767;35501
1501402;Belém;2000;1280614;1272354;8260
1501451;Belterra;2000;14594;5126;9468
1501501;Benevides;2000;35546;20912;14634
1501576;Bom Jesus do Tocantins;2000;13106;6180;6926
1501600;Bonito;2000;9814;2582;7232
1501709;Bragança;2000;93779;56572;37207
1501725;Brasil Novo;2000;17193;4371;12822
1501758;Brejo Grande do Araguaia;2000;7464;4255;3209
1501782;Breu Branco;2000;32446;15952;16494
1501808;Breves;2000;80158;40285;39873
1501907;Bujaru;2000;22508;8143;14364
1501956;Cachoeira do Piriá;2000;15437;2393;13044
1502004;Cachoeira do Arari;2000;16700;5832;10868
1502103;Cametá;2000;97624;40417;57207
1502152;Canaã dos Carajás;2000;10922;3924;6998
1502202;Capanema;2000;57119;46329;10790
1502301;Capitão Poço;2000;50815;21121;29694
1502400;Castanhal;2000;134496;121249;13247
1502509;Chaves;2000;17350;1233;16117
1502608;Colares;2000;10632;3238;7394
1502707;Conceição do Araguaia;2000;43386;29370;14016
1502756;Concórdia do Pará;2000;20956;10848;10108
1502764;Cumaru do Norte;2000;5978;1374;4604
1502772;Curionópolis;2000;19486;13250;6236
1502806;Curralinho;2000;20016;5400;14616
1502855;Curuá;2000;9224;2933;6291
1502905;Curuçá;2000;26160;9422;16738
1502939;Dom Eliseu;2000;39529;23801;15728
1502954;Eldorado do Carajás;2000;29608;14112;15496
1503002;Faro;2000;10037;4918;5119
1503044;Floresta do Araguaia;2000;14284;4874;9410
1503077;Garrafão do Norte;2000;24221;7018;17203
1503093;Goianésia do Pará;2000;22685;14878;7807
1503101;Gurupá;2000;23098;6593;16505
1503200;Igarapé-Açu;2000;32400;19489;12911
1503309;Igarapé-Miri;2000;52604;24983;27621
1503408;Inhangapi;2000;7681;2036;5645
1503457;Ipixuna do Pará;2000;25138;4991;20147
1503507;Irituia;2000;31752;5826;25926
1503606;Itaituba;2000;94750;64486;30264
1503705;Itupiranga;2000;49655;14754;34901
1503754;Jacareacanga;2000;22078;5670;16408
1503804;Jacundá;2000;40546;34518;6028
1503903;Juruti;2000;31198;10780;20418
1504000;Limoeiro do Ajuru;2000;19564;3770;15794
1504059;Mãe do Rio;2000;25351;18738;6613
1504109;Magalhães Barata;2000;7693;4183;3510
1504208;Marabá;2000;168020;134373;33647
1504307;Maracanã;2000;27571;11712;15859
1504406;Marapanim;2000;24718;9490;15228
1504422;Marituba;2000;74429;64884;9545
1504455;Medicilândia;2000;21379;6759;14620
1504505;Melgaço;2000;21064;3180;17884
1504604;Mocajuba;2000;20542;14561;5981
1504703;Moju;2000;52941;17626;35315
1504802;Monte Alegre;2000;61334;20921;40413
1504901;Muaná;2000;25536;7637;17899
1504950;Nova Esperança do Piriá;2000;18893;5255;13638
1504976;Nova Ipixuna;2000;11866;5207;6659
1505007;Nova Timboteua;2000;11406;4985;6421
1505031;Novo Progresso;2000;24948;9151;15797
1505064;Novo Repartimento;2000;41817;15524;26293
1505106;Óbidos;2000;46490;22978;23512
1505205;Oeiras do Pará;2000;23255;7980;15275
1505304;Oriximiná;2000;48332;29181;19151
1505403;Ourém;2000;14397;6516;7881
1505437;Ourilândia do Norte;2000;19471;10988;8483
1505486;Pacajá;2000;28888;7604;21284
1505494;Palestina do Pará;2000;7544;3840;3704
1505502;Paragominas;2000;76450;58240;18210
1505536;Parauapebas;2000;71568;59260;12308
1505551;Pau D'Arco;2000;7124;3212;3912
1505601;Peixe-Boi;2000;7760;3901;3859
1505635;Piçarra;2000;13031;2755;10276
1505650;Placas;2000;13394;3534;9860
1505700;Ponta de Pedras;2000;18694;8641;10053
1505809;Portel;2000;38043;17325;20718
1505908;Porto de Moz;2000;23545;10230;13315
1506005;Prainha;2000;27301;7149;20152
1506104;Primavera;2000;9718;6369;3349
1506112;Quatipuru;2000;10905;4339;6566
1506138;Redenção;2000;63251;59613;3638
1506161;Rio Maria;2000;17498;12840;4658
1506187;Rondon do Pará;2000;39870;30061;9809
1506195;Rurópolis;2000;24660;8419;16241
1506203;Salinópolis;2000;33449;30417;3032
1506302;Salvaterra;2000;15118;8651;6467
1506351;Santa Bárbara do Pará;2000;11378;4009;7369
1506401;Santa Cruz do Arari;2000;5621;2622;2999
1506500;Santa Izabel do Pará;2000;43227;33078;10149
1506559;Santa Luzia do Pará;2000;19400;8442;10958
1506583;Santa Maria das Barreiras;2000;10955;1380;9575
1506609;Santa Maria do Pará;2000;20850;11709;9141
1506708;Santana do Araguaia;2000;31218;17326;13892
1506807;Santarém;2000;262538;186297;76241
1506906;Santarém Novo;2000;5434;1488;3946
1507003;Santo Antônio do Tauá;2000;19835;10388;9447
1507102;São Caetano de Odivelas;2000;15595;6550;9045
1507151;São Domingos do Araguaia;2000;20005;10878;9127
1507201;São Domingos do Capim;2000;27405;5877;21528
1507300;São Félix do Xingu;2000;34621;12530;22091
1507409;São Francisco do Pará;2000;14245;4907;9338
1507458;São Geraldo do Araguaia;2000;27646;11933;15713
1507466;São João da Ponta;2000;4035;1163;2872
1507474;São João de Pirabas;2000;17484;9018;8466
1507508;São João do Araguaia;2000;12247;2413;9834
1507607;São Miguel do Guamá;2000;41366;24457;16909
1507706;São Sebastião da Boa Vista;2000;17664;7180;10484
1507755;Sapucaia;2000;3796;2682;1114
1507805;Senador José Porfírio;2000;15721;5331;10390
1507904;Soure;2000;19958;17303;2655
1507953;Tailândia;2000;38435;28128;10307
1507961;Terra Alta;2000;8261;3692;4569
1507979;Terra Santa;2000;14592;10965;3627
1508001;Tomé-Açu;2000;47404;27314;20090
1508035;Tracuateua;2000;22743;4677;18066
1508050;Trairão;2000;13902;3008;10894
1508084;Tucumã;2000;25309;16496;8813
1508100;Tucuruí;2000;73798;60918;12880
1508126;Ulianópolis;2000;19254;11909;7345
1508159;Uruará;2000;45201;13753;31448
1508209;Vigia;2000;40176;28006;12170
1508308;Viseu;2000;51090;16478;34612
1508357;Vitória do Xingu;2000;11142;3932;7210
1508407;Xinguara;2000;35365;25776;9589
1600055;Serra do Navio;2000;3293;1216;2077
1600105;Amapá;2000;7121;5922;1199
1600154;Pedra Branca do Amapari;2000;4009;1364;2645
1600204;Calçoene;2000;6730;5271;1459
1600212;Cutias;2000;3280;1717;1563
1600238;Ferreira Gomes;2000;3562;2225;1337
1600253;Itaubal;2000;2894;1156;1738
1600279;Laranjal do Jari;2000;28515;26792;1723
1600303;Macapá;2000;283308;273026;10282
1600402;Mazagão;2000;11986;5972;6014
1600501;Oiapoque;2000;12886;7842;5044
1600535;Porto Grande;2000;11042;7374;3668
1600550;Pracuúba;2000;2286;969;1317
1600600;Santana;2000;80439;75849;4590
1600709;Tartarugalzinho;2000;7121;3483;3638
1600808;Vitória do Jari;2000;8560;6880;1680
1700251;Abreulândia;2000;2189;1005;1184
1700301;Aguiarnópolis;2000;3145;2304;841
1700350;Aliança do Tocantins;2000;6177;5120;1057
1700400;Almas;2000;8474;5572;2902
1700707;Alvorada;2000;8508;7842;666
1701002;Ananás;2000;10512;8396;2116
1701051;Angico;2000;2889;1639;1250
1701101;Aparecida do Rio Negro;2000;3517;2774;743
1701309;Aragominas;2000;6180;2383;3797
1701903;Araguacema;2000;5414;3032;2382
1702000;Araguaçu;2000;9346;6434;2912
1702109;Araguaína;2000;113143;105874;7269
1702158;Araguanã;2000;4262;2653;1609
1702208;Araguatins;2000;26010;16577;9433
1702307;Arapoema;2000;7025;5087;1938
1702406;Arraias;2000;10984;6136;4848
1702554;Augustinópolis;2000;12964;10227;2737
1702703;Aurora do Tocantins;2000;3101;1960;1141
1702901;Axixá do Tocantins;2000;8827;7560;1267
1703008;Babaçulândia;2000;10688;4235;6453
1703057;Bandeirantes do Tocantins;2000;2608;1203;1405
1703073;Barra do Ouro;2000;3579;1286;2293
1703107;Barrolândia;2000;5082;4188;894
1703206;Bernardo Sayão;2000;4551;1855;2696
1703305;Bom Jesus do Tocantins;2000;2323;1130;1193
1703602;Brasilândia do Tocantins;2000;1923;1212;711
1703701;Brejinho de Nazaré;2000;4877;3827;1050
1703800;Buriti do Tocantins;2000;7842;6116;1726
1703826;Cachoeirinha;2000;2023;1765;258
1703842;Campos Lindos;2000;5638;2209;3429
1703867;Cariri do Tocantins;2000;2990;1942;1048
1703883;Carmolândia;2000;2008;1550;458
1703891;Carrasco Bonito;2000;3218;1573;1645
1703909;Caseara;2000;3660;2746;914
1704105;Centenário;2000;2163;761;1402
1704600;Chapada de Areia;2000;1270;667;603
1705102;Chapada da Natividade;2000;3274;1419;1855
1705508;Colinas do Tocantins;2000;25301;24114;1187
1705557;Combinado;2000;4524;3761;763
1705607;Conceição do Tocantins;2000;4377;2335;2042
1706001;Couto Magalhães;2000;4335;1835;2500
1706100;Cristalândia;2000;7318;6713;605
1706258;Crixás do Tocantins;2000;1384;837;547
1706506;Darcinópolis;2000;4273;2415;1858
1707009;Dianópolis;2000;15428;12616;2812
1707108;Divinópolis do Tocantins;2000;5776;3987;1789
1707207;Dois Irmãos do Tocantins;2000;7269;2388;4881
1707306;Dueré;2000;4565;2954;1611
1707405;Esperantina;2000;7623;3552;4071
1707553;Fátima;2000;3848;3316;532
1707652;Figueirópolis;2000;5562;4169;1393
1707702;Filadélfia;2000;8218;4043;4175
1708205;Formoso do Araguaia;2000;18817;13258;5559
1708254;Fortaleza do Tabocão;2000;2242;1606;636
1708304;Goianorte;2000;4839;2257;2582
1709005;Goiatins;2000;11036;4241;6795
1709302;Guaraí;2000;20018;17587;2431
1709500;Gurupi;2000;65034;63486;1548
1709807;Ipueiras;2000;1166;586;580
1710508;Itacajá;2000;6815;3627;3188
1710706;Itaguatins;2000;6386;3270;3116
1710904;Itapiratins;2000;3277;1318;1959
1711100;Itaporã do Tocantins;2000;2522;1862;660
1711506;Jaú do Tocantins;2000;3121;1141;1980
1711803;Juarina;2000;2333;1297;1036
1711902;Lagoa da Confusão;2000;6168;3486;2682
1711951;Lagoa do Tocantins;2000;2530;1903;627
1712009;Lajeado;2000;2344;1583;761
1712157;Lavandeira;2000;1209;763;446
1712405;Lizarda;2000;3787;1923;1864
1712454;Luzinópolis;2000;2021;1352;669
1712504;Marianópolis do Tocantins;2000;3332;2025;1307
1712702;Mateiros;2000;1646;869;777
1712801;Maurilândia do Tocantins;2000;2854;1579;1275
1713205;Miracema do Tocantins;2000;24444;20151;4293
1713304;Miranorte;2000;11802;10702;1100
1713601;Monte do Carmo;2000;5193;2326;2867
1713700;Monte Santo do Tocantins;2000;1869;475;1394
1713809;Palmeiras do Tocantins;2000;4622;2572;2050
1713957;Muricilândia;2000;2680;1725;955
1714203;Natividade;2000;8867;6399;2468
1714302;Nazaré;2000;5150;2003;3147
1714880;Nova Olinda;2000;9385;6128;3257
1715002;Nova Rosalândia;2000;3190;2476;714
1715101;Novo Acordo;2000;3057;1968;1089
1715150;Novo Alegre;2000;2274;1806;468
1715259;Novo Jardim;2000;2151;1373;778
1715507;Oliveira de Fátima;2000;958;698;260
1715705;Palmeirante;2000;3610;1363;2247
1715754;Palmeirópolis;2000;7068;5324;1744
1716109;Paraíso do Tocantins;2000;36130;34379;1751
1716208;Paranã;2000;10416;2833;7583
1716307;Pau D'Arco;2000;4335;2757;1578
1716505;Pedro Afonso;2000;9028;7328;1700
1716604;Peixe;2000;8763;3672;5091
1716653;Pequizeiro;2000;4591;2040;2551
1716703;Colméia;2000;9352;6192;3160
1717008;Pindorama do Tocantins;2000;4685;2324;2361
1717206;Piraquê;2000;2524;1179;1345
1717503;Pium;2000;5540;3194;2346
1717800;Ponte Alta do Bom Jesus;2000;4574;2464;2110
1717909;Ponte Alta do Tocantins;2000;6172;3276;2896
1718006;Porto Alegre do Tocantins;2000;2393;1566;827
1718204;Porto Nacional;2000;44991;38766;6225
1718303;Praia Norte;2000;6781;3475;3306
1718402;Presidente Kennedy;2000;3759;3119;640
1718451;Pugmil;2000;1989;1566;423
1718501;Recursolândia;2000;3138;1256;1882
1718550;Riachinho;2000;3670;1567;2103
1718659;Rio da Conceição;2000;1189;998;191
1718709;Rio dos Bois;2000;2269;1410;859
1718758;Rio Sono;2000;6089;1871;4218
1718808;Sampaio;2000;2801;2371;430
1718840;Sandolândia;2000;3332;1459;1873
1718865;Santa Fé do Araguaia;2000;5507;3368;2139
1718881;Santa Maria do Tocantins;2000;2226;1127;1099
1718899;Santa Rita do Tocantins;2000;1852;656;1196
1718907;Santa Rosa do Tocantins;2000;4316;2938;1378
1719004;Santa Tereza do Tocantins;2000;2114;1289;825
1720002;Santa Terezinha do Tocantins;2000;2455;1526;929
1720101;São Bento do Tocantins;2000;3738;2178;1560
1720150;São Félix do Tocantins;2000;1269;531;738
1720200;São Miguel do Tocantins;2000;8486;1910;6576
1720259;São Salvador do Tocantins;2000;2740;957;1783
1720309;São Sebastião do Tocantins;2000;3669;2761;908
1720499;São Valério;2000;5054;2138;2916
1720655;Silvanópolis;2000;4725;3451;1274
1720804;Sítio Novo do Tocantins;2000;9488;4756;4732
1720853;Sucupira;2000;1476;864;612
1720903;Taguatinga;2000;13169;8160;5009
1720937;Taipas do Tocantins;2000;1713;1103;610
1720978;Talismã;2000;2306;980;1326
1721000;Palmas;2000;137355;134179;3176
1721109;Tocantínia;2000;5788;2980;2808
1721208;Tocantinópolis;2000;22777;18878;3899
1721257;Tupirama;2000;1179;479;700
1721307;Tupiratins;2000;1365;729;636
1722081;Wanderlândia;2000;10273;5273;5000
1722107;Xambioá;2000;12137;9677;2460
2100055;Açailândia;2000;88320;64164;24156
2100105;Afonso Cunha;2000;4680;2255;2425
2100154;Água Doce do Maranhão;2000;9703;2455;7248
2100204;Alcântara;2000;21291;5665;15626
2100303;Aldeias Altas;2000;18827;7375;11452
2100402;Altamira do Maranhão;2000;8865;2894;5971
2100436;Alto Alegre do Maranhão;2000;20162;12997;7165
2100477;Alto Alegre do Pindaré;2000;30177;7909;22268
2100501;Alto Parnaíba;2000;10174;6038;4136
2100550;Amapá do Maranhão;2000;5431;3979;1452
2100600;Amarante do Maranhão;2000;31292;10818;20474
2100709;Anajatuba;2000;22978;5992;16986
2100808;Anapurus;2000;10280;4601;5679
2100832;Apicum-Açu;2000;11099;5553;5546
2100873;Araguanã;2000;9123;3899;5224
2100907;Araioses;2000;34906;9134;25772
2100956;Arame;2000;30163;11461;18702
2101004;Arari;2000;26366;15453;10913
2101103;Axixá;2000;10142;1202;8940
2101202;Bacabal;2000;91823;71408;20415
2101251;Bacabeira;2000;10516;1892;8624
2101301;Bacuri;2000;15531;7649;7882
2101350;Bacurituba;2000;4671;1139;3532
2101400;Balsas;2000;60163;50144;10019
2101509;Barão de Grajaú;2000;15371;7694;7677
2101608;Barra do Corda;2000;78147;43412;34735
2101707;Barreirinhas;2000;39669;13209;26460
2101731;Belágua;2000;5253;1829;3424
2101772;Bela Vista do Maranhão;2000;9900;3464;6436
2101806;Benedito Leite;2000;5288;2259;3029
2101905;Bequimão;2000;19700;5148;14552
2101939;Bernardo do Mearim;2000;5239;1546;3693
2101970;Boa Vista do Gurupi;2000;5128;4077;1051
2102002;Bom Jardim;2000;35395;12126;23269
2102036;Bom Jesus das Selvas;2000;16545;7967;8578
2102077;Bom Lugar;2000;11534;1929;9605
2102101;Brejo;2000;27513;10656;16857
2102150;Brejo de Areia;2000;10418;2181;8237
2102200;Buriti;2000;24126;7195;16931
2102309;Buriti Bravo;2000;21446;14886;6560
2102325;Buriticupu;2000;51341;26017;25324
2102358;Buritirana;2000;13822;3784;10038
2102374;Cachoeira Grande;2000;7383;2852;4531
2102408;Cajapió;2000;9622;2853;6769
2102507;Cajari;2000;13405;3543;9862
2102556;Campestre do Maranhão;2000;11521;8591;2930
2102606;Cândido Mendes;2000;16901;9492;7409
2102705;Cantanhede;2000;17713;8526;9187
2102754;Capinzal do Norte;2000;10656;4024;6632
2102804;Carolina;2000;23991;14362;9629
2102903;Carutapera;2000;19262;13138;6124
2103000;Caxias;2000;139756;103485;36271
2103109;Cedral;2000;9793;1976;7817
2103125;Central do Maranhão;2000;7186;3013;4173
2103158;Centro do Guilherme;2000;6152;3401;2751
2103174;Centro Novo do Maranhão;2000;14554;3127;11427
2103208;Chapadinha;2000;61322;37231;24091
2103257;Cidelândia;2000;11816;4623;7193
2103307;Codó;2000;111146;75093;36053
2103406;Coelho Neto;2000;42214;34747;7467
2103505;Colinas;2000;35803;20821;14982
2103554;Conceição do Lago-Açu;2000;10774;5252;5522
2103604;Coroatá;2000;55676;33419;22257
2103703;Cururupu;2000;33747;21468;12279
2103752;Davinópolis;2000;12275;10231;2044
2103802;Dom Pedro;2000;21956;14037;7919
2103901;Duque Bacelar;2000;9413;4190;5223
2104008;Esperantinópolis;2000;21224;9823;11401
2104057;Estreito;2000;22930;15846;7084
2104073;Feira Nova do Maranhão;2000;7543;1030;6513
2104081;Fernando Falcão;2000;4823;800;4023
2104099;Formosa da Serra Negra;2000;13781;2189;11592
2104107;Fortaleza dos Nogueiras;2000;11301;5925;5376
2104206;Fortuna;2000;14596;9128;5468
2104305;Godofredo Viana;2000;6994;4341;2653
2104404;Gonçalves Dias;2000;16790;7527;9263
2104503;Governador Archer;2000;9100;5858;3242
2104552;Governador Edison Lobão;2000;10891;3867;7024
2104602;Governador Eugênio Barros;2000;14629;4245;10384
2104628;Governador Luiz Rocha;2000;6513;4330;2183
2104651;Governador Newton Bello;2000;11804;2678;9126
2104677;Governador Nunes Freire;2000;25921;14102;11819
2104701;Graça Aranha;2000;6080;2998;3082
2104800;Grajaú;2000;47155;26511;20644
2104909;Guimarães;2000;12641;5259;7382
2105005;Humberto de Campos;2000;21266;6240;15026
2105104;Icatu;2000;21489;6272;15217
2105153;Igarapé do Meio;2000;9842;3912;5930
2105203;Igarapé Grande;2000;9759;6044;3715
2105302;Imperatriz;2000;230566;218673;11893
2105351;Itaipava do Grajaú;2000;13341;1125;12216
2105401;Itapecuru Mirim;2000;42772;27661;15111
2105427;Itinga do Maranhão;2000;23128;17401;5727
2105450;Jatobá;2000;5055;2061;2994
2105476;Jenipapo dos Vieiras;2000;10119;2177;7942
2105500;João Lisboa;2000;24598;15307;9291
2105609;Joselândia;2000;14609;4417;10192
2105658;Junco do Maranhão;2000;5533;2566;2967
2105708;Lago da Pedra;2000;40405;24048;16357
2105807;Lago do Junco;2000;9833;2840;6993
2105906;Lago Verde;2000;13038;4713;8325
2105922;Lagoa do Mato;2000;9446;2695;6751
2105948;Lago dos Rodrigues;2000;8443;4480;3963
2105963;Lagoa Grande do Maranhão;2000;8469;2862;5607
2105989;Lajeado Novo;2000;5717;1978;3739
2106003;Lima Campos;2000;10749;6128;4621
2106102;Loreto;2000;10024;4819;5205
2106201;Luís Domingues;2000;5724;4693;1031
2106300;Magalhães de Almeida;2000;13021;6279;6742
2106326;Maracaçumé;2000;14866;12691;2175
2106359;Marajá do Sena;2000;7161;717;6444
2106375;Maranhãozinho;2000;8445;4951;3494
2106409;Mata Roma;2000;11799;5235;6564
2106508;Matinha;2000;20046;6905;13141
2106607;Matões;2000;26433;9479;16954
2106631;Matões do Norte;2000;7435;2174;5261
2106672;Milagres do Maranhão;2000;5149;1399;3750
2106706;Mirador;2000;19906;6992;12914
2106755;Miranda do Norte;2000;16123;13611;2512
2106805;Mirinzal;2000;13005;7812;5193
2106904;Monção;2000;26043;9002;17041
2107001;Montes Altos;2000;10347;4825;5522
2107100;Morros;2000;14594;4946;9648
2107209;Nina Rodrigues;2000;8289;3363;4926
2107258;Nova Colinas;2000;3904;1561;2343
2107308;Nova Iorque;2000;4543;2597;1946
2107357;Nova Olinda do Maranhão;2000;15660;9398;6262
2107407;Olho d'Água das Cunhãs;2000;14377;8441;5936
2107456;Olinda Nova do Maranhão;2000;10128;3415;6713
2107506;Paço do Lumiar;2000;76188;1188;75000
2107605;Palmeirândia;2000;17264;3208;14056
2107704;Paraibano;2000;17854;12827;5027
2107803;Parnarama;2000;32469;11007;21462
2107902;Passagem Franca;2000;14817;7012;7805
2108009;Pastos Bons;2000;15460;9160;6300
2108058;Paulino Neves;2000;11526;3413;8113
2108108;Paulo Ramos;2000;19290;8627;10663
2108207;Pedreiras;2000;39828;31732;8096
2108256;Pedro do Rosário;2000;17954;2937;15017
2108306;Penalva;2000;30299;12624;17675
2108405;Peri Mirim;2000;13071;3153;9918
2108454;Peritoró;2000;17336;6527;10809
2108504;Pindaré-Mirim;2000;27517;20941;6576
2108603;Pinheiro;2000;68030;38186;29844
2108702;Pio XII;2000;28413;12944;15469
2108801;Pirapemas;2000;15124;9195;5929
2108900;Poção de Pedras;2000;22378;9864;12514
2109007;Porto Franco;2000;16840;12618;4222
2109056;Porto Rico do Maranhão;2000;6380;2530;3850
2109106;Presidente Dutra;2000;39541;27505;12036
2109205;Presidente Juscelino;2000;10693;2715;7978
2109239;Presidente Médici;2000;5116;3377;1739
2109270;Presidente Sarney;2000;13718;3242;10476
2109304;Presidente Vargas;2000;11724;3584;8140
2109403;Primeira Cruz;2000;11019;3759;7260
2109452;Raposa;2000;17088;11370;5718
2109502;Riachão;2000;20983;9095;11888
2109551;Ribamar Fiquene;2000;6488;2744;3744
2109601;Rosário;2000;33665;21765;11900
2109700;Sambaíba;2000;5261;2295;2966
2109759;Santa Filomena do Maranhão;2000;4667;1642;3025
2109809;Santa Helena;2000;30860;15105;15755
2109908;Santa Inês;2000;68321;63030;5291
2110005;Santa Luzia;2000;69271;21264;48007
2110039;Santa Luzia do Paruá;2000;20058;10676;9382
2110104;Santa Quitéria do Maranhão;2000;28150;11499;16651
2110203;Santa Rita;2000;24922;9666;15256
2110237;Santana do Maranhão;2000;10944;1340;9604
2110278;Santo Amaro do Maranhão;2000;9612;2933;6679
2110302;Santo Antônio dos Lopes;2000;14253;5337;8916
2110401;São Benedito do Rio Preto;2000;16442;9368;7074
2110500;São Bento;2000;31819;16760;15059
2110609;São Bernardo;2000;22720;8764;13956
2110658;São Domingos do Azeitão;2000;6289;4079;2210
2110708;São Domingos do Maranhão;2000;33049;15980;17069
2110807;São Félix de Balsas;2000;5144;1283;3861
2110856;São Francisco do Brejão;2000;7062;3833;3229
2110906;São Francisco do Maranhão;2000;12854;3205;9649
2111003;São João Batista;2000;19497;3753;15744
2111029;São João do Carú;2000;13495;3155;10340
2111052;São João do Paraíso;2000;10365;3829;6536
2111078;São João do Soter;2000;14834;4442;10392
2111102;São João dos Patos;2000;23182;18817;4365
2111201;São José de Ribamar;2000;107384;27245;80139
2111250;São José dos Basílios;2000;7432;2713;4719
2111300;São Luís;2000;870028;837584;32444
2111409;São Luís Gonzaga do Maranhão;2000;23230;7115;16116
2111508;São Mateus do Maranhão;2000;34859;25970;8889
2111532;São Pedro da Água Branca;2000;10927;9459;1468
2111573;São Pedro dos Crentes;2000;4197;1692;2505
2111607;São Raimundo das Mangabeiras;2000;14870;9720;5150
2111631;São Raimundo do Doca Bezerra;2000;6671;1486;5185
2111672;São Roberto;2000;4400;2463;1937
2111706;São Vicente Ferrer;2000;18406;3977;14429
2111722;Satubinha;2000;10995;2270;8725
2111748;Senador Alexandre Costa;2000;8571;4944;3627
2111763;Senador La Rocque;2000;16242;7965;8277
2111789;Serrano do Maranhão;2000;9120;2918;6202
2111805;Sítio Novo;2000;15114;4249;10865
2111904;Sucupira do Norte;2000;10378;3832;6546
2111953;Sucupira do Riachão;2000;4287;2133;2154
2112001;Tasso Fragoso;2000;6393;3034;3359
2112100;Timbiras;2000;26401;13954;12447
2112209;Timon;2000;129692;113066;16626
2112233;Trizidela do Vale;2000;16402;14329;2073
2112274;Tufilândia;2000;5527;2049;3478
2112308;Tuntum;2000;35411;16424;18987
2112407;Turiaçu;2000;31289;8489;22800
2112456;Turilândia;2000;17231;6929;10302
2112506;Tutóia;2000;37728;11589;26139
2112605;Urbano Santos;2000;17603;10906;6697
2112704;Vargem Grande;2000;34707;17116;17591
2112803;Viana;2000;44190;22996;21194
2112852;Vila Nova dos Martírios;2000;6705;3108;3597
2112902;Vitória do Mearim;2000;29953;13492;16461
2113009;Vitorino Freire;2000;27462;13594;13868
2114007;Zé Doca;2000;46134;29082;17052
2200053;Acauã;2000;5147;754;4393
2200103;Agricolândia;2000;5340;3942;1398
2200202;Água Branca;2000;14517;13075;1442
2200251;Alagoinha do Piauí;2000;6868;1948;4920
2200277;Alegrete do Piauí;2000;4713;2662;2051
2200301;Alto Longá;2000;12000;5604;6396
2200400;Altos;2000;39122;26199;12923
2200459;Alvorada do Gurguéia;2000;4211;1479;2732
2200509;Amarante;2000;16884;9112;7772
2200608;Angical do Piauí;2000;6788;5065;1723
2200707;Anísio de Abreu;2000;7166;3291;3875
2200806;Antônio Almeida;2000;2851;1886;965
2200905;Aroazes;2000;6025;3171;2854
2201002;Arraial;2000;4909;2495;2414
2201051;Assunção do Piauí;2000;6933;2832;4101
2201101;Avelino Lopes;2000;9625;5118;4507
2201150;Baixa Grande do Ribeiro;2000;7779;3656;4123
2201176;Barra D'Alcântara;2000;4107;1615;2492
2201200;Barras;2000;40891;18809;22082
2201309;Barreiras do Piauí;2000;3098;1495;1603
2201408;Barro Duro;2000;6787;5029;1758
2201507;Batalha;2000;24127;7930;16197
2201556;Bela Vista do Piauí;2000;2963;758;2205
2201572;Belém do Piauí;2000;2429;929;1500
2201606;Beneditinos;2000;9712;5214;4498
2201705;Bertolínia;2000;5117;3459;1658
2201739;Betânia do Piauí;2000;8640;1029;7611
2201770;Boa Hora;2000;5170;1023;4147
2201804;Bocaina;2000;4261;1493;2768
2201903;Bom Jesus;2000;15924;10961;4963
2201919;Bom Princípio do Piauí;2000;4625;1216;3409
2201929;Bonfim do Piauí;2000;4881;1159;3722
2201945;Boqueirão do Piauí;2000;5567;1877;3690
2201960;Brasileira;2000;7366;2926;4440
2201988;Brejo do Piauí;2000;3986;1194;2792
2202000;Buriti dos Lopes;2000;18598;9332;9266
2202026;Buriti dos Montes;2000;7284;1845;5439
2202059;Cabeceiras do Piauí;2000;8498;1389;7109
2202075;Cajazeiras do Piauí;2000;2667;866;1801
2202083;Cajueiro da Praia;2000;6122;2124;3998
2202091;Caldeirão Grande do Piauí;2000;5481;1311;4170
2202109;Campinas do Piauí;2000;5141;1544;3597
2202117;Campo Alegre do Fidalgo;2000;4451;410;4041
2202133;Campo Grande do Piauí;2000;4882;1180;3702
2202174;Campo Largo do Piauí;2000;5743;1044;4699
2202208;Campo Maior;2000;43126;31928;11198
2202251;Canavieira;2000;4114;1854;2260
2202307;Canto do Buriti;2000;18371;10154;8217
2202406;Capitão de Campos;2000;10036;5641;4395
2202455;Capitão Gervásio Oliveira;2000;3492;358;3134
2202505;Caracol;2000;8040;3013;5027
2202539;Caraúbas do Piauí;2000;4809;635;4174
2202554;Caridade do Piauí;2000;4062;1091;2971
2202604;Castelo do Piauí;2000;18339;9242;9097
2202653;Caxingó;2000;4147;927;3220
2202703;Cocal;2000;24150;10647;13503
2202711;Cocal de Telha;2000;4248;2234;2014
2202729;Cocal dos Alves;2000;5155;1334;3821
2202737;Coivaras;2000;3507;875;2632
2202752;Colônia do Gurguéia;2000;5012;3886;1126
2202778;Colônia do Piauí;2000;7251;2650;4601
2202802;Conceição do Canindé;2000;4926;2607;2319
2202851;Coronel José Dias;2000;4415;1013;3402
2202901;Corrente;2000;23226;12552;10674
2203008;Cristalândia do Piauí;2000;6493;2309;4184
2203107;Cristino Castro;2000;9269;6170;3099
2203206;Curimatá;2000;9518;5267;4251
2203230;Currais;2000;4232;701;3531
2203255;Curralinhos;2000;3641;797;2844
2203271;Curral Novo do Piauí;2000;4220;1050;3170
2203305;Demerval Lobão;2000;12489;10254;2235
2203354;Dirceu Arcoverde;2000;6066;1855;4211
2203404;Dom Expedito Lopes;2000;5954;3335;2619
2203420;Domingos Mourão;2000;4284;950;3334
2203453;Dom Inocêncio;2000;8909;856;8053
2203503;Elesbão Veloso;2000;15002;10133;4869
2203602;Eliseu Martins;2000;4188;2801;1387
2203701;Esperantina;2000;34094;20748;13346
2203750;Fartura do Piauí;2000;4685;895;3790
2203800;Flores do Piauí;2000;4372;1753;2619
2203859;Floresta do Piauí;2000;2416;586;1830
2203909;Floriano;2000;54591;46684;7907
2204006;Francinópolis;2000;5254;3122;2132
2204105;Francisco Ayres;2000;5236;2375;2861
2204154;Francisco Macedo;2000;2337;609;1728
2204204;Francisco Santos;2000;7043;3354;3689
2204303;Fronteiras;2000;10012;5746;4266
2204352;Geminiano;2000;4790;839;3951
2204402;Gilbués;2000;10229;4521;5708
2204501;Guadalupe;2000;10308;9596;712
2204550;Guaribas;2000;4814;898;3916
2204600;Hugo Napoleão;2000;3703;2945;758
2204659;Ilha Grande;2000;7890;6505;1385
2204709;Inhuma;2000;14426;6614;7812
2204808;Ipiranga do Piauí;2000;8428;4981;3447
2204907;Isaías Coelho;2000;7658;1693;5965
2205003;Itainópolis;2000;10381;2572;7809
2205102;Itaueira;2000;10347;5125;5222
2205151;Jacobina do Piauí;2000;5690;851;4839
2205201;Jaicós;2000;15859;7375;8484
2205250;Jardim do Mulato;2000;3990;1169;2821
2205276;Jatobá do Piauí;2000;4314;657;3657
2205300;Jerumenha;2000;4515;2850;1665
2205359;João Costa;2000;3025;453;2572
2205409;Joaquim Pires;2000;13076;3670;9406
2205458;Joca Marques;2000;4349;1109;3240
2205508;José de Freitas;2000;32858;18110;14748
2205516;Juazeiro do Piauí;2000;4523;970;3553
2205524;Júlio Borges;2000;4866;936;3930
2205532;Jurema;2000;4047;498;3549
2205540;Lagoinha do Piauí;2000;2231;1033;1198
2205557;Lagoa Alegre;2000;6849;2337;4512
2205565;Lagoa do Barro do Piauí;2000;4450;910;3540
2205573;Lagoa de São Francisco;2000;5795;1684;4111
2205581;Lagoa do Piauí;2000;3488;939;2549
2205599;Lagoa do Sítio;2000;4138;1590;2548
2205607;Landri Sales;2000;5628;3864;1764
2205706;Luís Correia;2000;24253;10297;13956
2205805;Luzilândia;2000;24042;13453;10589
2205854;Madeiro;2000;6771;2544;4227
2205904;Manoel Emídio;2000;5151;2566;2585
2205953;Marcolândia;2000;6178;4748;1430
2206001;Marcos Parente;2000;4279;3128;1151
2206050;Massapê do Piauí;2000;5988;771;5217
2206100;Matias Olímpio;2000;9727;4210;5517
2206209;Miguel Alves;2000;29849;9609;20240
2206308;Miguel Leão;2000;1370;749;621
2206357;Milton Brandão;2000;6900;1591;5309
2206407;Monsenhor Gil;2000;10309;4529;5780
2206506;Monsenhor Hipólito;2000;6764;2630;4134
2206605;Monte Alegre do Piauí;2000;10230;2672;7558
2206654;Morro Cabeça no Tempo;2000;4426;704;3722
2206670;Morro do Chapéu do Piauí;2000;6006;1648;4358
2206696;Murici dos Portelas;2000;6375;1002;5373
2206704;Nazaré do Piauí;2000;7805;3331;4474
2206753;Nossa Senhora de Nazaré;2000;3726;1618;2108
2206803;Nossa Senhora dos Remédios;2000;7214;2705;4509
2206902;Novo Oriente do Piauí;2000;6760;3181;3579
2206951;Novo Santo Antônio;2000;3155;307;2848
2207009;Oeiras;2000;33910;19629;14281
2207108;Olho D'Água do Piauí;2000;2283;943;1340
2207207;Padre Marcos;2000;7283;2553;4730
2207306;Paes Landim;2000;4184;2324;1860
2207355;Pajeú do Piauí;2000;2894;1290;1604
2207405;Palmeira do Piauí;2000;5199;1414;3785
2207504;Palmeirais;2000;12154;4381;7773
2207553;Paquetá;2000;4386;498;3888
2207603;Parnaguá;2000;9345;4052;5293
2207702;Parnaíba;2000;132282;124988;7294
2207751;Passagem Franca do Piauí;2000;4195;2134;2061
2207777;Patos do Piauí;2000;5634;1200;4434
2207801;Paulistana;2000;16529;8939;7590
2207850;Pavussu;2000;3973;1721;2252
2207900;Pedro II;2000;36201;20917;15284
2207934;Pedro Laurentino;2000;2002;352;1650
2207959;Nova Santa Rita;2000;4150;339;3811
2208007;Picos;2000;68974;52547;16427
2208106;Pimenteiras;2000;11306;4152;7154
2208205;Pio IX;2000;16505;4278;12227
2208304;Piracuruca;2000;24786;17881;6905
2208403;Piripiri;2000;60154;43537;16617
2208502;Porto;2000;10573;6695;3878
2208551;Porto Alegre do Piauí;2000;2421;1201;1220
2208601;Prata do Piauí;2000;3117;2390;727
2208650;Queimada Nova;2000;8332;729;7603
2208700;Redenção do Gurguéia;2000;7781;4679;3102
2208809;Regeneração;2000;17471;13241;4230
2208858;Riacho Frio;2000;4321;1510;2811
2208874;Ribeira do Piauí;2000;3879;523;3356
2208908;Ribeiro Gonçalves;2000;5722;2990;2732
2209005;Rio Grande do Piauí;2000;6131;3967;2164
2209104;Santa Cruz do Piauí;2000;5776;3788;1988
2209153;Santa Cruz dos Milagres;2000;3334;1737;1597
2209203;Santa Filomena;2000;6031;2521;3510
2209302;Santa Luz;2000;4780;2628;2152
2209351;Santana do Piauí;2000;4595;1753;2842
2209377;Santa Rosa do Piauí;2000;5223;3452;1771
2209401;Santo Antônio de Lisboa;2000;5154;3364;1790
2209450;Santo Antônio dos Milagres;2000;1876;622;1254
2209500;Santo Inácio do Piauí;2000;3447;1904;1543
2209559;São Braz do Piauí;2000;4192;935;3257
2209609;São Félix do Piauí;2000;3397;1762;1635
2209658;São Francisco de Assis do Piauí;2000;3806;705;3101
2209708;São Francisco do Piauí;2000;6442;1787;4655
2209757;São Gonçalo do Gurguéia;2000;2322;873;1449
2209807;São Gonçalo do Piauí;2000;4249;3266;983
2209856;São João da Canabrava;2000;4240;1245;2995
2209872;São João da Fronteira;2000;4886;1613;3273
2209906;São João da Serra;2000;6675;3163;3512
2209955;São João da Varjota;2000;4375;1055;3320
2209971;São João do Arraial;2000;5734;2324;3410
2210003;São João do Piauí;2000;17670;11353;6317
2210052;São José do Divino;2000;4881;2195;2686
2210102;São José do Peixe;2000;3825;1891;1934
2210201;São José do Piauí;2000;6706;1898;4808
2210300;São Julião;2000;5700;2134;3566
2210359;São Lourenço do Piauí;2000;4274;691;3583
2210375;São Luis do Piauí;2000;2488;594;1894
2210383;São Miguel da Baixa Grande;2000;2030;1247;783
2210391;São Miguel do Fidalgo;2000;2991;933;2058
2210409;São Miguel do Tapuio;2000;18808;6595;12213
2210508;São Pedro do Piauí;2000;12510;7103;5407
2210607;São Raimundo Nonato;2000;26890;17202;9688
2210623;Sebastião Barros;2000;4524;305;4219
2210631;Sebastião Leal;2000;3835;1408;2427
2210656;Sigefredo Pacheco;2000;9046;2306;6740
2210706;Simões;2000;13621;4542;9079
2210805;Simplício Mendes;2000;10966;6673;4293
2210904;Socorro do Piauí;2000;4675;1517;3158
2210938;Sussuapara;2000;5042;1191;3851
2210953;Tamboril do Piauí;2000;2413;1034;1379
2210979;Tanque do Piauí;2000;2318;958;1360
2211001;Teresina;2000;715360;677470;37890
2211100;União;2000;39801;16089;23712
2211209;Uruçuí;2000;17011;11112;5899
2211308;Valença do Piauí;2000;19887;14110;5777
2211357;Várzea Branca;2000;5203;849;4354
2211407;Várzea Grande;2000;4475;2647;1828
2211506;Vera Mendes;2000;2907;586;2321
2211605;Vila Nova do Piauí;2000;2906;500;2406
2211704;Wall Ferraz;2000;3983;979;3004
2300101;Abaiara;2000;8385;3208;5177
2300150;Acarape;2000;12927;7025;5902
2300200;Acaraú;2000;48968;24582;24386
2300309;Acopiara;2000;47137;22230;24907
2300408;Aiuaba;2000;14452;2838;11614
2300507;Alcântaras;2000;9548;2762;6786
2300606;Altaneira;2000;5687;3787;1900
2300705;Alto Santo;2000;15394;5447;9947
2300754;Amontada;2000;32333;11802;20531
2300804;Antonina do Norte;2000;6509;4429;2080
2300903;Apuiarés;2000;12540;5453;7087
2301000;Aquiraz;2000;60469;54682;5787
2301109;Aracati;2000;61187;39179;22008
2301208;Aracoiaba;2000;24064;12205;11859
2301257;Ararendá;2000;10008;4075;5933
2301307;Araripe;2000;19606;10151;9455
2301406;Aratuba;2000;12359;2157;10202
2301505;Arneiroz;2000;7538;2146;5392
2301604;Assaré;2000;20882;9428;11454
2301703;Aurora;2000;25207;10080;15127
2301802;Baixio;2000;5830;2585;3245
2301851;Banabuiú;2000;16173;7622;8551
2301901;Barbalha;2000;47031;30669;16362
2301950;Barreira;2000;17024;6375;10649
2302008;Barro;2000;20007;10866;9141
2302057;Barroquinha;2000;13921;9096;4825
2302107;Baturité;2000;29861;20846;9015
2302206;Beberibe;2000;42343;19697;22646
2302305;Bela Cruz;2000;28358;11585;16773
2302404;Boa Viagem;2000;50306;20546;29760
2302503;Brejo Santo;2000;38484;22678;15806
2302602;Camocim;2000;55448;40684;14764
2302701;Campos Sales;2000;25566;17135;8431
2302800;Canindé;2000;69601;39573;30028
2302909;Capistrano;2000;15830;5252;10578
2303006;Caridade;2000;15604;8381;7223
2303105;Cariré;2000;18617;5459;13158
2303204;Caririaçu;2000;25733;10618;15115
2303303;Cariús;2000;18444;7170;11274
2303402;Carnaubal;2000;15230;6925;8305
2303501;Cascavel;2000;57129;47453;9676
2303600;Catarina;2000;15547;6465;9082
2303659;Catunda;2000;9286;4068;5218
2303709;Caucaia;2000;250479;226088;24391
2303808;Cedro;2000;24062;13501;10561
2303907;Chaval;2000;12163;8497;3666
2303931;Choró;2000;12001;2849;9152
2303956;Chorozinho;2000;18707;9469;9238
2304004;Coreaú;2000;19981;11263;8718
2304103;Crateús;2000;70898;47549;23349
2304202;Crato;2000;104646;83917;20729
2304236;Croatá;2000;16064;7298;8766
2304251;Cruz;2000;19779;8218;11561
2304269;Deputado Irapuan Pinheiro;2000;8385;2721;5664
2304277;Ererê;2000;6302;2262;4040
2304285;Eusébio;2000;31500;31500;0
2304301;Farias Brito;2000;20315;8726;11589
2304350;Forquilha;2000;17488;11619;5869
2304400;Fortaleza;2000;2141402;2141402;0
2304459;Fortim;2000;12066;8610;3456
2304509;Frecheirinha;2000;11832;6459;5373
2304608;General Sampaio;2000;4866;2316;2550
2304657;Graça;2000;14813;4838;9975
2304707;Granja;2000;48484;22564;25920
2304806;Granjeiro;2000;5295;1234;4061
2304905;Groaíras;2000;8741;5588;3153
2304954;Guaiúba;2000;19884;14929;4955
2305001;Guaraciaba do Norte;2000;35037;14826;20211
2305100;Guaramiranga;2000;5714;2330;3384
2305209;Hidrolândia;2000;17687;9122;8565
2305233;Horizonte;2000;33790;28122;5668
2305266;Ibaretama;2000;12561;3366;9195
2305308;Ibiapina;2000;22157;8231;13926
2305332;Ibicuitinga;2000;9435;4387;5048
2305357;Icapuí;2000;16052;4662;11390
2305407;Icó;2000;62521;26047;36474
2305506;Iguatu;2000;85615;62366;23249
2305605;Independência;2000;25262;10265;14997
2305654;Ipaporanga;2000;11247;3203;8044
2305704;Ipaumirim;2000;11539;6199;5340
2305803;Ipu;2000;39078;22404;16674
2305902;Ipueiras;2000;38219;15775;22444
2306009;Iracema;2000;13155;8279;4876
2306108;Irauçuba;2000;19560;10873;8687
2306207;Itaiçaba;2000;6579;3672;2907
2306256;Itaitinga;2000;29217;26546;2671
2306306;Itapajé;2000;41093;27459;13634
2306405;Itapipoca;2000;94369;48481;45888
2306504;Itapiúna;2000;16276;7684;8592
2306553;Itarema;2000;30347;9901;20446
2306603;Itatira;2000;15541;6030;9511
2306702;Jaguaretama;2000;18024;7295;10729
2306801;Jaguaribara;2000;8730;3539;5191
2306900;Jaguaribe;2000;35062;21051;14011
2307007;Jaguaruana;2000;29735;16580;13155
2307106;Jardim;2000;26900;7358;19542
2307205;Jati;2000;7265;3016;4249
2307254;Jijoca de Jericoacoara;2000;12089;3434;8655
2307304;Juazeiro do Norte;2000;212133;202227;9906
2307403;Jucás;2000;22632;11856;10776
2307502;Lavras da Mangabeira;2000;31360;16730;14630
2307601;Limoeiro do Norte;2000;49620;28213;21407
2307635;Madalena;2000;14864;5459;9405
2307650;Maracanaú;2000;179732;179170;562
2307700;Maranguape;2000;88135;65268;22867
2307809;Marco;2000;20427;11687;8740
2307908;Martinópole;2000;8602;6487;2115
2308005;Massapê;2000;29574;19173;10401
2308104;Mauriti;2000;42399;18079;24320
2308203;Meruoca;2000;11339;5627;5712
2308302;Milagres;2000;26959;11291;15668
2308351;Milhã;2000;13028;5054;7974
2308377;Miraíma;2000;11417;4772;6645
2308401;Missão Velha;2000;32586;12785;19801
2308500;Mombaça;2000;41215;16052;25163
2308609;Monsenhor Tabosa;2000;16344;8252;8092
2308708;Morada Nova;2000;64400;33869;30531
2308807;Moraújo;2000;7046;3352;3694
2308906;Morrinhos;2000;17928;7746;10182
2309003;Mucambo;2000;13811;7533;6278
2309102;Mulungu;2000;8964;3795;5169
2309201;Nova Olinda;2000;12077;6393;5684
2309300;Nova Russas;2000;29347;20844;8503
2309409;Novo Oriente;2000;26119;12709;13410
2309458;Ocara;2000;21584;6372;15212
2309508;Orós;2000;22023;15710;6313
2309607;Pacajus;2000;44070;34301;9769
2309706;Pacatuba;2000;51696;47028;4668
2309805;Pacoti;2000;10929;3809;7120
2309904;Pacujá;2000;5653;3276;2377
2310001;Palhano;2000;8166;4259;3907
2310100;Palmácia;2000;9859;4417;5442
2310209;Paracuru;2000;27541;16673;10868
2310258;Paraipaba;2000;25462;12680;12782
2310308;Parambu;2000;32302;12550;19752
2310407;Paramoti;2000;10970;4175;6795
2310506;Pedra Branca;2000;40742;17347;23395
2310605;Penaforte;2000;7017;4478;2539
2310704;Pentecoste;2000;32600;19212;13388
2310803;Pereiro;2000;15225;5109;10116
2310852;Pindoretama;2000;14951;6818;8133
2310902;Piquet Carneiro;2000;13131;5582;7549
2310951;Pires Ferreira;2000;8643;2813;5830
2311009;Poranga;2000;11737;7135;4602
2311108;Porteiras;2000;15658;4480;11178
2311207;Potengi;2000;9258;3985;5273
2311231;Potiretama;2000;5768;2197;3571
2311264;Quiterianópolis;2000;18355;5068;13287
2311306;Quixadá;2000;69654;46888;22766
2311355;Quixelô;2000;15596;4165;11431
2311405;Quixeramobim;2000;59235;30762;28473
2311504;Quixeré;2000;16862;9857;7005
2311603;Redenção;2000;24993;12787;12206
2311702;Reriutaba;2000;21224;9734;11490
2311801;Russas;2000;57320;35323;21997
2311900;Saboeiro;2000;16226;7798;8428
2311959;Salitre;2000;13925;4489;9436
2312007;Santana do Acaraú;2000;26198;12454;13744
2312106;Santana do Cariri;2000;16847;8178;8669
2312205;Santa Quitéria;2000;42375;19355;23020
2312304;São Benedito;2000;39894;20970;18924
2312403;São Gonçalo do Amarante;2000;35608;22077;13531
2312502;São João do Jaguaribe;2000;8650;2744;5906
2312601;São Luís do Curu;2000;11497;7384;4113
2312700;Senador Pompeu;2000;27225;15682;11543
2312809;Senador Sá;2000;5605;3802;1803
2312908;Sobral;2000;155276;134508;20768
2313005;Solonópole;2000;16902;7716;9186
2313104;Tabuleiro do Norte;2000;27098;15852;11246
2313203;Tamboril;2000;25973;12401;13572
2313252;Tarrafas;2000;9213;1947;7266
2313302;Tauá;2000;51948;26721;25227
2313351;Tejuçuoca;2000;13519;4157;9362
2313401;Tianguá;2000;58069;37299;20770
2313500;Trairi;2000;44527;14413;30114
2313559;Tururu;2000;11498;5278;6220
2313609;Ubajara;2000;27095;12490;14605
2313708;Umari;2000;7435;3359;4076
2313757;Umirim;2000;17343;10060;7283
2313807;Uruburetama;2000;16444;11170;5274
2313906;Uruoca;2000;11479;6121;5358
2313955;Varjota;2000;16593;13479;3114
2314003;Várzea Alegre;2000;34844;19268;15576
2314102;Viçosa do Ceará;2000;45427;14478;30949
2400109;Acari;2000;11189;8841;2348
2400208;Açu;2000;47904;34645;13259
2400307;Afonso Bezerra;2000;10867;6500;4367
2400406;Água Nova;2000;2678;1630;1048
2400505;Alexandria;2000;13772;8644;5128
2400604;Almino Afonso;2000;5195;3375;1820
2400703;Alto do Rodrigues;2000;9499;6482;3017
2400802;Angicos;2000;11626;9391;2235
2400901;Antônio Martins;2000;6757;3157;3600
2401008;Apodi;2000;34174;16353;17821
2401107;Areia Branca;2000;22530;17861;4669
2401206;Arês;2000;11323;6761;4562
2401305;Augusto Severo;2000;9024;4670;4354
2401404;Baía Formosa;2000;7821;6369;1452
2401453;Baraúna;2000;18922;11965;6957
2401503;Barcelona;2000;3990;1599;2391
2401602;Bento Fernandes;2000;4709;2044;2665
2401651;Bodó;2000;2775;1230;1545
2401701;Bom Jesus;2000;8608;6223;2385
2401800;Brejinho;2000;10317;7344;2973
2401859;Caiçara do Norte;2000;5842;5537;305
2401909;Caiçara do Rio do Vento;2000;2867;1912;955
2402006;Caicó;2000;57002;50624;6378
2402105;Campo Redondo;2000;9201;4822;4379
2402204;Canguaretama;2000;27011;16924;10087
2402303;Caraúbas;2000;18810;12304;6506
2402402;Carnaúba dos Dantas;2000;6572;5103;1469
2402501;Carnaubais;2000;8192;2104;6088
2402600;Ceará-Mirim;2000;62424;30839;31585
2402709;Cerro Corá;2000;10839;4790;6049
2402808;Coronel Ezequiel;2000;5409;2212;3197
2402907;Coronel João Pessoa;2000;4703;1812;2891
2403004;Cruzeta;2000;8138;5715;2423
2403103;Currais Novos;2000;40791;35529;5262
2403202;Doutor Severiano;2000;6552;2261;4291
2403251;Parnamirim;2000;124690;109139;15551
2403301;Encanto;2000;4798;2116;2682
2403400;Equador;2000;5664;4440;1224
2403509;Espírito Santo;2000;10715;5709;5006
2403608;Extremoz;2000;19572;13418;6154
2403707;Felipe Guerra;2000;5534;3276;2258
2403756;Fernando Pedroza;2000;2650;2293;357
2403806;Florânia;2000;8978;5972;3006
2403905;Francisco Dantas;2000;3021;1571;1450
2404002;Frutuoso Gomes;2000;4580;2726;1854
2404101;Galinhos;2000;1767;1001;766
2404200;Goianinha;2000;17661;13055;4606
2404309;Governador Dix-Sept Rosado;2000;11772;5638;6134
2404408;Grossos;2000;8249;6275;1974
2404507;Guamaré;2000;8149;3599;4550
2404606;Ielmo Marinho;2000;10249;1123;9126
2404705;Ipanguaçu;2000;11924;4352;7572
2404804;Ipueira;2000;1902;1540;362
2404853;Itajá;2000;6249;5128;1121
2404903;Itaú;2000;5271;4110;1161
2405009;Jaçanã;2000;7677;5609;2068
2405108;Jandaíra;2000;6124;3792;2332
2405207;Janduís;2000;5597;3761;1836
2405306;Januário Cicco;2000;7687;2611;5076
2405405;Japi;2000;6328;3783;2545
2405504;Jardim de Angicos;2000;2670;544;2126
2405603;Jardim de Piranhas;2000;11994;8998;2996
2405702;Jardim do Seridó;2000;12041;9297;2744
2405801;João Câmara;2000;29248;19956;9292
2405900;João Dias;2000;2596;1104;1492
2406007;José da Penha;2000;5908;3287;2621
2406106;Jucurutu;2000;17319;10388;6931
2406205;Lagoa d'Anta;2000;5629;3387;2242
2406304;Lagoa de Pedras;2000;6395;2146;4249
2406403;Lagoa de Velhos;2000;2651;1577;1074
2406502;Lagoa Nova;2000;12058;5688;6370
2406601;Lagoa Salgada;2000;6808;3415;3393
2406700;Lajes;2000;9399;7970;1429
2406809;Lajes Pintadas;2000;4530;2053;2477
2406908;Lucrécia;2000;3218;1932;1286
2407005;Luís Gomes;2000;9154;5844;3310
2407104;Macaíba;2000;54883;36041;18842
2407203;Macau;2000;25700;18612;7088
2407252;Major Sales;2000;2948;2255;693
2407302;Marcelino Vieira;2000;8373;4138;4235
2407401;Martins;2000;7725;4194;3531
2407500;Maxaranguape;2000;8001;3017;4984
2407609;Messias Targino;2000;3718;2910;808
2407708;Montanhas;2000;11948;8652;3296
2407807;Monte Alegre;2000;19270;7555;11715
2407906;Monte das Gameleiras;2000;2541;1412;1129
2408003;Mossoró;2000;213841;199081;14760
2408102;Natal;2000;712317;712317;0
2408201;Nísia Floresta;2000;19040;8638;10402
2408300;Nova Cruz;2000;33834;21634;12200
2408409;Olho d'Água do Borges;2000;4461;3176;1285
2408508;Ouro Branco;2000;4667;2963;1704
2408607;Paraná;2000;3633;661;2972
2408706;Paraú;2000;4092;2936;1156
2408805;Parazinho;2000;4325;3060;1265
2408904;Parelhas;2000;19319;15606;3713
2408953;Rio do Fogo;2000;9217;3620;5597
2409100;Passa e Fica;2000;8329;4488;3841
2409209;Passagem;2000;2691;1334;1357
2409308;Patu;2000;11171;8848;2323
2409332;Santa Maria;2000;3778;2351;1427
2409407;Pau dos Ferros;2000;24758;22311;2447
2409506;Pedra Grande;2000;4017;1292;2725
2409605;Pedra Preta;2000;2847;748;2099
2409704;Pedro Avelino;2000;8006;4819;3187
2409803;Pedro Velho;2000;13518;5813;7705
2409902;Pendências;2000;11401;8944;2457
2410009;Pilões;2000;3002;2178;824
2410108;Poço Branco;2000;12506;6661;5844
2410207;Portalegre;2000;6746;2983;3763
2410256;Porto do Mangue;2000;4064;2285;1779
2410306;Serra Caiada;2000;7005;3959;3046
2410405;Pureza;2000;6963;2537;4426
2410504;Rafael Fernandes;2000;4247;2206;2041
2410603;Rafael Godeiro;2000;2953;1792;1161
2410702;Riacho da Cruz;2000;2667;2134;533
2410801;Riacho de Santana;2000;4200;1586;2614
2410900;Riachuelo;2000;5760;3561;2199
2411007;Rodolfo Fernandes;2000;4467;3781;686
2411056;Tibau;2000;3197;2688;509
2411106;Ruy Barbosa;2000;3686;1376;2310
2411205;Santa Cruz;2000;31294;24507;6787
2411403;Santana do Matos;2000;15987;6975;9012
2411429;Santana do Seridó;2000;2377;1394;983
2411502;Santo Antônio;2000;20107;12052;8055
2411601;São Bento do Norte;2000;3443;925;2518
2411700;São Bento do Trairí;2000;3244;1644;1600
2411809;São Fernando;2000;3234;1479;1755
2411908;São Francisco do Oeste;2000;3480;2456;1024
2412005;São Gonçalo do Amarante;2000;69435;9798;59637
2412104;São João do Sabugi;2000;5698;4142;1556
2412203;São José de Mipibu;2000;34912;15508;19404
2412302;São José do Campestre;2000;11982;9265;2717
2412401;São José do Seridó;2000;3777;2659;1118
2412500;São Miguel;2000;20124;11655;8469
2412559;São Miguel do Gostoso;2000;7580;2902;4678
2412609;São Paulo do Potengi;2000;13822;9899;3923
2412708;São Pedro;2000;6776;2861;3915
2412807;São Rafael;2000;8201;5384;2817
2412906;São Tomé;2000;10798;5600;5198
2413003;São Vicente;2000;5633;2823;2810
2413102;Senador Elói de Souza;2000;5028;2093;2935
2413201;Senador Georgino Avelino;2000;3302;727;2575
2413300;Serra de São Bento;2000;5870;2742;3128
2413359;Serra do Mel;2000;8237;8237;0
2413409;Serra Negra do Norte;2000;7543;2909;4634
2413508;Serrinha;2000;7253;2022;5231
2413557;Serrinha dos Pintos;2000;4295;1854;2441
2413607;Severiano Melo;2000;10579;2275;8304
2413706;Sítio Novo;2000;4448;2025;2423
2413805;Taboleiro Grande;2000;2029;1608;421
2413904;Taipu;2000;11531;4138;7393
2414001;Tangará;2000;12118;8109;4009
2414100;Tenente Ananias;2000;8875;5359;3516
2414159;Tenente Laurentino Cruz;2000;4412;1261;3151
2414209;Tibau do Sul;2000;7749;1288;6461
2414308;Timbaúba dos Batistas;2000;2189;1670;519
2414407;Touros;2000;27879;7594;20285
2414456;Triunfo Potiguar;2000;3663;1730;1933
2414506;Umarizal;2000;11092;8844;2248
2414605;Upanema;2000;10991;5043;5948
2414704;Várzea;2000;8238;5490;2748
2414753;Venha-Ver;2000;3422;713;2709
2414803;Vera Cruz;2000;8522;3925;4597
2414902;Viçosa;2000;1521;1408;113
2415008;Vila Flor;2000;2528;2435;93
2500106;Água Branca;2000;8377;3170;5207
2500205;Aguiar;2000;5638;2044;3594
2500304;Alagoa Grande;2000;29169;16847;12322
2500403;Alagoa Nova;2000;18575;8301;10274
2500502;Alagoinha;2000;11833;7789;4044
2500536;Alcantil;2000;4958;1671;3287
2500577;Algodão de Jandaíra;2000;2209;866;1343
2500601;Alhandra;2000;15914;8943;6971
2500700;São João do Rio do Peixe;2000;17661;6066;11595
2500734;Amparo;2000;1886;619;1267
2500775;Aparecida;2000;5894;2963;2931
2500809;Araçagi;2000;18095;5921;12174
2500908;Arara;2000;11530;7587;3943
2501005;Araruna;2000;16605;7349;9256
2501104;Areia;2000;26131;13471;12660
2501153;Areia de Baraúnas;2000;2104;865;1239
2501203;Areial;2000;6039;3715;2324
2501302;Aroeiras;2000;19520;6579;12941
2501351;Assunção;2000;2960;2142;818
2501401;Baía da Traição;2000;6483;2972;3511
2501500;Bananeiras;2000;21810;7590;14220
2501534;Baraúna;2000;3169;1936;1233
2501575;Barra de Santana;2000;8311;602;7709
2501609;Barra de Santa Rosa;2000;13127;6786;6341
2501708;Barra de São Miguel;2000;5162;2080;3082
2501807;Bayeux;2000;87561;87471;90
2501906;Belém;2000;16605;13200;3405
2502003;Belém do Brejo do Cruz;2000;7011;4484;2527
2502052;Bernardino Batista;2000;2559;339;2220
2502102;Boa Ventura;2000;6588;3502;3086
2502151;Boa Vista;2000;4983;2133;2850
2502201;Bom Jesus;2000;2193;819;1374
2502300;Bom Sucesso;2000;5285;1558;3727
2502409;Bonito de Santa Fé;2000;9230;4950;4280
2502508;Boqueirão;2000;15867;11141;4726
2502607;Igaracy;2000;6307;3539;2768
2502706;Borborema;2000;4730;3159;1571
2502805;Brejo do Cruz;2000;11868;8062;3806
2502904;Brejo dos Santos;2000;5948;4056;1892
2503001;Caaporã;2000;18441;11936;6505
2503100;Cabaceiras;2000;4290;1760;2530
2503209;Cabedelo;2000;42832;42832;0
2503308;Cachoeira dos Índios;2000;7834;2671;5163
2503407;Cacimba de Areia;2000;3577;1289;2288
2503506;Cacimba de Dentro;2000;16817;7553;9264
2503555;Cacimbas;2000;6979;1499;5480
2503605;Caiçara;2000;7325;4669;2656
2503704;Cajazeiras;2000;54715;41964;12751
2503753;Cajazeirinhas;2000;2888;660;2228
2503803;Caldas Brandão;2000;5155;2695;2460
2503902;Camalaú;2000;5516;2357;3159
2504009;Campina Grande;2000;355331;337484;17847
2504033;Capim;2000;4180;3656;524
2504074;Caraúbas;2000;3401;1074;2327
2504108;Carrapateira;2000;2160;1466;694
2504157;Casserengue;2000;6568;2566;4002
2504207;Catingueira;2000;4748;2445;2303
2504306;Catolé do Rocha;2000;26641;18336;8305
2504355;Caturité;2000;4183;701;3482
2504405;Conceição;2000;17931;10272;7659
2504504;Condado;2000;6495;4126;2369
2504603;Conde;2000;16413;10266;6147
2504702;Congo;2000;4602;2176;2426
2504801;Coremas;2000;15130;10571;4559
2504850;Coxixola;2000;1422;589;833
2504900;Cruz do Espírito Santo;2000;14081;5890;8191
2505006;Cubati;2000;6388;4030;2358
2505105;Cuité;2000;19946;12071;7875
2505204;Cuitegi;2000;7254;5678;1576
2505238;Cuité de Mamanguape;2000;6124;1519;4605
2505279;Curral de Cima;2000;5323;444;4879
2505303;Curral Velho;2000;2558;1313;1245
2505352;Damião;2000;3645;1432;2213
2505402;Desterro;2000;7701;4154;3547
2505501;Vista Serrana;2000;3121;1220;1901
2505600;Diamante;2000;6920;3871;3049
2505709;Dona Inês;2000;10227;3983;6244
2505808;Duas Estradas;2000;3818;2766;1052
2505907;Emas;2000;3061;1463;1598
2506004;Esperança;2000;28166;18520;9646
2506103;Fagundes;2000;11892;4958;6934
2506202;Frei Martinho;2000;2923;1377;1546
2506251;Gado Bravo;2000;8521;651;7870
2506301;Guarabira;2000;51482;44068;7414
2506400;Gurinhém;2000;13182;5543;7639
2506509;Gurjão;2000;2789;1684;1105
2506608;Ibiara;2000;6383;3549;2834
2506707;Imaculada;2000;11577;4190;7387
2506806;Ingá;2000;17473;10636;6837
2506905;Itabaiana;2000;25207;19801;5406
2507002;Itaporanga;2000;21123;14689;6434
2507101;Itapororoca;2000;14633;7957;6676
2507200;Itatuba;2000;9374;4985;4389
2507309;Jacaraú;2000;14117;7113;7004
2507408;Jericó;2000;7416;4198;3218
2507507;João Pessoa;2000;597934;597934;0
2507606;Juarez Távora;2000;7081;5227;1854
2507705;Juazeirinho;2000;14873;7649;7224
2507804;Junco do Seridó;2000;5968;3479;2489
2507903;Juripiranga;2000;9647;8657;990
2508000;Juru;2000;10045;3866;6179
2508109;Lagoa;2000;4844;1742;3102
2508208;Lagoa de Dentro;2000;7086;3347;3739
2508307;Lagoa Seca;2000;24154;8112;16042
2508406;Lastro;2000;3118;1082;2036
2508505;Livramento;2000;7605;3261;4344
2508554;Logradouro;2000;3389;1528;1861
2508604;Lucena;2000;9755;8027;1728
2508703;Mãe d'Água;2000;3459;1302;2157
2508802;Malta;2000;5692;4719;973
2508901;Mamanguape;2000;38772;30754;8018
2509008;Manaíra;2000;10473;4806;5667
2509057;Marcação;2000;6203;2948;3255
2509107;Mari;2000;20663;17420;3243
2509156;Marizópolis;2000;5618;4866;752
2509206;Massaranduba;2000;11697;3511;8186
2509305;Mataraca;2000;5500;4818;682
2509339;Matinhas;2000;4086;609;3477
2509370;Mato Grosso;2000;2427;879;1548
2509396;Maturéia;2000;5032;2460;2572
2509404;Mogeiro;2000;13231;4328;8903
2509503;Montadas;2000;3969;1966;2003
2509602;Monte Horebe;2000;4112;2156;1956
2509701;Monteiro;2000;27687;16684;11003
2509800;Mulungu;2000;9314;4137;5177
2509909;Natuba;2000;10562;3146;7416
2510006;Nazarezinho;2000;7272;2727;4545
2510105;Nova Floresta;2000;9421;8188;1233
2510204;Nova Olinda;2000;6457;3169;3288
2510303;Nova Palmeira;2000;3573;2052;1521
2510402;Olho d'Água;2000;7831;3287;4544
2510501;Olivedos;2000;3194;1360;1834
2510600;Ouro Velho;2000;2823;1905;918
2510659;Parari;2000;1437;339;1098
2510709;Passagem;2000;1979;829;1150
2510808;Patos;2000;91761;87949;3812
2510907;Paulista;2000;11266;4442;6824
2511004;Pedra Branca;2000;3692;1980;1712
2511103;Pedra Lavrada;2000;6617;2446;4171
2511202;Pedras de Fogo;2000;25861;13910;11951
2511301;Piancó;2000;14872;10052;4820
2511400;Picuí;2000;17896;10196;7700
2511509;Pilar;2000;10274;6975;3299
2511608;Pilões;2000;7800;2793;5007
2511707;Pilõezinhos;2000;5430;2298;3132
2511806;Pirpirituba;2000;10198;7214;2984
2511905;Pitimbu;2000;13927;7911;6016
2512002;Pocinhos;2000;14880;7557;7323
2512036;Poço Dantas;2000;3828;717;3111
2512077;Poço de José de Moura;2000;3529;994;2535
2512101;Pombal;2000;31954;23064;8890
2512200;Prata;2000;3425;2177;1248
2512309;Princesa Isabel;2000;18231;11401;6830
2512408;Puxinanã;2000;11981;3160;8821
2512507;Queimadas;2000;36032;17046;18986
2512606;Quixaba;2000;1308;505;803
2512705;Remígio;2000;14914;10196;4718
2512721;Pedro Régis;2000;4883;1374;3509
2512747;Riachão;2000;2793;1656;1137
2512754;Riachão do Bacamarte;2000;3948;2454;1494
2512762;Riachão do Poço;2000;3694;859;2835
2512788;Riacho de Santo Antônio;2000;1334;711;623
2512804;Riacho dos Cavalos;2000;8064;2833;5231
2512903;Rio Tinto;2000;22311;13284;9027
2513000;Salgadinho;2000;2823;505;2318
2513109;Salgado de São Félix;2000;12046;4927;7119
2513158;Santa Cecília;2000;6862;1193;5669
2513208;Santa Cruz;2000;6471;2746;3725
2513307;Santa Helena;2000;6170;2708;3462
2513356;Santa Inês;2000;3548;1057;2491
2513406;Santa Luzia;2000;14012;12469;1543
2513505;Santana de Mangueira;2000;5930;1850;4080
2513604;Santana dos Garrotes;2000;7975;3672;4303
2513653;Joca Claudino;2000;2568;743;1825
2513703;Santa Rita;2000;115844;100475;15369
2513802;Santa Teresinha;2000;4728;1607;3121
2513851;Santo André;2000;2800;521;2279
2513901;São Bento;2000;26225;20277;5948
2513927;São Bentinho;2000;3589;2228;1361
2513943;São Domingos do Cariri;2000;2189;780;1409
2513968;São Domingos;2000;2498;910;1588
2513984;São Francisco;2000;3464;1047;2417
2514008;São João do Cariri;2000;4703;1996;2707
2514107;São João do Tigre;2000;4481;1293;3188
2514206;São José da Lagoa Tapada;2000;7184;2978;4206
2514305;São José de Caiana;2000;5737;2047;3690
2514404;São José de Espinharas;2000;5109;1475;3634
2514453;São José dos Ramos;2000;4900;1536;3364
2514503;São José de Piranhas;2000;18401;8111;10290
2514552;São José de Princesa;2000;4970;449;4521
2514602;São José do Bonfim;2000;2838;965;1873
2514651;São José do Brejo do Cruz;2000;1532;657;875
2514701;São José do Sabugi;2000;3903;2212;1691
2514800;São José dos Cordeiros;2000;4136;1307;2829
2514909;São Mamede;2000;8018;5445;2573
2515005;São Miguel de Taipu;2000;6086;2741;3345
2515104;São Sebastião de Lagoa de Roça;2000;10055;3776;6279
2515203;São Sebastião do Umbuzeiro;2000;2894;1809;1085
2515302;Sapé;2000;47353;35516;11837
2515401;São Vicente do Seridó;2000;9106;3461;5645
2515500;Serra Branca;2000;12275;7949;4326
2515609;Serra da Raiz;2000;3436;2143;1293
2515708;Serra Grande;2000;2855;1401;1454
2515807;Serra Redonda;2000;7307;3125;4182
2515906;Serraria;2000;6678;3165;3513
2515930;Sertãozinho;2000;3444;2112;1332
2515971;Sobrado;2000;6885;583;6302
2516003;Solânea;2000;30658;17834;12824
2516102;Soledade;2000;12061;8461;3600
2516151;Sossêgo;2000;2598;1326;1272
2516201;Sousa;2000;62635;46200;16435
2516300;Sumé;2000;15035;10877;4158
2516409;Tacima;2000;9388;3706;5682
2516508;Taperoá;2000;13299;7934;5365
2516607;Tavares;2000;13584;5017;8567
2516706;Teixeira;2000;11953;7948;4005
2516755;Tenório;2000;2473;1276;1197
2516805;Triunfo;2000;9053;3733;5320
2516904;Uiraúna;2000;13681;8946;4735
2517001;Umbuzeiro;2000;9192;3582;5610
2517100;Várzea;2000;2051;1403;648
2517209;Vieirópolis;2000;4672;914;3758
2517407;Zabelê;2000;1853;1183;670
2600054;Abreu e Lima;2000;89039;77696;11343
2600104;Afogados da Ingazeira;2000;32922;23149;9773
2600203;Afrânio;2000;15269;3985;11284
2600302;Agrestina;2000;20036;12895;7141
2600401;Água Preta;2000;28814;14707;14107
2600500;Águas Belas;2000;36641;19937;16704
2600609;Alagoinha;2000;12535;6738;5797
2600708;Aliança;2000;37189;17091;20098
2600807;Altinho;2000;22131;10077;12054
2600906;Amaraji;2000;21309;14381;6928
2601003;Angelim;2000;9082;4543;4539
2601052;Araçoiaba;2000;15108;12447;2661
2601102;Araripina;2000;70898;34651;36247
2601201;Arcoverde;2000;61600;55301;6299
2601300;Barra de Guabiraba;2000;10939;8944;1995
2601409;Barreiros;2000;39139;31028;8111
2601508;Belém de Maria;2000;10626;6566;4060
2601607;Belém do São Francisco;2000;20208;11114;9094
2601706;Belo Jardim;2000;68698;50392;18306
2601805;Betânia;2000;11305;2921;8384
2601904;Bezerros;2000;57371;44566;12805
2602001;Bodocó;2000;31731;9302;22429
2602100;Bom Conselho;2000;42657;25222;17435
2602209;Bom Jardim;2000;37544;13033;24511
2602308;Bonito;2000;38908;22995;15913
2602407;Brejão;2000;8916;3217;5699
2602506;Brejinho;2000;7278;2389;4889
2602605;Brejo da Madre de Deus;2000;38109;24713;13396
2602704;Buenos Aires;2000;12007;6408;5599
2602803;Buíque;2000;45047;15472;29575
2602902;Cabo de Santo Agostinho;2000;152977;134486;18491
2603009;Cabrobó;2000;26741;15769;10972
2603108;Cachoeirinha;2000;17042;11698;5344
2603207;Caetés;2000;24137;5508;18629
2603306;Calçado;2000;11709;3265;8444
2603405;Calumbi;2000;7192;1914;5278
2603454;Camaragibe;2000;128702;128702;0
2603504;Camocim de São Félix;2000;15115;11177;3938
2603603;Camutanga;2000;7844;6016;1828
2603702;Canhotinho;2000;24920;12261;12659
2603801;Capoeiras;2000;19556;4843;14713
2603900;Carnaíba;2000;17696;6560;11136
2603926;Carnaubeira da Penha;2000;10404;1122;9282
2604007;Carpina;2000;63811;61006;2805
2604106;Caruaru;2000;253634;217407;36227
2604155;Casinhas;2000;13345;1425;11920
2604205;Catende;2000;31257;23451;7806
2604304;Cedro;2000;9551;5017;4534
2604403;Chã de Alegria;2000;11102;8082;3020
2604502;Chã Grande;2000;18729;10949;7780
2604601;Condado;2000;21797;18473;3324
2604700;Correntes;2000;17044;8844;8200
2604809;Cortês;2000;12681;8313;4368
2604908;Cumaru;2000;28607;6798;21809
2605004;Cupira;2000;22383;18085;4298
2605103;Custódia;2000;30199;16645;13554
2605152;Dormentes;2000;14411;3835;10576
2605202;Escada;2000;57341;45596;11745
2605301;Exu;2000;32423;11519;20904
2605400;Feira Nova;2000;18857;12156;6701
2605459;Fernando de Noronha;2000;2051;2051;0
2605509;Ferreiros;2000;10727;6957;3770
2605608;Flores;2000;20823;8139;12684
2605707;Floresta;2000;24729;15547;9182
2605806;Frei Miguelinho;2000;12978;2364;10614
2605905;Gameleira;2000;24003;16663;7340
2606002;Garanhuns;2000;117749;103341;14408
2606101;Glória do Goitá;2000;27554;12542;15012
2606200;Goiana;2000;71177;43531;27646
2606309;Granito;2000;6110;1601;4509
2606408;Gravatá;2000;67273;55563;11710
2606507;Iati;2000;17691;6608;11083
2606606;Ibimirim;2000;24340;13496;10844
2606705;Ibirajuba;2000;7438;2428;5010
2606804;Igarassu;2000;82277;75739;6538
2606903;Iguaracy;2000;11570;4999;6571
2607000;Inajá;2000;13280;6479;6801
2607109;Ingazeira;2000;4567;2128;2439
2607208;Ipojuca;2000;59281;40396;18885
2607307;Ipubi;2000;23042;13439;9603
2607406;Itacuruba;2000;3669;3244;425
2607505;Itaíba;2000;26799;8735;18064
2607604;Ilha de Itamaracá;2000;15858;12930;2928
2607653;Itambé;2000;34982;26325;8657
2607703;Itapetim;2000;14766;7591;7175
2607752;Itapissuma;2000;20116;16330;3786
2607802;Itaquitinga;2000;14950;10779;4171
2607901;Jaboatão dos Guararapes;2000;581556;568474;13082
2607950;Jaqueira;2000;11653;5904;5749
2608008;Jataúba;2000;14653;6628;8025
2608057;Jatobá;2000;13148;5412;7736
2608107;João Alfredo;2000;27316;10296;17020
2608206;Joaquim Nabuco;2000;15925;9617;6308
2608255;Jucati;2000;9695;2277;7418
2608305;Jupi;2000;12329;5785;6544
2608404;Jurema;2000;13741;7634;6107
2608453;Lagoa do Carro;2000;13110;8087;5023
2608503;Lagoa de Itaenga;2000;20172;15345;4827
2608602;Lagoa do Ouro;2000;11324;4548;6776
2608701;Lagoa dos Gatos;2000;16100;7460;8640
2608750;Lagoa Grande;2000;19137;8651;10486
2608800;Lajedo;2000;32209;22531;9678
2608909;Limoeiro;2000;56322;42412;13910
2609006;Macaparana;2000;22494;13518;8976
2609105;Machados;2000;9826;5474;4352
2609154;Manari;2000;13028;2287;10741
2609204;Maraial;2000;14706;7937;6769
2609303;Mirandiba;2000;13122;6375;6747
2609402;Moreno;2000;49205;38294;10911
2609501;Nazaré da Mata;2000;29254;24704;4550
2609600;Olinda;2000;367902;360554;7348
2609709;Orobó;2000;22475;5587;16888
2609808;Orocó;2000;10825;3573;7252
2609907;Ouricuri;2000;56733;26608;30125
2610004;Palmares;2000;55790;43452;12338
2610103;Palmeirina;2000;9536;4790;4746
2610202;Panelas;2000;25874;9641;16233
2610301;Paranatama;2000;10763;1647;9116
2610400;Parnamirim;2000;19289;7323;11966
2610509;Passira;2000;29132;12326;16806
2610608;Paudalho;2000;45138;35190;9948
2610707;Paulista;2000;262237;262237;0
2610806;Pedra;2000;20244;10267;9977
2610905;Pesqueira;2000;57721;40991;16730
2611002;Petrolândia;2000;27320;19599;7721
2611101;Petrolina;2000;218538;166279;52259
2611200;Poção;2000;11178;6359;4819
2611309;Pombos;2000;23730;13979;9751
2611408;Primavera;2000;11477;6641;4836
2611507;Quipapá;2000;23519;12235;11284
2611533;Quixaba;2000;6855;2038;4817
2611606;Recife;2000;1422905;1422905;0
2611705;Riacho das Almas;2000;18142;6123;12019
2611804;Ribeirão;2000;41853;29546;12307
2611903;Rio Formoso;2000;20764;8349;12415
2612000;Sairé;2000;13649;5648;8001
2612109;Salgadinho;2000;7139;2251;4888
2612208;Salgueiro;2000;51571;39891;11680
2612307;Saloá;2000;15006;5141;9865
2612406;Sanharó;2000;15879;7613;8266
2612455;Santa Cruz;2000;11264;2861;8403
2612471;Santa Cruz da Baixa Verde;2000;10859;4147;6712
2612505;Santa Cruz do Capibaribe;2000;59048;57226;1822
2612554;Santa Filomena;2000;12115;1693;10422
2612604;Santa Maria da Boa Vista;2000;36914;14004;22910
2612703;Santa Maria do Cambucá;2000;11739;2261;9478
2612802;Santa Terezinha;2000;10251;5967;4284
2612901;São Benedito do Sul;2000;10477;4947;5530
2613008;São Bento do Una;2000;45585;23306;22279
2613107;São Caitano;2000;33426;22499;10927
2613206;São João;2000;19967;7144;12823
2613305;São Joaquim do Monte;2000;20124;11354;8770
2613404;São José da Coroa Grande;2000;13971;9516;4455
2613503;São José do Belmonte;2000;31652;14365;17287
2613602;São José do Egito;2000;29468;17695;11773
2613701;São Lourenço da Mata;2000;90402;83543;6859
2613800;São Vicente Férrer;2000;16004;8906;7098
2613909;Serra Talhada;2000;70912;49605;21307
2614006;Serrita;2000;17848;4419;13429
2614105;Sertânia;2000;31657;17047;14610
2614204;Sirinhaém;2000;33046;13646;19400
2614303;Moreilândia;2000;11116;5586;5530
2614402;Solidão;2000;5532;1303;4229
2614501;Surubim;2000;50331;33145;17186
2614600;Tabira;2000;24065;15944;8121
2614709;Tacaimbó;2000;13207;5927;7280
2614808;Tacaratu;2000;17096;7242;9854
2614857;Tamandaré;2000;17281;11035;6246
2615003;Taquaritinga do Norte;2000;19757;12022;7735
2615102;Terezinha;2000;6463;1750;4714
2615201;Terra Nova;2000;7518;3969;3549
2615300;Timbaúba;2000;56906;44035;12871
2615409;Toritama;2000;21800;20078;1722
2615508;Tracunhaém;2000;12394;9442;2952
2615607;Trindade;2000;21930;17195;4735
2615706;Triunfo;2000;15362;6810;8552
2615805;Tupanatinga;2000;20801;6420;14381
2615904;Tuparetama;2000;7766;5806;1960
2616001;Venturosa;2000;13462;8050;5412
2616100;Verdejante;2000;8846;2300;6546
2616183;Vertente do Lério;2000;8536;1508;7028
2616209;Vertentes;2000;14957;6303;8654
2616308;Vicência;2000;28820;10502;18318
2616407;Vitória de Santo Antão;2000;117609;99342;18267
2616506;Xexéu;2000;13597;7857;5740
2700102;Água Branca;2000;19294;4496;14798
2700201;Anadia;2000;17849;9108;8741
2700300;Arapiraca;2000;186466;152354;34112
2700409;Atalaia;2000;40552;17949;22603
2700508;Barra de Santo Antônio;2000;11351;9583;1768
2700607;Barra de São Miguel;2000;6379;5241;1138
2700706;Batalha;2000;14799;10322;4477
2700805;Belém;2000;6024;1823;4201
2700904;Belo Monte;2000;6822;1226;5596
2701001;Boca da Mata;2000;24227;15415;8812
2701100;Branquinha;2000;11325;5888;5437
2701209;Cacimbinhas;2000;9552;4236;5316
2701308;Cajueiro;2000;18975;14048;4927
2701357;Campestre;2000;6223;4725;1498
2701407;Campo Alegre;2000;41028;16117;24911
2701506;Campo Grande;2000;9134;3703;5431
2701605;Canapi;2000;17334;4112;13222
2701704;Capela;2000;19302;12544;6758
2701803;Carneiros;2000;6585;3385;3200
2701902;Chã Preta;2000;8203;3672;4531
2702009;Coité do Nóia;2000;11993;2519;9474
2702108;Colônia Leopoldina;2000;17493;11414;6079
2702207;Coqueiro Seco;2000;5134;4574;560
2702306;Coruripe;2000;48846;22199;26647
2702355;Craíbas;2000;20789;6608;14181
2702405;Delmiro Gouveia;2000;42995;33563;9432
2702504;Dois Riachos;2000;11066;4421;6645
2702553;Estrela de Alagoas;2000;16341;3260;13081
2702603;Feira Grande;2000;21270;3557;17713
2702702;Feliz Deserto;2000;3836;2848;988
2702801;Flexeiras;2000;11979;6690;5289
2702900;Girau do Ponciano;2000;29804;8858;20946
2703007;Ibateguara;2000;15105;8409;6696
2703106;Igaci;2000;25584;5886;19698
2703205;Igreja Nova;2000;21451;4433;17018
2703304;Inhapi;2000;18553;5937;12616
2703403;Jacaré dos Homens;2000;5720;2826;2894
2703502;Jacuípe;2000;7313;3344;3969
2703601;Japaratinga;2000;6868;2511;4357
2703700;Jaramataia;2000;5788;2887;2901
2703809;Joaquim Gomes;2000;21488;12606;8882
2703908;Jundiá;2000;4680;2148;2532
2704005;Junqueiro;2000;23832;6957;16875
2704104;Lagoa da Canoa;2000;19988;8886;11102
2704203;Limoeiro de Anadia;2000;24263;2105;22158
2704302;Maceió;2000;797759;795804;1955
2704401;Major Isidoro;2000;17639;8535;9104
2704500;Maragogi;2000;21832;12180;9652
2704609;Maravilha;2000;13687;5254;8433
2704708;Marechal Deodoro;2000;35866;29837;6029
2704807;Maribondo;2000;15145;10101;5044
2704906;Mar Vermelho;2000;4078;1355;2723
2705002;Mata Grande;2000;25032;4731;20301
2705101;Matriz de Camaragibe;2000;24017;18262;5755
2705200;Messias;2000;11990;9552;2438
2705309;Minador do Negrão;2000;5399;1898;3501
2705408;Monteirópolis;2000;7240;2691;4549
2705507;Murici;2000;24671;17485;7186
2705606;Novo Lino;2000;10375;5341;5034
2705705;Olho d'Água das Flores;2000;19417;12996;6421
2705804;Olho d'Água do Casado;2000;7059;3887;3172
2705903;Olho d'Água Grande;2000;4847;1077;3770
2706000;Olivença;2000;10369;2371;7998
2706109;Ouro Branco;2000;10516;5300;5216
2706208;Palestina;2000;4523;3014;1509
2706307;Palmeira dos Índios;2000;68060;48958;19102
2706406;Pão de Açúcar;2000;24351;10806;13545
2706422;Pariconha;2000;10086;2404;7682
2706448;Paripueira;2000;8049;7085;964
2706505;Passo de Camaragibe;2000;13755;5751;8004
2706604;Paulo Jacinto;2000;7651;4661;2990
2706703;Penedo;2000;56993;41545;15448
2706802;Piaçabuçu;2000;16775;10154;6621
2706901;Pilar;2000;31201;28166;3035
2707008;Pindoba;2000;2926;1330;1596
2707107;Piranhas;2000;20007;1340;18667
2707206;Poço das Trincheiras;2000;13222;1557;11665
2707305;Porto Calvo;2000;23951;14983;8968
2707404;Porto de Pedras;2000;10568;5198;5370
2707503;Porto Real do Colégio;2000;18355;5960;12395
2707602;Quebrangulo;2000;11902;6149;5753
2707701;Rio Largo;2000;62510;49919;12591
2707800;Roteiro;2000;6985;5477;1508
2707909;Santa Luzia do Norte;2000;6388;5446;942
2708006;Santana do Ipanema;2000;41485;23993;17492
2708105;Santana do Mundaú;2000;11534;6182;5352
2708204;São Brás;2000;6551;3021;3530
2708303;São José da Laje;2000;21071;12520;8551
2708402;São José da Tapera;2000;28240;9261;18979
2708501;São Luís do Quitunde;2000;29543;17525;12018
2708600;São Miguel dos Campos;2000;51456;35375;16081
2708709;São Miguel dos Milagres;2000;5860;1744;4116
2708808;São Sebastião;2000;29124;9408;19716
2708907;Satuba;2000;12555;9975;2580
2708956;Senador Rui Palmeira;2000;11979;3443;8536
2709004;Tanque d'Arca;2000;6594;2077;4517
2709103;Taquarana;2000;17046;4371;12675
2709152;Teotônio Vilela;2000;36881;29838;7043
2709202;Traipu;2000;24255;6798;17457
2709301;União dos Palmares;2000;58620;37869;20751
2709400;Viçosa;2000;26263;17611;8652
2800100;Amparo de São Francisco;2000;2182;1205;977
2800209;Aquidabã;2000;18344;9647;8697
2800308;Aracaju;2000;461534;461534;0
2800407;Arauá;2000;9762;4050;5712
2800506;Areia Branca;2000;14824;6809;8015
2800605;Barra dos Coqueiros;2000;17807;15176;2631
2800670;Boquim;2000;24188;14975;9213
2800704;Brejo Grande;2000;7102;4202;2900
2801009;Campo do Brito;2000;15175;6916;8259
2801108;Canhoba;2000;3965;1595;2370
2801207;Canindé de São Francisco;2000;17754;9303;8451
2801306;Capela;2000;26518;16095;10423
2801405;Carira;2000;17738;8881;8857
2801504;Carmópolis;2000;9352;7606;1746
2801603;Cedro de São João;2000;5378;4650;728
2801702;Cristinápolis;2000;14268;6445;7823
2801900;Cumbe;2000;3646;2130;1516
2802007;Divina Pastora;2000;3266;1849;1417
2802106;Estância;2000;59002;50854;8148
2802205;Feira Nova;2000;5068;2935;2133
2802304;Frei Paulo;2000;11973;6330;5643
2802403;Gararu;2000;11363;2988;8375
2802502;General Maynard;2000;2400;1565;835
2802601;Gracho Cardoso;2000;5519;2540;2979
2802700;Ilha das Flores;2000;8281;3796;4485
2802809;Indiaroba;2000;13152;4681;8471
2802908;Itabaiana;2000;76813;55472;21341
2803005;Itabaianinha;2000;35454;15559;19895
2803104;Itabi;2000;5174;2638;2536
2803203;Itaporanga d'Ajuda;2000;25482;9159;16323
2803302;Japaratuba;2000;14556;7212;7344
2803401;Japoatã;2000;13020;3866;9154
2803500;Lagarto;2000;83334;40527;42807
2803609;Laranjeiras;2000;23560;21213;2347
2803708;Macambira;2000;5802;2166;3636
2803807;Malhada dos Bois;2000;3208;1331;1877
2803906;Malhador;2000;11481;4867;6614
2804003;Maruim;2000;15454;11666;3788
2804102;Moita Bonita;2000;11000;3633;7367
2804201;Monte Alegre de Sergipe;2000;11587;6468;5119
2804300;Muribeca;2000;7101;2763;4338
2804409;Neópolis;2000;18593;10501;8092
2804458;Nossa Senhora Aparecida;2000;8279;2395;5884
2804508;Nossa Senhora da Glória;2000;26910;17137;9773
2804607;Nossa Senhora das Dores;2000;22195;13524;8671
2804706;Nossa Senhora de Lourdes;2000;6023;2965;3058
2804805;Nossa Senhora do Socorro;2000;131679;131279;400
2804904;Pacatuba;2000;11536;2533;9003
2805000;Pedra Mole;2000;2630;1100;1530
2805109;Pedrinhas;2000;7929;5398;2531
2805208;Pinhão;2000;5244;3133;2111
2805307;Pirambu;2000;7255;4148;3107
2805406;Poço Redondo;2000;26022;6360;19662
2805505;Poço Verde;2000;19973;10498;9475
2805604;Porto da Folha;2000;25664;8712;16952
2805703;Propriá;2000;27385;23567;3818
2805802;Riachão do Dantas;2000;19202;4270;14932
2805901;Riachuelo;2000;8337;6707;1630
2806008;Ribeirópolis;2000;15439;10095;5344
2806107;Rosário do Catete;2000;7102;5656;1446
2806206;Salgado;2000;18876;4983;13893
2806305;Santa Luzia do Itanhy;2000;13948;2585;11363
2806404;Santana do São Francisco;2000;6135;4051;2084
2806503;Santa Rosa de Lima;2000;3595;1960;1635
2806602;Santo Amaro das Brotas;2000;10670;8082;2588
2806701;São Cristóvão;2000;64647;63116;1531
2806800;São Domingos;2000;9260;3904;5356
2806909;São Francisco;2000;2532;2166;366
2807006;São Miguel do Aleixo;2000;3447;1274;2173
2807105;Simão Dias;2000;36957;16818;20139
2807204;Siriri;2000;6914;2726;4188
2807303;Telha;2000;2638;1063;1575
2807402;Tobias Barreto;2000;43172;27500;15672
2807501;Tomar do Geru;2000;12840;4135;8705
2807600;Umbaúba;2000;19214;10935;8279
2900108;Abaíra;2000;9067;3559;5508
2900207;Abaré;2000;13648;5528;8120
2900306;Acajutiba;2000;14322;12184;2138
2900355;Adustina;2000;14302;4484;9818
2900405;Água Fria;2000;14966;4324;10642
2900504;Érico Cardoso;2000;12305;1351;10953
2900603;Aiquara;2000;5315;2579;2736
2900702;Alagoinhas;2000;130095;112440;17655
2900801;Alcobaça;2000;20900;7446;13454
2900900;Almadina;2000;7862;5200;2662
2901007;Amargosa;2000;31108;20884;10224
2901106;Amélia Rodrigues;2000;24134;19022;5112
2901155;América Dourada;2000;15959;10148;5811
2901205;Anagé;2000;31060;4208;26852
2901304;Andaraí;2000;13884;7166;6718
2901353;Andorinha;2000;15774;4335;11439
2901403;Angical;2000;14701;6035;8666
2901502;Anguera;2000;8834;3456;5378
2901601;Antas;2000;14059;5014;9045
2901700;Antônio Cardoso;2000;11837;2316;9521
2901809;Antônio Gonçalves;2000;9716;5260;4456
2901908;Aporá;2000;16769;6546;10223
2901957;Apuarema;2000;7443;4382;3061
2902005;Aracatu;2000;15913;3187;12726
2902054;Araçás;2000;11003;5330;5673
2902104;Araci;2000;47584;16189;31395
2902203;Aramari;2000;9258;4291;4967
2902252;Arataca;2000;11218;5176;6042
2902302;Aratuípe;2000;8381;4787;3594
2902401;Aurelino Leal;2000;17149;13940;3209
2902500;Baianópolis;2000;12179;2727;9452
2902609;Baixa Grande;2000;20441;7126;13315
2902658;Banzaê;2000;11156;3414;7742
2902708;Barra;2000;44203;19641;24562
2902807;Barra da Estiva;2000;24785;9536;15249
2902906;Barra do Choça;2000;40818;17721;23097
2903003;Barra do Mendes;2000;13610;5579;8031
2903102;Barra do Rocha;2000;8074;3425;4649
2903201;Barreiras;2000;131849;115784;16065
2903235;Barro Alto;2000;12098;5176;6922
2903300;Barro Preto;2000;8602;5159;3443
2903409;Belmonte;2000;20032;10806;9226
2903508;Belo Campo;2000;17655;8082;9573
2903607;Biritinga;2000;14641;2347;12294
2903706;Boa Nova;2000;20544;4589;15955
2903805;Boa Vista do Tupim;2000;18408;5840;12568
2903904;Bom Jesus da Lapa;2000;54421;37726;16695
2903953;Bom Jesus da Serra;2000;10502;1953;8549
2904001;Boninal;2000;12461;3821;8640
2904050;Bonito;2000;12902;5501;7401
2904100;Boquira;2000;22121;6600;15521
2904209;Botuporã;2000;11522;3251;8271
2904308;Brejões;2000;15344;4568;10776
2904407;Brejolândia;2000;8762;1832;6930
2904506;Brotas de Macaúbas;2000;13003;3050;9953
2904605;Brumado;2000;62148;40710;21438
2904704;Buerarema;2000;19118;16249;2869
2904753;Buritirama;2000;17797;5924;11873
2904803;Caatiba;2000;15508;4428;11080
2904852;Cabaceiras do Paraguaçu;2000;15547;3305;12242
2904902;Cachoeira;2000;30416;15831;14585
2905008;Caculé;2000;20339;11531;8808
2905107;Caém;2000;12563;3377;9186
2905156;Caetanos;2000;13076;2312;10764
2905206;Caetité;2000;45727;23459;22268
2905305;Cafarnaum;2000;16059;9209;6850
2905404;Cairu;2000;11410;6981;4429
2905503;Caldeirão Grande;2000;11395;4081;7314
2905602;Camacan;2000;31055;24282;6773
2905701;Camaçari;2000;161727;154402;7325
2905800;Camamu;2000;33661;12107;21554
2905909;Campo Alegre de Lourdes;2000;27607;6539;21068
2906006;Campo Formoso;2000;61942;21003;40939
2906105;Canápolis;2000;9743;2538;7205
2906204;Canarana;2000;21665;9755;11910
2906303;Canavieiras;2000;35322;26343;8979
2906402;Candeal;2000;10121;3417;6704
2906501;Candeias;2000;76783;69127;7656
2906600;Candiba;2000;12280;6159;6121
2906709;Cândido Sales;2000;28516;18924;9592
2906808;Cansanção;2000;31947;9221;22726
2906824;Canudos;2000;13761;6541;7220
2906857;Capela do Alto Alegre;2000;11898;4533;7365
2906873;Capim Grosso;2000;23908;17861;6047
2906899;Caraíbas;2000;17164;1424;15740
2906907;Caravelas;2000;20103;10332;9771
2907004;Cardeal da Silva;2000;8034;2832;5202
2907103;Carinhanha;2000;27272;10680;16592
2907202;Casa Nova;2000;55730;27266;28464
2907301;Castro Alves;2000;25561;14647;10914
2907400;Catolândia;2000;3092;848;2244
2907509;Catu;2000;46731;37816;8915
2907558;Caturama;2000;9199;1563;7636
2907608;Central;2000;16792;7637;9155
2907707;Chorrochó;2000;10171;2155;8016
2907806;Cícero Dantas;2000;30934;15797;15137
2907905;Cipó;2000;14285;9527;4758
2908002;Coaraci;2000;27852;23086;4766
2908101;Cocos;2000;17611;6424;11187
2908200;Conceição da Feira;2000;17514;11237;6277
2908309;Conceição do Almeida;2000;18912;8318;10594
2908408;Conceição do Coité;2000;56317;28026;28291
2908507;Conceição do Jacuípe;2000;26194;19466;6728
2908606;Conde;2000;20426;10492;9934
2908705;Condeúba;2000;18047;6331;11716
2908804;Contendas do Sincorá;2000;4264;2331;1933
2908903;Coração de Maria;2000;23818;7528;16290
2909000;Cordeiros;2000;8193;2100;6093
2909109;Coribe;2000;15148;5695;9453
2909208;Coronel João Sá;2000;19665;5538;14127
2909307;Correntina;2000;30583;11355;19228
2909406;Cotegipe;2000;13374;6547;6827
2909505;Cravolândia;2000;5001;3329;1672
2909604;Crisópolis;2000;19037;6855;12182
2909703;Cristópolis;2000;12662;2675;9987
2909802;Cruz das Almas;2000;53049;39604;13445
2909901;Curaçá;2000;28841;10775;18066
2910008;Dário Meira;2000;15983;4931;11052
2910057;Dias d'Ávila;2000;45333;42673;2660
2910107;Dom Basílio;2000;10427;1521;8906
2910206;Dom Macedo Costa;2000;3748;1297;2451
2910305;Elísio Medrado;2000;7860;2514;5346
2910404;Encruzilhada;2000;32924;4983;27941
2910503;Entre Rios;2000;37513;23019;14494
2910602;Esplanada;2000;27230;17538;9692
2910701;Euclides da Cunha;2000;53885;24531;29354
2910727;Eunápolis;2000;84120;79161;4959
2910750;Fátima;2000;18298;6343;11955
2910776;Feira da Mata;2000;6235;2822;3413
2910800;Feira de Santana;2000;480949;431419;49530
2910859;Filadélfia;2000;17411;7972;9439
2910909;Firmino Alves;2000;5170;3896;1274
2911006;Floresta Azul;2000;11614;7915;3699
2911105;Formosa do Rio Preto;2000;18288;9381;8907
2911204;Gandu;2000;27160;22060;5100
2911253;Gavião;2000;4792;2203;2589
2911303;Gentio do Ouro;2000;10173;4784;5389
2911402;Glória;2000;14559;2365;12194
2911501;Gongogi;2000;10522;6250;4272
2911600;Governador Mangabeira;2000;17165;6684;10481
2911659;Guajeru;2000;12836;1723;11113
2911709;Guanambi;2000;71728;54003;17725
2911808;Guaratinga;2000;24319;10017;14302
2911857;Heliópolis;2000;13108;4232;8876
2911907;Iaçu;2000;28501;21636;6865
2912004;Ibiassucê;2000;12828;4037;8791
2912103;Ibicaraí;2000;28861;19333;9528
2912202;Ibicoara;2000;15168;4133;11035
2912301;Ibicuí;2000;15129;10454;4675
2912400;Ibipeba;2000;15362;9282;6080
2912509;Ibipitanga;2000;13477;3663;9814
2912608;Ibiquera;2000;4495;2493;2002
2912707;Ibirapitanga;2000;22177;6363;15814
2912806;Ibirapuã;2000;7096;3918;3178
2912905;Ibirataia;2000;24741;18726;6015
2913002;Ibitiara;2000;14443;2714;11729
2913101;Ibititá;2000;17905;8060;9845
2913200;Ibotirama;2000;24149;16384;7765
2913309;Ichu;2000;5593;2663;2930
2913408;Igaporã;2000;14557;7101;7456
2913457;Igrapiúna;2000;14960;2377;12583
2913507;Iguaí;2000;25134;12290;12844
2913606;Ilhéus;2000;222127;162277;59850
2913705;Inhambupe;2000;29589;12581;17008
2913804;Ipecaetá;2000;18696;2065;16631
2913903;Ipiaú;2000;43621;37924;5697
2914000;Ipirá;2000;61746;23320;38426
2914109;Ipupiara;2000;8541;5192;3349
2914208;Irajuba;2000;6362;2717;3645
2914307;Iramaia;2000;17553;7682;9871
2914406;Iraquara;2000;18334;5330;13004
2914505;Irará;2000;25163;8657;16506
2914604;Irecê;2000;57436;53143;4293
2914653;Itabela;2000;25746;18837;6909
2914703;Itaberaba;2000;58943;44517;14426
2914802;Itabuna;2000;196675;191184;5491
2914901;Itacaré;2000;18120;7951;10169
2915007;Itaeté;2000;14006;5454;8552
2915106;Itagi;2000;15541;10251;5291
2915205;Itagibá;2000;17191;8767;8424
2915304;Itagimirim;2000;7728;5966;1762
2915353;Itaguaçu da Bahia;2000;11309;1987;9322
2915403;Itaju do Colônia;2000;8580;6389;2191
2915502;Itajuípe;2000;22511;16123;6388
2915601;Itamaraju;2000;64144;48037;16107
2915700;Itamari;2000;8470;5124;3346
2915809;Itambé;2000;30850;22175;8675
2915908;Itanagra;2000;6370;1859;4511
2916005;Itanhém;2000;21334;14090;7244
2916104;Itaparica;2000;18945;18945;0
2916203;Itapé;2000;14639;8666;5973
2916302;Itapebi;2000;11126;8542;2584
2916401;Itapetinga;2000;57931;55182;2749
2916500;Itapicuru;2000;27315;5085;22230
2916609;Itapitanga;2000;10382;7095;3287
2916708;Itaquara;2000;7861;3765;4096
2916807;Itarantim;2000;16923;12493;4430
2916856;Itatim;2000;12700;8700;4000
2916906;Itiruçu;2000;13585;9871;3714
2917003;Itiúba;2000;35543;8864;26679
2917102;Itororó;2000;19799;16627;3172
2917201;Ituaçu;2000;17268;4127;13141
2917300;Ituberá;2000;24133;15910;8223
2917334;Iuiu;2000;10489;4565;5924
2917359;Jaborandi;2000;10288;2023;8265
2917409;Jacaraci;2000;13520;3651;9869
2917508;Jacobina;2000;76492;52088;24404
2917607;Jaguaquara;2000;46621;35103;11518
2917706;Jaguarari;2000;27412;13381;14031
2917805;Jaguaripe;2000;13422;4632;8790
2917904;Jandaíra;2000;10027;5211;4816
2918001;Jequié;2000;147202;130296;16906
2918100;Jeremoabo;2000;34916;14764;20152
2918209;Jiquiriçá;2000;13638;4588;9050
2918308;Jitaúna;2000;21056;9568;11488
2918357;João Dourado;2000;18967;11441;7526
2918407;Juazeiro;2000;174567;133278;41289
2918456;Jucuruçu;2000;12377;1850;10527
2918506;Jussara;2000;15339;9865;5474
2918555;Jussari;2000;7556;5124;2432
2918605;Jussiape;2000;10486;3766;6720
2918704;Lafaiete Coutinho;2000;4102;1921;2181
2918753;Lagoa Real;2000;12765;2006;10759
2918803;Laje;2000;19601;5118;14483
2918902;Lajedão;2000;3409;1852;1557
2919009;Lajedinho;2000;4352;1154;3198
2919058;Lajedo do Tabocal;2000;8100;4841;3259
2919108;Lamarão;2000;9523;1928;7595
2919157;Lapão;2000;24727;9222;15505
2919207;Lauro de Freitas;2000;113543;108595;4948
2919306;Lençóis;2000;8910;6395;2515
2919405;Licínio de Almeida;2000;12349;5957;6392
2919504;Livramento de Nossa Senhora;2000;38025;16724;21301
2919603;Macajuba;2000;11474;4405;7069
2919702;Macarani;2000;14594;10719;3875
2919801;Macaúbas;2000;41806;11681;30125
2919900;Macururé;2000;8612;2355;6257
2919926;Madre de Deus;2000;12036;11599;437
2919959;Maetinga;2000;13686;1974;11712
2920007;Maiquinique;2000;7326;5208;2118
2920106;Mairi;2000;20085;9595;10490
2920205;Malhada;2000;15614;6073;9541
2920304;Malhada de Pedras;2000;8426;2348;6078
2920403;Manoel Vitorino;2000;16807;6783;10024
2920452;Mansidão;2000;11046;2334;8712
2920502;Maracás;2000;31683;18211;13472
2920601;Maragogipe;2000;41418;21043;20375
2920700;Maraú;2000;19621;2849;16772
2920809;Marcionílio Souza;2000;10775;5097;5678
2920908;Mascote;2000;16093;11853;4240
2921005;Mata de São João;2000;32568;24969;7599
2921054;Matina;2000;10242;2759;7483
2921104;Medeiros Neto;2000;21235;16027;5208
2921203;Miguel Calmon;2000;28267;14819;13448
2921302;Milagres;2000;12067;9359;2708
2921401;Mirangaba;2000;14261;4713;9548
2921450;Mirante;2000;12874;1279;11595
2921500;Monte Santo;2000;56139;7226;48913
2921609;Morpará;2000;8597;5494;3103
2921708;Morro do Chapéu;2000;34494;19793;14701
2921807;Mortugaba;2000;12598;4994;7604
2921906;Mucugê;2000;12959;3317;9642
2922003;Mucuri;2000;28062;18685;9377
2922052;Mulungu do Morro;2000;15119;6159;8960
2922102;Mundo Novo;2000;21273;11129;10144
2922201;Muniz Ferreira;2000;6941;3301;3640
2922250;Muquém do São Francisco;2000;9052;997;8055
2922300;Muritiba;2000;30644;17905;12739
2922409;Mutuípe;2000;20462;8984;11478
2922508;Nazaré;2000;26365;23011;3354
2922607;Nilo Peçanha;2000;11213;2495;8718
2922656;Nordestina;2000;11800;2875;8925
2922706;Nova Canaã;2000;15431;5973;9458
2922730;Nova Fátima;2000;7536;4441;3095
2922755;Nova Ibiá;2000;7166;2534;4632
2922805;Nova Itarana;2000;6592;2497;4095
2922854;Nova Redenção;2000;8636;4718;3918
2922904;Nova Soure;2000;24405;10869;13536
2923001;Nova Viçosa;2000;32076;24636;7440
2923035;Novo Horizonte;2000;8502;2000;6502
2923050;Novo Triunfo;2000;13905;5247;8658
2923100;Olindina;2000;23909;11152;12757
2923209;Oliveira dos Brejinhos;2000;21670;5817;15853
2923308;Ouriçangas;2000;7525;2303;5222
2923357;Ourolândia;2000;15356;4458;10898
2923407;Palmas de Monte Alto;2000;20099;6657;13442
2923506;Palmeiras;2000;7518;3999;3519
2923605;Paramirim;2000;18921;7883;11038
2923704;Paratinga;2000;27679;9067;18612
2923803;Paripiranga;2000;26591;7781;18810
2923902;Pau Brasil;2000;13048;8740;4308
2924009;Paulo Afonso;2000;96499;82584;13915
2924058;Pé de Serra;2000;13531;4111;9420
2924108;Pedrão;2000;6979;1176;5802
2924207;Pedro Alexandre;2000;17610;2131;15479
2924306;Piatã;2000;18977;5771;13206
2924405;Pilão Arcado;2000;30713;7865;22848
2924504;Pindaí;2000;15494;3631;11863
2924603;Pindobaçu;2000;20869;10456;10413
2924652;Pintadas;2000;10927;4076;6851
2924678;Piraí do Norte;2000;11239;2933;8306
2924702;Piripá;2000;16128;5248;10880
2924801;Piritiba;2000;19037;12728;6309
2924900;Planaltino;2000;7963;2990;4973
2925006;Planalto;2000;21707;12537;9170
2925105;Poções;2000;44213;31801;12412
2925204;Pojuca;2000;26203;21884;4319
2925253;Ponto Novo;2000;17187;6767;10420
2925303;Porto Seguro;2000;95721;79619;16102
2925402;Potiraguá;2000;14579;7546;7033
2925501;Prado;2000;26498;14169;12329
2925600;Presidente Dutra;2000;13730;7659;6071
2925709;Presidente Jânio Quadros;2000;17045;2913;14132
2925758;Presidente Tancredo Neves;2000;19642;6221;13421
2925808;Queimadas;2000;24613;9783;14830
2925907;Quijingue;2000;26376;4892;21484
2925931;Quixabeira;2000;9466;3130;6336
2925956;Rafael Jambeiro;2000;22600;4902;17698
2926004;Remanso;2000;36257;21015;15242
2926103;Retirolândia;2000;10891;5474;5417
2926202;Riachão das Neves;2000;21917;10257;11660
2926301;Riachão do Jacuípe;2000;31633;15569;16064
2926400;Riacho de Santana;2000;28643;11125;17518
2926509;Ribeira do Amparo;2000;13903;1459;12444
2926608;Ribeira do Pombal;2000;46270;25383;20887
2926657;Ribeirão do Largo;2000;15303;4451;10852
2926707;Rio de Contas;2000;13935;5684;8251
2926806;Rio do Antônio;2000;14637;5112;9525
2926905;Rio do Pires;2000;12010;4310;7700
2927002;Rio Real;2000;33260;19479;13781
2927101;Rodelas;2000;6260;4786;1474
2927200;Ruy Barbosa;2000;29026;20263;8763
2927309;Salinas da Margarida;2000;10377;4611;5766
2927408;Salvador;2000;2443107;2442102;1005
2927507;Santa Bárbara;2000;17933;6961;10972
2927606;Santa Brígida;2000;17354;4408;12946
2927705;Santa Cruz Cabrália;2000;23888;13527;10361
2927804;Santa Cruz da Vitória;2000;7025;4988;2037
2927903;Santa Inês;2000;11027;10374;653
2928000;Santaluz;2000;30955;17966;12989
2928059;Santa Luzia;2000;16061;8329;7732
2928109;Santa Maria da Vitória;2000;41261;22787;18474
2928208;Santana;2000;24139;12496;11643
2928307;Santanópolis;2000;8644;1250;7394
2928406;Santa Rita de Cássia;2000;24026;12185;11841
2928505;Santa Terezinha;2000;8696;1859;6837
2928604;Santo Amaro;2000;58414;44505;13909
2928703;Santo Antônio de Jesus;2000;77368;66245;11123
2928802;Santo Estêvão;2000;41145;19693;21452
2928901;São Desidério;2000;19006;7129;11877
2928950;São Domingos;2000;8618;3711;4907
2929008;São Félix;2000;13699;8748;4951
2929057;São Félix do Coribe;2000;11758;8552;3206
2929107;São Felipe;2000;20228;8250;11978
2929206;São Francisco do Conde;2000;26282;21870;4412
2929255;São Gabriel;2000;18687;9811;8876
2929305;São Gonçalo dos Campos;2000;27000;13552;13448
2929354;São José da Vitória;2000;6210;5065;1145
2929370;São José do Jacuípe;2000;9233;5701;3532
2929404;São Miguel das Matas;2000;10020;2772;7248
2929503;São Sebastião do Passé;2000;39960;29549;10411
2929602;Sapeaçu;2000;16450;7524;8926
2929701;Sátiro Dias;2000;17251;3426;13825
2929750;Saubara;2000;10193;10076;117
2929800;Saúde;2000;11488;5991;5497
2929909;Seabra;2000;39422;16749;22673
2930006;Sebastião Laranjeiras;2000;9283;3639;5644
2930105;Senhor do Bonfim;2000;67723;51343;16380
2930154;Serra do Ramalho;2000;32600;3742;28858
2930204;Sento Sé;2000;32461;17264;15197
2930303;Serra Dourada;2000;18347;5377;12970
2930402;Serra Preta;2000;17726;5692;12034
2930501;Serrinha;2000;83206;45943;37263
2930600;Serrolândia;2000;12616;6042;6574
2930709;Simões Filho;2000;94066;76905;17161
2930758;Sítio do Mato;2000;11752;6470;5282
2930766;Sítio do Quinto;2000;17031;4011;13020
2930774;Sobradinho;2000;21325;19610;1715
2930808;Souto Soares;2000;14795;5080;9715
2930907;Tabocas do Brejo Velho;2000;12619;3431;9188
2931004;Tanhaçu;2000;20559;7017;13542
2931053;Tanque Novo;2000;15771;5535;10236
2931103;Tanquinho;2000;7460;5310;2150
2931202;Taperoá;2000;15933;7523;8410
2931301;Tapiramutá;2000;17061;12425;4636
2931350;Teixeira de Freitas;2000;107486;99128;8358
2931400;Teodoro Sampaio;2000;8884;6627;2257
2931509;Teofilândia;2000;20432;5858;14574
2931608;Teolândia;2000;13141;3606;9535
2931707;Terra Nova;2000;12875;10984;1891
2931806;Tremedal;2000;21200;3503;17697
2931905;Tucano;2000;50948;18597;32351
2932002;Uauá;2000;26517;9608;16909
2932101;Ubaíra;2000;21227;8010;13217
2932200;Ubaitaba;2000;23854;18582;5272
2932309;Ubatã;2000;21803;17847;3956
2932408;Uibaí;2000;13614;7880;5734
2932457;Umburanas;2000;14140;6186;7954
2932507;Una;2000;31261;14021;17240
2932606;Urandi;2000;16076;4730;11346
2932705;Uruçuca;2000;20323;14158;6165
2932804;Utinga;2000;16889;11472;5417
2932903;Valença;2000;77509;55884;21625
2933000;Valente;2000;19145;9511;9634
2933059;Várzea da Roça;2000;13633;5847;7786
2933109;Várzea do Poço;2000;7515;4763;2752
2933158;Várzea Nova;2000;14154;8683;5471
2933174;Varzedo;2000;8673;2627;6046
2933208;Vera Cruz;2000;29750;27872;1878
2933257;Vereda;2000;7450;1276;6174
2933307;Vitória da Conquista;2000;262494;225545;36949
2933406;Wagner;2000;8976;6037;2939
2933455;Wanderley;2000;13649;5478;8171
2933505;Wenceslau Guimarães;2000;23926;6790;17136
2933604;Xique-Xique;2000;44718;31565;13153
3100104;Abadia dos Dourados;2000;6446;3584;2862
3100203;Abaeté;2000;22360;19022;3338
3100302;Abre Campo;2000;13348;5983;7365
3100401;Acaiaca;2000;3889;2385;1504
3100500;Açucena;2000;11489;4579;6910
3100609;Água Boa;2000;17956;4653;13303
3100708;Água Comprida;2000;2092;1254;838
3100807;Aguanil;2000;3562;1869;1693
3100906;Águas Formosas;2000;17845;12594;5251
3101003;Águas Vermelhas;2000;11878;8115;3763
3101102;Aimorés;2000;25105;18764;6341
3101201;Aiuruoca;2000;6469;3020;3449
3101300;Alagoa;2000;2800;952;1848
3101409;Albertina;2000;2841;1745;1096
3101508;Além Paraíba;2000;33610;31028;2582
3101607;Alfenas;2000;66957;62148;4809
3101631;Alfredo Vasconcelos;2000;5101;3148;1953
3101706;Almenara;2000;35385;27770;7615
3101805;Alpercata;2000;6966;5312;1654
3101904;Alpinópolis;2000;17031;13551;3480
3102001;Alterosa;2000;12976;8989;3987
3102050;Alto Caparaó;2000;4673;3329;1344
3102100;Alto Rio Doce;2000;13858;4912;8946
3102209;Alvarenga;2000;5212;2023;3189
3102308;Alvinópolis;2000;15588;10804;4784
3102407;Alvorada de Minas;2000;3527;1129;2398
3102506;Amparo do Serra;2000;5477;2506;2971
3102605;Andradas;2000;32968;24087;8881
3102704;Cachoeira de Pajeú;2000;8523;3135;5388
3102803;Andrelândia;2000;12310;9307;3003
3102852;Angelândia;2000;7468;2830;4638
3102902;Antônio Carlos;2000;10870;5931;4939
3103009;Antônio Dias;2000;10044;4450;5594
3103108;Antônio Prado de Minas;2000;1794;977;817
3103207;Araçaí;2000;2145;1761;384
3103306;Aracitaba;2000;2086;1405;681
3103405;Araçuaí;2000;35713;20461;15252
3103504;Araguari;2000;101974;92748;9226
3103603;Arantina;2000;2906;2662;244
3103702;Araponga;2000;7916;2541;5375
3103751;Araporã;2000;5309;4821;488
3103801;Arapuá;2000;2772;1716;1056
3103900;Araújos;2000;6217;5080;1137
3104007;Araxá;2000;78997;77743;1254
3104106;Arceburgo;2000;8035;6482;1553
3104205;Arcos;2000;32687;29343;3344
3104304;Areado;2000;12228;9790;2438
3104403;Argirita;2000;3173;2152;1021
3104452;Aricanduva;2000;4255;1067;3188
3104502;Arinos;2000;17709;10137;7572
3104601;Astolfo Dutra;2000;11805;10342;1463
3104700;Ataléia;2000;16747;7561;9186
3104809;Augusto de Lima;2000;5159;2291;2868
3104908;Baependi;2000;17523;11584;5939
3105004;Baldim;2000;8155;4818;3337
3105103;Bambuí;2000;21697;17672;4025
3105202;Bandeira;2000;5318;2341;2977
3105301;Bandeira do Sul;2000;4899;4124;775
3105400;Barão de Cocais;2000;23391;21307;2084
3105509;Barão de Monte Alto;2000;6232;3879;2353
3105608;Barbacena;2000;114126;103669;10457
3105707;Barra Longa;2000;7554;2244;5310
3105905;Barroso;2000;18359;17731;628
3106002;Bela Vista de Minas;2000;9846;9240;606
3106101;Belmiro Braga;2000;3427;950;2477
3106200;Belo Horizonte;2000;2238526;2238526;0
3106309;Belo Oriente;2000;19516;16217;3299
3106408;Belo Vale;2000;7651;3136;4515
3106507;Berilo;2000;12979;3031;9948
3106606;Bertópolis;2000;4436;2444;1992
3106655;Berizal;2000;3970;2067;1903
3106705;Betim;2000;306675;298304;8371
3106804;Bias Fortes;2000;4392;1641;2751
3106903;Bicas;2000;12793;11498;1295
3107000;Biquinhas;2000;2821;1644;1177
3107109;Boa Esperança;2000;37074;30392;6682
3107208;Bocaina de Minas;2000;5020;2205;2815
3107307;Bocaiúva;2000;42806;32446;10360
3107406;Bom Despacho;2000;39943;37221;2722
3107505;Bom Jardim de Minas;2000;6643;5452;1191
3107604;Bom Jesus da Penha;2000;3523;2293;1230
3107703;Bom Jesus do Amparo;2000;4817;2025;2792
3107802;Bom Jesus do Galho;2000;16173;9294;6879
3107901;Bom Repouso;2000;10855;5638;5218
3108008;Bom Sucesso;2000;17064;13659;3405
3108107;Bonfim;2000;6866;2556;4310
3108206;Bonfinópolis de Minas;2000;6443;4202;2241
3108255;Bonito de Minas;2000;7863;1420;6443
3108305;Borda da Mata;2000;14439;11202;3237
3108404;Botelhos;2000;15101;10544;4557
3108503;Botumirim;2000;6834;3306;3528
3108552;Brasilândia de Minas;2000;11473;9212;2261
3108602;Brasília de Minas;2000;31194;17580;13614
3108701;Brás Pires;2000;5107;1805;3302
3108800;Braúnas;2000;5408;1141;4267
3108909;Brazópolis;2000;15165;7694;7471
3109006;Brumadinho;2000;26614;19373;7241
3109105;Bueno Brandão;2000;10932;5241;5691
3109204;Buenópolis;2000;10515;7314;3201
3109253;Bugre;2000;3949;1298;2651
3109303;Buritis;2000;20396;13868;6528
3109402;Buritizeiro;2000;25904;21804;4100
3109451;Cabeceira Grande;2000;5920;4579;1341
3109501;Cabo Verde;2000;13727;6495;7232
3109600;Cachoeira da Prata;2000;3780;3549;231
3109709;Cachoeira de Minas;2000;10555;5795;4760
3109808;Cachoeira Dourada;2000;2305;1993;312
3109907;Caetanópolis;2000;8571;7400;1171
3110004;Caeté;2000;36299;31656;4643
3110103;Caiana;2000;4367;1751;2616
3110202;Cajuri;2000;4190;2287;1903
3110301;Caldas;2000;12766;7232;5534
3110400;Camacho;2000;3533;1302;2231
3110509;Camanducaia;2000;20537;14262;6275
3110608;Cambuí;2000;22969;17683;5286
3110707;Cambuquira;2000;12538;10023;2515
3110806;Campanário;2000;3419;2426;993
3110905;Campanha;2000;14098;11735;2363
3111002;Campestre;2000;20553;10372;10181
3111101;Campina Verde;2000;19100;13411;5689
3111150;Campo Azul;2000;3574;1322;2252
3111200;Campo Belo;2000;49187;45592;3595
3111309;Campo do Meio;2000;11436;10039;1397
3111408;Campo Florido;2000;5447;3007;2440
3111507;Campos Altos;2000;12819;11619;1200
3111606;Campos Gerais;2000;26541;17739;8802
3111705;Canaã;2000;4789;1419;3370
3111804;Canápolis;2000;10633;9010;1623
3111903;Cana Verde;2000;5664;3191;2473
3112000;Candeias;2000;14461;9172;5289
3112059;Cantagalo;2000;3838;1979;1859
3112109;Caparaó;2000;5000;1806;3194
3112208;Capela Nova;2000;4964;2066;2898
3112307;Capelinha;2000;31231;20066;11165
3112406;Capetinga;2000;7424;5909;1515
3112505;Capim Branco;2000;7900;7146;754
3112604;Capinópolis;2000;14403;13140;1263
3112653;Capitão Andrade;2000;4306;2624;1682
3112703;Capitão Enéas;2000;13113;9967;3146
3112802;Capitólio;2000;7737;5658;2079
3112901;Caputira;2000;8834;3434;5400
3113008;Caraí;2000;20981;6701;14280
3113107;Caranaíba;2000;3549;1268;2281
3113206;Carandaí;2000;21057;15781;5276
3113305;Carangola;2000;31921;24740;7181
3113404;Caratinga;2000;77789;62334;15455
3113503;Carbonita;2000;8967;5562;3405
3113602;Careaçu;2000;5810;4248;1562
3113701;Carlos Chagas;2000;21994;14190;7804
3113800;Carmésia;2000;2246;1083;1163
3113909;Carmo da Cachoeira;2000;11600;7527;4073
3114006;Carmo da Mata;2000;10400;7208;3192
3114105;Carmo de Minas;2000;12545;7730;4815
3114204;Carmo do Cajuru;2000;17157;14122;3035
3114303;Carmo do Paranaíba;2000;29460;24276;5184
3114402;Carmo do Rio Claro;2000;19732;13320;6412
3114501;Carmópolis de Minas;2000;14348;9075;5273
3114550;Carneirinho;2000;8910;5515;3395
3114600;Carrancas;2000;3887;2263;1624
3114709;Carvalhópolis;2000;3089;2137;952
3114808;Carvalhos;2000;4733;2532;2201
3114907;Casa Grande;2000;2264;1013;1251
3115003;Cascalho Rico;2000;2622;1073;1549
3115102;Cássia;2000;17278;13842;3436
3115201;Conceição da Barra de Minas;2000;4021;2674;1347
3115300;Cataguases;2000;63980;60482;3498
3115359;Catas Altas;2000;4241;2970;1271
3115409;Catas Altas da Noruega;2000;3288;1130;2158
3115458;Catuji;2000;7787;1691;6097
3115474;Catuti;2000;5337;2900;2437
3115508;Caxambu;2000;22129;21690;439
3115607;Cedro do Abaeté;2000;1289;1140;149
3115706;Central de Minas;2000;6548;5058;1490
3115805;Centralina;2000;10236;9346;890
3115904;Chácara;2000;2370;1651;719
3116001;Chalé;2000;5663;2511;3152
3116100;Chapada do Norte;2000;15225;4863;10362
3116159;Chapada Gaúcha;2000;7270;3080;4190
3116209;Chiador;2000;3020;1410;1610
3116308;Cipotânea;2000;6345;2418;3927
3116407;Claraval;2000;4338;2061;2277
3116506;Claro dos Poções;2000;8193;5057;3136
3116605;Cláudio;2000;22522;17189;5333
3116704;Coimbra;2000;6523;3488;3035
3116803;Coluna;2000;9369;3379;5990
3116902;Comendador Gomes;2000;2842;1174;1668
3117009;Comercinho;2000;10204;3340;6864
3117108;Conceição da Aparecida;2000;9372;5608;3764
3117207;Conceição das Pedras;2000;2714;1140;1574
3117306;Conceição das Alagoas;2000;17156;14429;2727
3117405;Conceição de Ipanema;2000;4377;1421;2956
3117504;Conceição do Mato Dentro;2000;18637;10636;8001
3117603;Conceição do Pará;2000;4793;1736;3057
3117702;Conceição do Rio Verde;2000;12273;10594;1679
3117801;Conceição dos Ouros;2000;8929;6477;2452
3117836;Cônego Marinho;2000;6477;764;5713
3117876;Confins;2000;4880;3126;1754
3117900;Congonhal;2000;8726;6122;2604
3118007;Congonhas;2000;41256;39458;1798
3118106;Congonhas do Norte;2000;4897;2225;2672
3118205;Conquista;2000;6101;4681;1420
3118304;Conselheiro Lafaiete;2000;102836;99515;3321
3118403;Conselheiro Pena;2000;21734;16611;5123
3118502;Consolação;2000;1736;850;886
3118601;Contagem;2000;538208;533521;4687
3118700;Coqueiral;2000;9612;6118;3494
3118809;Coração de Jesus;2000;25729;13948;11781
3118908;Cordisburgo;2000;8522;5688;2834
3119005;Cordislândia;2000;3359;2704;655
3119104;Corinto;2000;24546;21450;3096
3119203;Coroaci;2000;10802;4695;6107
3119302;Coromandel;2000;27452;20261;7191
3119401;Coronel Fabriciano;2000;97451;96255;1196
3119500;Coronel Murta;2000;9134;6496;2638
3119609;Coronel Pacheco;2000;2900;1802;1098
3119708;Coronel Xavier Chaves;2000;3185;1600;1585
3119807;Córrego Danta;2000;3674;1963;1711
3119906;Córrego do Bom Jesus;2000;3949;1388;2561
3119955;Córrego Fundo;2000;5179;3353;1826
3120003;Córrego Novo;2000;3638;2142;1496
3120102;Couto de Magalhães de Minas;2000;4007;3621;386
3120151;Crisólita;2000;5298;1364;3934
3120201;Cristais;2000;9518;6552;2966
3120300;Cristália;2000;5583;2595;2988
3120409;Cristiano Otoni;2000;4905;3496;1409
3120508;Cristina;2000;10339;5490;4849
3120607;Crucilândia;2000;4477;2251;2226
3120706;Cruzeiro da Fortaleza;2000;3720;3095;625
3120805;Cruzília;2000;13765;12141;1624
3120839;Cuparaque;2000;4367;3252;1115
3120870;Curral de Dentro;2000;5973;3566;2407
3120904;Curvelo;2000;67512;59197;8315
3121001;Datas;2000;5040;2622;2418
3121100;Delfim Moreira;2000;8032;2672;5360
3121209;Delfinópolis;2000;6577;4668;1909
3121258;Delta;2000;5065;4660;405
3121308;Descoberto;2000;4531;3251;1280
3121407;Desterro de Entre Rios;2000;6807;3040;3767
3121506;Desterro do Melo;2000;3272;1092;2180
3121605;Diamantina;2000;44259;37774;6485
3121704;Diogo de Vasconcelos;2000;3972;841;3131
3121803;Dionísio;2000;10191;5611;4580
3121902;Divinésia;2000;3188;1548;1640
3122009;Divino;2000;18420;8664;9756
3122108;Divino das Laranjeiras;2000;4965;2902;2063
3122207;Divinolândia de Minas;2000;6434;4809;1625
3122306;Divinópolis;2000;183962;177886;6076
3122355;Divisa Alegre;2000;4815;4656;159
3122405;Divisa Nova;2000;5539;4338;1201
3122454;Divisópolis;2000;6480;4904;1576
3122470;Dom Bosco;2000;4055;1832;2223
3122504;Dom Cavati;2000;5473;4752;721
3122603;Dom Joaquim;2000;4698;2715;1983
3122702;Dom Silvério;2000;5228;3835;1393
3122801;Dom Viçoso;2000;3133;944;2189
3122900;Dona Eusébia;2000;5362;4616;746
3123007;Dores de Campos;2000;8349;7170;1179
3123106;Dores de Guanhães;2000;5380;1672;3708
3123205;Dores do Indaiá;2000;14388;13306;1082
3123304;Dores do Turvo;2000;5103;1797;3305
3123403;Doresópolis;2000;1350;963;387
3123502;Douradoquara;2000;1785;1133;652
3123528;Durandé;2000;7005;2987;4018
3123601;Elói Mendes;2000;21947;17055;4892
3123700;Engenheiro Caldas;2000;9347;7309;2038
3123809;Engenheiro Navarro;2000;7085;4714;2371
3123858;Entre Folhas;2000;5054;3083;1971
3123908;Entre Rios de Minas;2000;13114;8390;4724
3124005;Ervália;2000;17252;7560;9692
3124104;Esmeraldas;2000;47090;38181;8909
3124203;Espera Feliz;2000;20528;11261;9267
3124302;Espinosa;2000;30978;16811;14167
3124401;Espírito Santo do Dourado;2000;4162;1469;2693
3124500;Estiva;2000;10366;4428;5938
3124609;Estrela Dalva;2000;2674;1801;873
3124708;Estrela do Indaiá;2000;3597;2651;946
3124807;Estrela do Sul;2000;6883;5040;1843
3124906;Eugenópolis;2000;9766;5662;4104
3125002;Ewbank da Câmara;2000;3608;3229;379
3125101;Extrema;2000;19219;12902;6317
3125200;Fama;2000;2353;1442;911
3125309;Faria Lemos;2000;3606;2277;1329
3125408;Felício dos Santos;2000;5729;1900;3829
3125507;São Gonçalo do Rio Preto;2000;2963;1584;1379
3125606;Felisburgo;2000;6289;4546;1743
3125705;Felixlândia;2000;12784;9447;3337
3125804;Fernandes Tourinho;2000;2563;1725;838
3125903;Ferros;2000;12331;4628;7703
3125952;Fervedouro;2000;9671;3715;5956
3126000;Florestal;2000;5647;3840;1807
3126109;Formiga;2000;62907;55597;7310
3126208;Formoso;2000;6522;3409;3113
3126307;Fortaleza de Minas;2000;3866;2652;1214
3126406;Fortuna de Minas;2000;2437;1515;922
3126505;Francisco Badaró;2000;10309;2511;7798
3126604;Francisco Dumont;2000;4488;2592;1896
3126703;Francisco Sá;2000;23743;13191;10552
3126752;Franciscópolis;2000;7323;2049;5274
3126802;Frei Gaspar;2000;6103;1707;4396
3126901;Frei Inocêncio;2000;8176;5911;2265
3126950;Frei Lagonegro;2000;3191;373;2818
3127008;Fronteira;2000;9024;6926;2098
3127057;Fronteira dos Vales;2000;4902;2929;1973
3127073;Fruta de Leite;2000;6777;2042;4735
3127107;Frutal;2000;46566;39012;7554
3127206;Funilândia;2000;3281;1592;1689
3127305;Galiléia;2000;7241;5714;1527
3127339;Gameleiras;2000;5263;792;4471
3127354;Glaucilândia;2000;2767;681;2086
3127370;Goiabeira;2000;2715;2116;599
3127388;Goianá;2000;3323;2412;911
3127404;Gonçalves;2000;4123;1057;3066
3127503;Gonzaga;2000;5713;2591;3122
3127602;Gouveia;2000;12004;7740;4264
3127701;Governador Valadares;2000;247131;236098;11033
3127800;Grão Mogol;2000;14224;4831;9393
3127909;Grupiara;2000;1376;1159;217
3128006;Guanhães;2000;27828;20938;6890
3128105;Guapé;2000;13620;6287;7333
3128204;Guaraciaba;2000;10262;2749;7513
3128253;Guaraciama;2000;4469;2406;2063
3128303;Guaranésia;2000;18628;15812;2816
3128402;Guarani;2000;8520;5847;2673
3128501;Guarará;2000;4166;3523;643
3128600;Guarda-Mor;2000;6681;3513;3168
3128709;Guaxupé;2000;47036;43005;4031
3128808;Guidoval;2000;7547;5304;2243
3128907;Guimarânia;2000;6384;5013;1371
3129004;Guiricema;2000;9343;4063;5280
3129103;Gurinhatã;2000;6883;2627;4256
3129202;Heliodora;2000;5657;4218;1439
3129301;Iapu;2000;9718;6395;3323
3129400;Ibertioga;2000;5140;3037;2103
3129509;Ibiá;2000;21044;17353;3691
3129608;Ibiaí;2000;7251;5141;2110
3129657;Ibiracatu;2000;6534;2673;3861
3129707;Ibiraci;2000;10229;6457;3772
3129806;Ibirité;2000;133044;132335;709
3129905;Ibitiúra de Minas;2000;3301;2049;1252
3130002;Ibituruna;2000;2755;1987;768
3130051;Icaraí de Minas;2000;9323;1681;7641
3130101;Igarapé;2000;24838;22977;1861
3130200;Igaratinga;2000;7355;5416;1939
3130309;Iguatama;2000;8269;6859;1410
3130408;Ijaci;2000;5064;4079;985
3130507;Ilicínea;2000;10532;7637;2895
3130556;Imbé de Minas;2000;5911;1652;4259
3130606;Inconfidentes;2000;6479;3217;3262
3130655;Indaiabira;2000;7425;1233;6192
3130705;Indianópolis;2000;5387;3249;2138
3130804;Ingaí;2000;2494;1469;1025
3130903;Inhapim;2000;24895;12670;12225
3131000;Inhaúma;2000;5195;3464;1731
3131109;Inimutaba;2000;6270;4161;2108
3131158;Ipaba;2000;14531;13156;1375
3131208;Ipanema;2000;16286;12260;4026
3131307;Ipatinga;2000;212496;210895;1601
3131406;Ipiaçu;2000;4026;3511;515
3131505;Ipuiúna;2000;8958;6589;2369
3131604;Iraí de Minas;2000;5903;4600;1303
3131703;Itabira;2000;98322;89703;8619
3131802;Itabirinha;2000;9809;6515;3294
3131901;Itabirito;2000;37901;35245;2656
3132008;Itacambira;2000;4558;656;3902
3132107;Itacarambi;2000;17455;13304;4151
3132206;Itaguara;2000;11302;7805;3497
3132305;Itaipé;2000;10846;4079;6767
3132404;Itajubá;2000;84135;76986;7149
3132503;Itamarandiba;2000;29400;17717;11683
3132602;Itamarati de Minas;2000;3791;2804;987
3132701;Itambacuri;2000;22668;13992;8676
3132800;Itambé do Mato Dentro;2000;2582;779;1803
3132909;Itamogi;2000;10723;7420;3303
3133006;Itamonte;2000;12197;6685;5512
3133105;Itanhandu;2000;12915;10252;2663
3133204;Itanhomi;2000;11572;7373;4199
3133303;Itaobim;2000;21271;16076;5195
3133402;Itapagipe;2000;11832;7008;4824
3133501;Itapecerica;2000;21235;16220;5015
3133600;Itapeva;2000;7361;3781;3580
3133709;Itatiaiuçu;2000;8517;5039;3478
3133758;Itaú de Minas;2000;13691;13313;378
3133808;Itaúna;2000;76862;71770;5092
3133907;Itaverava;2000;6388;2418;3970
3134004;Itinga;2000;13894;5738;8156
3134103;Itueta;2000;5641;2495;3146
3134202;Ituiutaba;2000;89091;83853;5238
3134301;Itumirim;2000;6391;4701;1690
3134400;Iturama;2000;28814;26829;1985
3134509;Itutinga;2000;4140;2719;1421
3134608;Jaboticatubas;2000;13530;7116;6414
3134707;Jacinto;2000;12087;8544;3543
3134806;Jacuí;2000;7389;3965;3424
3134905;Jacutinga;2000;19004;14316;4688
3135001;Jaguaraçu;2000;2855;2040;815
3135050;Jaíba;2000;27287;13148;14139
3135076;Jampruca;2000;4716;3154;1562
3135100;Janaúba;2000;61651;53891;7760
3135209;Januária;2000;63605;35923;27682
3135308;Japaraíba;2000;3473;1930;1543
3135357;Japonvar;2000;8121;2577;5544
3135407;Jeceaba;2000;6109;2831;3278
3135456;Jenipapo de Minas;2000;6490;2022;4468
3135506;Jequeri;2000;13658;6173;7485
3135605;Jequitaí;2000;8750;5981;2769
3135704;Jequitibá;2000;5171;1602;3569
3135803;Jequitinhonha;2000;22902;16079;6823
3135902;Jesuânia;2000;4823;2848;1975
3136009;Joaíma;2000;14682;9586;5095
3136108;Joanésia;2000;6802;2065;4737
3136207;João Monlevade;2000;66690;66372;318
3136306;João Pinheiro;2000;41368;32424;8944
3136405;Joaquim Felício;2000;3872;2162;1710
3136504;Jordânia;2000;9865;7058;2807
3136520;José Gonçalves de Minas;2000;4696;783;3913
3136553;José Raydan;2000;3647;848;2799
3136579;Josenópolis;2000;4253;2020;2233
3136603;Nova União;2000;5427;1429;3998
3136652;Juatuba;2000;16389;15929;460
3136702;Juiz de Fora;2000;456796;453002;3794
3136801;Juramento;2000;3901;1873;2028
3136900;Juruaia;2000;7680;3236;4444
3136959;Juvenília;2000;7148;4213;2935
3137007;Ladainha;2000;15832;3983;11849
3137106;Lagamar;2000;7710;4811;2899
3137205;Lagoa da Prata;2000;38758;37911;847
3137304;Lagoa dos Patos;2000;4454;2902;1552
3137403;Lagoa Dourada;2000;11486;6054;5432
3137502;Lagoa Formosa;2000;16483;10848;5635
3137536;Lagoa Grande;2000;7610;5480;2130
3137601;Lagoa Santa;2000;37872;35396;2476
3137700;Lajinha;2000;19528;11218;8310
3137809;Lambari;2000;18249;13701;4548
3137908;Lamim;2000;3587;1362;2225
3138005;Laranjal;2000;6234;4212;2022
3138104;Lassance;2000;6554;3203;3351
3138203;Lavras;2000;78772;74296;4476
3138302;Leandro Ferreira;2000;3227;1938;1289
3138351;Leme do Prado;2000;4736;1541;3195
3138401;Leopoldina;2000;50097;43493;6604
3138500;Liberdade;2000;5792;3894;1898
3138609;Lima Duarte;2000;15708;11309;4399
3138625;Limeira do Oeste;2000;6170;3681;2489
3138658;Lontra;2000;7640;4954;2686
3138674;Luisburgo;2000;6297;1339;4958
3138682;Luislândia;2000;6121;2208;3913
3138708;Luminárias;2000;5482;3734;1748
3138807;Luz;2000;16833;14550;2283
3138906;Machacalis;2000;6917;5891;1026
3139003;Machado;2000;34877;26941;7936
3139102;Madre de Deus de Minas;2000;4734;3438;1296
3139201;Malacacheta;2000;19916;10926;8990
3139250;Mamonas;2000;6138;1785;4353
3139300;Manga;2000;21959;13956;8003
3139409;Manhuaçu;2000;67123;52106;15017
3139508;Manhumirim;2000;20025;15723;4302
3139607;Mantena;2000;26872;19311;7561
3139706;Maravilhas;2000;6232;4102;2130
3139805;Mar de Espanha;2000;10567;9123;1444
3139904;Maria da Fé;2000;14607;7812;6795
3140001;Mariana;2000;46710;38679;8031
3140100;Marilac;2000;4424;3455;969
3140159;Mário Campos;2000;10535;7952;2583
3140209;Maripá de Minas;2000;2594;1871;723
3140308;Marliéria;2000;4044;885;3159
3140407;Marmelópolis;2000;3293;1461;1832
3140506;Martinho Campos;2000;11817;9300;2517
3140530;Martins Soares;2000;5685;2329;3356
3140555;Mata Verde;2000;7085;5689;1396
3140605;Materlândia;2000;4846;1852;2994
3140704;Mateus Leme;2000;24144;20394;3750
3140803;Matias Barbosa;2000;12323;11583;740
3140852;Matias Cardoso;2000;8600;3613;4987
3140902;Matipó;2000;16291;11679;4612
3141009;Mato Verde;2000;13185;9349;3836
3141108;Matozinhos;2000;30164;27664;2500
3141207;Matutina;2000;3838;2759;1079
3141306;Medeiros;2000;3038;1568;1470
3141405;Medina;2000;21641;14493;7148
3141504;Mendes Pimentel;2000;6286;2972;3314
3141603;Mercês;2000;10061;6155;3906
3141702;Mesquita;2000;6771;3314;3457
3141801;Minas Novas;2000;31134;7730;23404
3141900;Minduri;2000;3834;3305;529
3142007;Mirabela;2000;12552;9476;3076
3142106;Miradouro;2000;9770;4919;4851
3142205;Miraí;2000;12479;9442;3037
3142254;Miravânia;2000;4340;687;3653
3142304;Moeda;2000;4469;1569;2900
3142403;Moema;2000;6513;5819;694
3142502;Monjolos;2000;2579;1416;1163
3142601;Monsenhor Paulo;2000;7615;5313;2302
3142700;Montalvânia;2000;16031;8473;7558
3142809;Monte Alegre de Minas;2000;18006;12673;5333
3142908;Monte Azul;2000;23832;11478;12354
3143005;Monte Belo;2000;13142;8117;5025
3143104;Monte Carmelo;2000;43899;38231;5668
3143153;Monte Formoso;2000;4411;1379;3032
3143203;Monte Santo de Minas;2000;21212;15597;5615
3143302;Montes Claros;2000;306947;289183;17764
3143401;Monte Sião;2000;18195;12729;5466
3143450;Montezuma;2000;6573;2308;4265
3143500;Morada Nova de Minas;2000;7606;5708;1898
3143609;Morro da Garça;2000;3073;1418;1654
3143708;Morro do Pilar;2000;3735;2565;1170
3143807;Munhoz;2000;6656;3524;3132
3143906;Muriaé;2000;92101;83923;8178
3144003;Mutum;2000;26896;11914;14982
3144102;Muzambinho;2000;20589;14363;6226
3144201;Nacip Raydan;2000;3122;1995;1127
3144300;Nanuque;2000;41619;37781;3838
3144359;Naque;2000;5601;5237;364
3144375;Natalândia;2000;3293;2163;1130
3144409;Natércia;2000;4644;2814;1830
3144508;Nazareno;2000;7240;5541;1699
3144607;Nepomuceno;2000;24822;18116;6706
3144656;Ninheira;2000;9356;1942;7414
3144672;Nova Belém;2000;4495;914;3581
3144706;Nova Era;2000;17754;15325;2429
3144805;Nova Lima;2000;64387;63035;1352
3144904;Nova Módica;2000;4100;2012;2088
3145000;Nova Ponte;2000;9492;7441;2051
3145059;Nova Porteirinha;2000;7389;4182;3207
3145109;Nova Resende;2000;14051;7118;6933
3145208;Nova Serrana;2000;37447;35321;2126
3145307;Novo Cruzeiro;2000;30453;7504;22949
3145356;Novo Oriente de Minas;2000;9974;3836;6138
3145372;Novorizonte;2000;4610;1242;3368
3145406;Olaria;2000;2304;844;1460
3145455;Olhos-d'Água;2000;4284;1890;2394
3145505;Olímpio Noronha;2000;2247;1693;554
3145604;Oliveira;2000;37250;32213;5037
3145703;Oliveira Fortes;2000;2145;1070;1075
3145802;Onça de Pitangui;2000;2985;872;2113
3145851;Oratórios;2000;4502;2729;1773
3145877;Orizânia;2000;6457;1705;4752
3145901;Ouro Branco;2000;30383;26303;4080
3146008;Ouro Fino;2000;29416;20434;8982
3146107;Ouro Preto;2000;66277;56292;9985
3146206;Ouro Verde de Minas;2000;6223;3330;2893
3146255;Padre Carvalho;2000;5227;2970;2257
3146305;Padre Paraíso;2000;17475;10687;6788
3146404;Paineiras;2000;4895;3420;1475
3146503;Pains;2000;7798;5629;2169
3146552;Pai Pedro;2000;5832;1592;4240
3146602;Paiva;2000;1622;1069;553
3146701;Palma;2000;6561;4865;1696
3146750;Palmópolis;2000;8886;4470;4416
3146909;Papagaios;2000;12472;10207;2265
3147006;Paracatu;2000;75216;63014;12202
3147105;Pará de Minas;2000;73007;67993;5014
3147204;Paraguaçu;2000;18942;14554;4388
3147303;Paraisópolis;2000;17498;12990;4508
3147402;Paraopeba;2000;20383;17283;3100
3147501;Passabém;2000;1946;652;1294
3147600;Passa Quatro;2000;14855;11320;3535
3147709;Passa Tempo;2000;8480;6131;2349
3147808;Passa Vinte;2000;2164;1283;881
3147907;Passos;2000;97211;89911;7300
3147956;Patis;2000;5164;2034;3130
3148004;Patos de Minas;2000;124056;111333;12723
3148103;Patrocínio;2000;73278;63000;10278
3148202;Patrocínio do Muriaé;2000;4861;3402;1459
3148301;Paula Cândido;2000;9109;3886;5223
3148400;Paulistas;2000;5113;2097;3016
3148509;Pavão;2000;8912;5177;3735
3148608;Peçanha;2000;17183;7934;9249
3148707;Pedra Azul;2000;23608;20090;3518
3148756;Pedra Bonita;2000;7288;1303;5985
3148806;Pedra do Anta;2000;3925;2079;1846
3148905;Pedra do Indaiá;2000;3814;1818;1996
3149002;Pedra Dourada;2000;1822;1121;701
3149101;Pedralva;2000;12009;5318;6691
3149150;Pedras de Maria da Cruz;2000;8871;4983;3888
3149200;Pedrinópolis;2000;3361;2863;498
3149309;Pedro Leopoldo;2000;53957;43479;10478
3149408;Pedro Teixeira;2000;1787;828;959
3149507;Pequeri;2000;3016;2627;389
3149606;Pequi;2000;3717;2556;1161
3149705;Perdigão;2000;5707;4425;1282
3149804;Perdizes;2000;12364;6833;5531
3149903;Perdões;2000;18736;15749;2987
3149952;Periquito;2000;7445;5444;2001
3150000;Pescador;2000;4037;2992;1045
3150109;Piau;2000;3008;1613;1395
3150158;Piedade de Caratinga;2000;5347;3059;2288
3150208;Piedade de Ponte Nova;2000;4029;2523;1506
3150307;Piedade do Rio Grande;2000;5063;3065;1998
3150406;Piedade dos Gerais;2000;4274;1584;2690
3150505;Pimenta;2000;7824;6134;1690
3150539;Pingo d'Água;2000;3820;3470;350
3150570;Pintópolis;2000;6949;2204;4745
3150604;Piracema;2000;6509;2764;3745
3150703;Pirajuba;2000;2741;2155;586
3150802;Piranga;2000;17257;5079;12178
3150901;Piranguçu;2000;4974;1692;3282
3151008;Piranguinho;2000;7399;4607;2792
3151107;Pirapetinga;2000;10034;8413;1621
3151206;Pirapora;2000;50300;49377;923
3151305;Piraúba;2000;11140;8502;2638
3151404;Pitangui;2000;22269;18629;3640
3151503;Piumhi;2000;28783;25225;3558
3151602;Planura;2000;8297;7729;568
3151701;Poço Fundo;2000;15148;8414;6734
3151800;Poços de Caldas;2000;135627;130826;4801
3151909;Pocrane;2000;9851;5147;4704
3152006;Pompéu;2000;26089;22286;3803
3152105;Ponte Nova;2000;55303;48997;6306
3152131;Ponto Chique;2000;3651;2120;1531
3152170;Ponto dos Volantes;2000;10529;3060;7469
3152204;Porteirinha;2000;37890;18140;19750
3152303;Porto Firme;2000;9474;3897;5577
3152402;Poté;2000;14780;8201;6579
3152501;Pouso Alegre;2000;106776;97756;9020
3152600;Pouso Alto;2000;6813;3232;3581
3152709;Prados;2000;7703;4941;2762
3152808;Prata;2000;23576;16535;7041
3152907;Pratápolis;2000;9217;7658;1559
3153004;Pratinha;2000;2969;1638;1331
3153103;Presidente Bernardes;2000;5847;1365;4482
3153202;Presidente Juscelino;2000;4455;1889;2566
3153301;Presidente Kubitschek;2000;2951;1737;1214
3153400;Presidente Olegário;2000;17781;11099;6682
3153509;Alto Jequitibá;2000;8458;4011;4447
3153608;Prudente de Morais;2000;8232;7864;368
3153707;Quartel Geral;2000;3082;2341;741
3153806;Queluzito;2000;1791;673;1118
3153905;Raposos;2000;14289;13455;834
3154002;Raul Soares;2000;24287;14299;9988
3154101;Recreio;2000;10188;9057;1131
3154150;Reduto;2000;5991;3071;2920
3154200;Resende Costa;2000;10336;7181;3155
3154309;Resplendor;2000;16975;13267;3708
3154408;Ressaquinha;2000;4557;2503;2054
3154457;Riachinho;2000;7973;3899;4074
3154507;Riacho dos Machados;2000;9358;3084;6274
3154606;Ribeirão das Neves;2000;246846;245401;1445
3154705;Ribeirão Vermelho;2000;3621;3312;309
3154804;Rio Acima;2000;7658;6850;808
3154903;Rio Casca;2000;15260;11477;3783
3155009;Rio Doce;2000;2318;1372;946
3155108;Rio do Prado;2000;5390;2892;2498
3155207;Rio Espera;2000;6942;2238;4704
3155306;Rio Manso;2000;4646;2862;1784
3155405;Rio Novo;2000;8550;7264;1286
3155504;Rio Paranaíba;2000;11734;5973;5761
3155603;Rio Pardo de Minas;2000;27237;10495;16742
3155702;Rio Piracicaba;2000;14138;10898;3240
3155801;Rio Pomba;2000;16359;13290;3069
3155900;Rio Preto;2000;5142;3864;1278
3156007;Rio Vermelho;2000;14905;5012;9893
3156106;Ritápolis;2000;5423;3502;1921
3156205;Rochedo de Minas;2000;1907;1703;204
3156304;Rodeiro;2000;5375;4309;1066
3156403;Romaria;2000;3737;2662;1075
3156452;Rosário da Limeira;2000;3869;1649;2220
3156502;Rubelita;2000;10199;2521;7678
3156601;Rubim;2000;9666;7534;2132
3156700;Sabará;2000;115352;112694;2658
3156809;Sabinópolis;2000;16269;9688;6581
3156908;Sacramento;2000;21334;15890;5444
3157005;Salinas;2000;36720;26278;10442
3157104;Salto da Divisa;2000;6779;5571;1208
3157203;Santa Bárbara;2000;24180;21294;2886
3157252;Santa Bárbara do Leste;2000;7349;2946;4403
3157278;Santa Bárbara do Monte Verde;2000;2366;1242;1124
3157302;Santa Bárbara do Tugúrio;2000;4827;1801;3026
3157336;Santa Cruz de Minas;2000;7042;7042;0
3157377;Santa Cruz de Salinas;2000;4801;911;3890
3157401;Santa Cruz do Escalvado;2000;5378;1644;3734
3157500;Santa Efigênia de Minas;2000;4924;2486;2438
3157609;Santa Fé de Minas;2000;4192;2207;1985
3157658;Santa Helena de Minas;2000;5753;2762;2991
3157708;Santa Juliana;2000;8078;6633;1445
3157807;Santa Luzia;2000;184903;184208;695
3157906;Santa Margarida;2000;13754;6314;7440
3158003;Santa Maria de Itabira;2000;10346;6025;4321
3158102;Santa Maria do Salto;2000;5438;3693;1745
3158201;Santa Maria do Suaçuí;2000;14350;9907;4443
3158300;Santana da Vargem;2000;7521;4697;2824
3158409;Santana de Cataguases;2000;3360;2613;747
3158508;Santana de Pirapama;2000;8616;2894;5722
3158607;Santana do Deserto;2000;3774;1225;2549
3158706;Santana do Garambéu;2000;1982;1253;729
3158805;Santana do Jacaré;2000;4408;4163;245
3158904;Santana do Manhuaçu;2000;8607;4196;4411
3158953;Santana do Paraíso;2000;18155;17197;958
3159001;Santana do Riacho;2000;3739;1728;2011
3159100;Santana dos Montes;2000;3944;2066;1878
3159209;Santa Rita de Caldas;2000;9500;5489;4011
3159308;Santa Rita de Jacutinga;2000;5218;3602;1616
3159357;Santa Rita de Minas;2000;5795;3988;1807
3159407;Santa Rita de Ibitipoca;2000;3847;2149;1698
3159506;Santa Rita do Itueto;2000;6061;1790;4271
3159605;Santa Rita do Sapucaí;2000;31264;25519;5745
3159704;Santa Rosa da Serra;2000;3114;1870;1244
3159803;Santa Vitória;2000;16365;12544;3821
3159902;Santo Antônio do Amparo;2000;16109;14052;2057
3160009;Santo Antônio do Aventureiro;2000;3606;2037;1569
3160108;Santo Antônio do Grama;2000;4377;3238;1139
3160207;Santo Antônio do Itambé;2000;4588;1171;3417
3160306;Santo Antônio do Jacinto;2000;12144;6104;6040
3160405;Santo Antônio do Monte;2000;23473;19042;4431
3160454;Santo Antônio do Retiro;2000;6655;1257;5398
3160504;Santo Antônio do Rio Abaixo;2000;1823;750;1073
3160603;Santo Hipólito;2000;3488;2127;1361
3160702;Santos Dumont;2000;46789;40402;6387
3160801;São Bento Abade;2000;3737;3452;285
3160900;São Brás do Suaçuí;2000;3282;2718;564
3160959;São Domingos das Dores;2000;5192;2232;2960
3161007;São Domingos do Prata;2000;17642;9122;8520
3161056;São Félix de Minas;2000;3454;1492;1962
3161106;São Francisco;2000;52553;27835;24718
3161205;São Francisco de Paula;2000;6533;4085;2448
3161304;São Francisco de Sales;2000;5274;3215;2059
3161403;São Francisco do Glória;2000;5696;3101;2595
3161502;São Geraldo;2000;7716;5344;2372
3161601;São Geraldo da Piedade;2000;5015;1126;3889
3161650;São Geraldo do Baixio;2000;2864;1522;1342
3161700;São Gonçalo do Abaeté;2000;5432;3895;1537
3161809;São Gonçalo do Pará;2000;7969;6213;1756
3161908;São Gonçalo do Rio Abaixo;2000;8462;3759;4703
3162005;São Gonçalo do Sapucaí;2000;22308;18132;4176
3162104;São Gotardo;2000;27631;24821;2810
3162203;São João Batista do Glória;2000;6271;4783;1488
3162252;São João da Lagoa;2000;4400;1928;2472
3162302;São João da Mata;2000;2752;1706;1046
3162401;São João da Ponte;2000;26028;7862;18166
3162450;São João das Missões;2000;10473;2003;8471
3162500;São João del Rei;2000;78616;73675;4941
3162559;São João do Manhuaçu;2000;8716;3681;5035
3162575;São João do Manteninha;2000;4406;2040;2366
3162609;São João do Oriente;2000;8492;6503;1989
3162658;São João do Pacuí;2000;3664;1525;2139
3162708;São João do Paraíso;2000;21010;8231;12779
3162807;São João Evangelista;2000;15526;9282;6244
3162906;São João Nepomuceno;2000;23786;22332;1454
3162922;São Joaquim de Bicas;2000;18152;13716;4436
3162948;São José da Barra;2000;6053;4319;1734
3162955;São José da Lapa;2000;15000;8904;6096
3163003;São José da Safira;2000;3894;2725;1169
3163102;São José da Varginha;2000;3225;1486;1739
3163201;São José do Alegre;2000;3802;2556;1246
3163300;São José do Divino;2000;3863;2456;1407
3163409;São José do Goiabal;2000;6009;3449;2560
3163508;São José do Jacuri;2000;6789;1714;5075
3163607;São José do Mantimento;2000;2379;1285;1094
3163706;São Lourenço;2000;36927;36927;0
3163805;São Miguel do Anta;2000;6641;3331;3310
3163904;São Pedro da União;2000;5618;2740;2878
3164001;São Pedro dos Ferros;2000;9239;7036;2203
3164100;São Pedro do Suaçuí;2000;6081;2440;3641
3164209;São Romão;2000;7783;5169;2614
3164308;São Roque de Minas;2000;6325;3728;2597
3164407;São Sebastião da Bela Vista;2000;4311;2364;1947
3164431;São Sebastião da Vargem Alegre;2000;2632;1223;1409
3164472;São Sebastião do Anta;2000;4779;2792;1987
3164506;São Sebastião do Maranhão;2000;11604;3098;8506
3164605;São Sebastião do Oeste;2000;4656;1624;3032
3164704;São Sebastião do Paraíso;2000;58335;51962;6373
3164803;São Sebastião do Rio Preto;2000;1779;590;1189
3164902;São Sebastião do Rio Verde;2000;1976;1022;954
3165008;São Tiago;2000;10245;7463;2782
3165107;São Tomás de Aquino;2000;7303;5368;1935
3165206;São Thomé das Letras;2000;6204;3212;2992
3165305;São Vicente de Minas;2000;6163;5453;710
3165404;Sapucaí-Mirim;2000;5455;2654;2801
3165503;Sardoá;2000;4775;1741;3034
3165537;Sarzedo;2000;17274;14738;2536
3165552;Setubinha;2000;9291;1432;7859
3165560;Sem-Peixe;2000;3170;1167;2003
3165578;Senador Amaral;2000;5128;2980;2148
3165602;Senador Cortes;2000;2000;1091;909
3165701;Senador Firmino;2000;6598;3998;2600
3165800;Senador José Bento;2000;2452;854;1598
3165909;Senador Modestino Gonçalves;2000;5190;1371;3819
3166006;Senhora de Oliveira;2000;5643;2722;2921
3166105;Senhora do Porto;2000;3520;1317;2203
3166204;Senhora dos Remédios;2000;10277;2850;7427
3166303;Sericita;2000;6990;3019;3971
3166402;Seritinga;2000;1738;1222;516
3166501;Serra Azul de Minas;2000;4238;1661;2577
3166600;Serra da Saudade;2000;873;533;340
3166709;Serra dos Aimorés;2000;8182;6498;1684
3166808;Serra do Salitre;2000;9390;6604;2786
3166907;Serrania;2000;7504;6226;1278
3166956;Serranópolis de Minas;2000;4038;1567;2471
3167004;Serranos;2000;2071;1595;476
3167103;Serro;2000;21012;11791;9221
3167202;Sete Lagoas;2000;184871;180366;4505
3167301;Silveirânia;2000;2138;1000;1138
3167400;Silvianópolis;2000;5855;3046;2809
3167509;Simão Pereira;2000;2479;1334;1145
3167608;Simonésia;2000;16875;6484;10391
3167707;Sobrália;2000;6284;3900;2384
3167806;Soledade de Minas;2000;5155;3312;1843
3167905;Tabuleiro;2000;4572;2508;2064
3168002;Taiobeiras;2000;27347;21795;5552
3168051;Taparuba;2000;3225;1355;1870
3168101;Tapira;2000;3327;2216;1111
3168200;Tapiraí;2000;1900;1133;767
3168309;Taquaraçu de Minas;2000;3529;1123;2405
3168408;Tarumirim;2000;14488;6005;8483
3168507;Teixeiras;2000;11149;6949;4200
3168606;Teófilo Otoni;2000;129424;102812;26612
3168705;Timóteo;2000;71478;71310;168
3168804;Tiradentes;2000;5759;4167;1592
3168903;Tiros;2000;7571;4829;2742
3169000;Tocantins;2000;15005;11347;3658
3169059;Tocos do Moji;2000;3821;818;3003
3169109;Toledo;2000;5222;1952;3270
3169208;Tombos;2000;11652;8317;3335
3169307;Três Corações;2000;65291;58419;6872
3169356;Três Marias;2000;23568;22515;1053
3169406;Três Pontas;2000;51024;40670;10354
3169505;Tumiritinga;2000;5831;3871;1960
3169604;Tupaciguara;2000;23117;20621;2496
3169703;Turmalina;2000;15655;9300;6355
3169802;Turvolândia;2000;4243;2156;2087
3169901;Ubá;2000;85065;76687;8378
3170008;Ubaí;2000;10774;4621;6153
3170057;Ubaporanga;2000;11902;5578;6324
3170107;Uberaba;2000;252365;244171;8194
3170206;Uberlândia;2000;501214;488982;12232
3170305;Umburatiba;2000;2872;1603;1269
3170404;Unaí;2000;70033;55549;14484
3170438;União de Minas;2000;4638;2272;2366
3170479;Uruana de Minas;2000;3263;1679;1584
3170503;Urucânia;2000;10375;7069;3306
3170529;Urucuia;2000;9615;4379;5236
3170578;Vargem Alegre;2000;6544;4824;1720
3170602;Vargem Bonita;2000;2212;1180;1032
3170651;Vargem Grande do Rio Pardo;2000;4457;1958;2499
3170701;Varginha;2000;108998;104165;4833
3170750;Varjão de Minas;2000;4701;3489;1212
3170800;Várzea da Palma;2000;31641;27632;4009
3170909;Varzelândia;2000;19169;8531;10638
3171006;Vazante;2000;18928;14928;4000
3171030;Verdelândia;2000;7179;3687;3492
3171071;Veredinha;2000;5257;3120;2137
3171105;Veríssimo;2000;2959;1475;1484
3171154;Vermelho Novo;2000;4572;1373;3199
3171204;Vespasiano;2000;76422;75213;1209
3171303;Viçosa;2000;64854;59792;5062
3171402;Vieiras;2000;3952;1785;2167
3171501;Mathias Lobato;2000;3642;3283;359
3171600;Virgem da Lapa;2000;13672;5883;7789
3171709;Virgínia;2000;8699;3371;5328
3171808;Virginópolis;2000;10827;5634;5193
3171907;Virgolândia;2000;6112;3180;2932
3172004;Visconde do Rio Branco;2000;32598;25889;6709
3172103;Volta Grande;2000;4919;3477;1442
3172202;Wenceslau Braz;2000;2596;1186;1410
3200102;Afonso Cláudio;2000;32232;14463;17769
3200136;Águia Branca;2000;9599;2341;7258
3200169;Água Doce do Norte;2000;12835;6113;6722
3200201;Alegre;2000;31714;19741;11973
3200300;Alfredo Chaves;2000;13616;5614;8002
3200359;Alto Rio Novo;2000;6964;3568;3396
3200409;Anchieta;2000;19217;13272;5945
3200508;Apiacá;2000;7615;4886;2729
3200607;Aracruz;2000;64637;54458;10179
3200706;Atílio Vivacqua;2000;8327;4055;4272
3200805;Baixo Guandu;2000;27819;19676;8143
3200904;Barra de São Francisco;2000;37597;20492;17105
3201001;Boa Esperança;2000;13679;9169;4510
3201100;Bom Jesus do Norte;2000;9226;8332;894
3201159;Brejetuba;2000;11687;1753;9934
3201209;Cachoeiro de Itapemirim;2000;174879;155401;19478
3201308;Cariacica;2000;324285;312980;11305
3201407;Castelo;2000;32756;17549;15207
3201506;Colatina;2000;112711;91298;21413
3201605;Conceição da Barra;2000;26494;19319;7175
3201704;Conceição do Castelo;2000;10910;4368;6542
3201803;Divino de São Lourenço;2000;4817;1612;3205
3201902;Domingos Martins;2000;30559;5820;24739
3202009;Dores do Rio Preto;2000;6188;3185;3003
3202108;Ecoporanga;2000;23979;12894;11085
3202207;Fundão;2000;13009;10801;2208
3202306;Guaçuí;2000;25492;19192;6300
3202405;Guarapari;2000;88400;82589;5811
3202454;Ibatiba;2000;19210;10596;8614
3202504;Ibiraçu;2000;10143;7404;2739
3202553;Ibitirama;2000;9211;2610;6601
3202603;Iconha;2000;11481;4793;6688
3202652;Irupi;2000;10354;3537;6817
3202702;Itaguaçu;2000;14495;7037;7458
3202801;Itapemirim;2000;28121;16133;11988
3202900;Itarana;2000;11425;3476;7949
3203007;Iúna;2000;26112;13875;12237
3203056;Jaguaré;2000;19539;10699;8840
3203106;Jerônimo Monteiro;2000;10189;6730;3459
3203130;João Neiva;2000;15301;10055;5246
3203163;Laranja da Terra;2000;10934;2853;8081
3203205;Linhares;2000;112617;92917;19700
3203304;Mantenópolis;2000;12201;7369;4832
3203320;Marataízes;2000;30603;23757;6846
3203346;Marechal Floriano;2000;12188;5270;6918
3203353;Marilândia;2000;9924;3981;5943
3203403;Mimoso do Sul;2000;26199;13283;12916
3203502;Montanha;2000;17263;12932;4331
3203601;Mucurici;2000;5900;3170;2730
3203700;Muniz Freire;2000;19689;7211;12478
3203809;Muqui;2000;13670;8642;5028
3203908;Nova Venécia;2000;43015;27390;15625
3204005;Pancas;2000;20402;8842;11560
3204054;Pedro Canário;2000;21961;20192;1769
3204104;Pinheiros;2000;21320;13970;7350
3204203;Piúma;2000;14987;14101;886
3204252;Ponto Belo;2000;6263;4867;1396
3204302;Presidente Kennedy;2000;9555;2530;7025
3204351;Rio Bananal;2000;16324;4347;11977
3204401;Rio Novo do Sul;2000;11271;5780;5491
3204500;Santa Leopoldina;2000;12463;2466;9997
3204559;Santa Maria de Jetibá;2000;28774;5102;23672
3204609;Santa Teresa;2000;20622;9714;10908
3204658;São Domingos do Norte;2000;7687;2734;4953
3204708;São Gabriel da Palha;2000;26588;18365;8223
3204807;São José do Calçado;2000;10481;6959;3522
3204906;São Mateus;2000;90460;69004;21456
3204955;São Roque do Canaã;2000;10395;4446;5949
3205002;Serra;2000;321181;319621;1560
3205010;Sooretama;2000;18269;11419;6850
3205036;Vargem Alta;2000;17376;4922;12454
3205069;Venda Nova do Imigrante;2000;16165;9912;6253
3205101;Viana;2000;53452;49597;3855
3205150;Vila Pavão;2000;8330;1863;6467
3205176;Vila Valério;2000;13875;4093;9782
3205200;Vila Velha;2000;345965;344625;1340
3205309;Vitória;2000;292304;292304;0
3300100;Angra dos Reis;2000;119247;114300;4947
3300159;Aperibé;2000;8018;6842;1176
3300209;Araruama;2000;82803;75088;7715
3300225;Areal;2000;9899;8954;945
3300233;Armação dos Búzios;2000;18204;18204;0
3300258;Arraial do Cabo;2000;23877;23877;0
3300308;Barra do Piraí;2000;88503;84816;3687
3300407;Barra Mansa;2000;170753;165134;5619
3300456;Belford Roxo;2000;434474;434474;0
3300506;Bom Jardim;2000;22651;11317;11334
3300605;Bom Jesus do Itabapoana;2000;33655;27425;6230
3300704;Cabo Frio;2000;126828;106237;20591
3300803;Cachoeiras de Macacu;2000;48543;41117;7426
3300902;Cambuci;2000;14670;9946;4724
3300936;Carapebus;2000;8666;6875;1791
3300951;Comendador Levy Gasparian;2000;7924;7310;614
3301009;Campos dos Goytacazes;2000;407168;364177;42991
3301108;Cantagalo;2000;19835;13698;6137
3301157;Cardoso Moreira;2000;12595;8041;4554
3301207;Carmo;2000;15289;11056;4233
3301306;Casimiro de Abreu;2000;22152;18769;3383
3301405;Conceição de Macabu;2000;18782;16542;2240
3301504;Cordeiro;2000;18601;17756;845
3301603;Duas Barras;2000;10334;6023;4311
3301702;Duque de Caxias;2000;775456;772327;3129
3301801;Engenheiro Paulo de Frontin;2000;12164;8766;3398
3301850;Guapimirim;2000;37952;25593;12359
3301876;Iguaba Grande;2000;15089;15089;0
3301900;Itaboraí;2000;187479;177260;10219
3302007;Itaguaí;2000;82003;78208;3795
3302056;Italva;2000;12621;8611;4010
3302106;Itaocara;2000;23003;15928;7075
3302205;Itaperuna;2000;86720;76864;9856
3302254;Itatiaia;2000;24739;11728;13011
3302270;Japeri;2000;83278;83278;0
3302304;Laje do Muriaé;2000;7909;5624;2285
3302403;Macaé;2000;132461;126007;6454
3302452;Macuco;2000;4886;3925;961
3302502;Magé;2000;205830;194193;11637
3302601;Mangaratiba;2000;24901;19860;5041
3302700;Maricá;2000;76737;63399;13338
3302809;Mendes;2000;17289;17123;166
3302908;Miguel Pereira;2000;23902;20081;3821
3303005;Miracema;2000;27064;23757;3307
3303104;Natividade;2000;15125;11741;3384
3303203;Nilópolis;2000;153712;153712;0
3303302;Niterói;2000;459451;459451;0
3303401;Nova Friburgo;2000;173418;151851;21567
3303500;Nova Iguaçu;2000;920599;920599;0
3303609;Paracambi;2000;40475;36868;3607
3303708;Paraíba do Sul;2000;37410;32688;4722
3303807;Paraty;2000;29544;14066;15478
3303856;Paty do Alferes;2000;24931;16756;8175
3303906;Petrópolis;2000;286537;270295;16242
3303955;Pinheiral;2000;19481;17672;1809
3304003;Piraí;2000;22118;18070;4048
3304102;Porciúncula;2000;16093;12018;4075
3304110;Porto Real;2000;12095;11388;707
3304128;Quatis;2000;10730;9469;1261
3304144;Queimados;2000;121993;121993;0
3304151;Quissamã;2000;13674;7699;5975
3304201;Resende;2000;104549;95963;8586
3304300;Rio Bonito;2000;49691;32450;17241
3304409;Rio Claro;2000;16228;11616;4612
3304508;Rio das Flores;2000;7625;5364;2261
3304524;Rio das Ostras;2000;36419;34552;1867
3304557;Rio de Janeiro;2000;5857904;5857904;0
3304607;Santa Maria Madalena;2000;10476;5530;4946
3304706;Santo Antônio de Pádua;2000;38692;29415;9277
3304755;São Francisco de Itabapoana;2000;41475;19738;21737
3304805;São Fidélis;2000;36789;26513;10276
3304904;São Gonçalo;2000;891119;891119;0
3305000;São João da Barra;2000;27682;19631;8051
3305109;São João de Meriti;2000;449476;449476;0
3305133;São José de Ubá;2000;6413;2326;4087
3305158;São José do Vale do Rio Preto;2000;19278;9007;10271
3305208;São Pedro da Aldeia;2000;63227;52141;11086
3305307;São Sebastião do Alto;2000;8402;3677;4725
3305406;Sapucaia;2000;17157;12161;4996
3305505;Saquarema;2000;52461;50422;2039
3305554;Seropédica;2000;65260;51897;13363
3305604;Silva Jardim;2000;21265;14215;7050
3305703;Sumidouro;2000;14176;2334;11842
3305752;Tanguá;2000;26057;22448;3609
3305802;Teresópolis;2000;138081;115198;22883
3305901;Trajano de Moraes;2000;10212;3711;6501
3306008;Três Rios;2000;71976;67347;4629
3306107;Valença;2000;66308;57323;8985
3306156;Varre-Sai;2000;7854;4132;3722
3306206;Vassouras;2000;31451;19886;11565
3306305;Volta Redonda;2000;242063;242053;10
3500105;Adamantina;2000;33497;30368;3129
3500204;Adolfo;2000;3684;3071;613
3500303;Aguaí;2000;28195;24708;3487
3500402;Águas da Prata;2000;7131;6075;1056
3500501;Águas de Lindóia;2000;16190;15463;727
3500550;Águas de Santa Bárbara;2000;5224;3943;1281
3500600;Águas de São Pedro;2000;1883;1883;0
3500709;Agudos;2000;32484;30692;1792
3500758;Alambari;2000;3650;2444;1206
3500808;Alfredo Marcondes;2000;3697;2735;962
3500907;Altair;2000;3554;2609;945
3501004;Altinópolis;2000;15481;11977;3504
3501103;Alto Alegre;2000;4261;3017;1244
3501152;Alumínio;2000;15252;13727;1525
3501202;Álvares Florence;2000;4316;2654;1662
3501301;Álvares Machado;2000;22661;19826;2835
3501400;Álvaro de Carvalho;2000;4109;2437;1672
3501509;Alvinlândia;2000;2837;2431;406
3501608;Americana;2000;182593;182159;434
3501707;Américo Brasiliense;2000;28287;27641;646
3501806;Américo de Campos;2000;5594;4388;1206
3501905;Amparo;2000;60404;43357;17047
3502002;Analândia;2000;3582;2650;932
3502101;Andradina;2000;55161;50836;4325
3502200;Angatuba;2000;19297;13240;6057
3502309;Anhembi;2000;4535;3265;1270
3502408;Anhumas;2000;3411;2507;904
3502507;Aparecida;2000;34904;34382;522
3502606;Aparecida d'Oeste;2000;4935;3633;1302
3502705;Apiaí;2000;27162;16648;10514
3502754;Araçariguama;2000;11154;7240;3914
3502804;Araçatuba;2000;169254;164449;4805
3502903;Araçoiaba da Serra;2000;20112;13113;6999
3503000;Aramina;2000;4763;4145;618
3503109;Arandu;2000;6065;4022;2043
3503158;Arapeí;2000;2618;1899;719
3503208;Araraquara;2000;182471;173569;8902
3503307;Araras;2000;104196;97860;6336
3503356;Arco-Íris;2000;2163;1068;1095
3503406;Arealva;2000;7244;5245;1999
3503505;Areias;2000;3600;2452;1148
3503604;Areiópolis;2000;10296;8560;1736
3503703;Ariranha;2000;7477;6884;593
3503802;Artur Nogueira;2000;33124;30464;2660
3503901;Arujá;2000;59185;56630;2555
3503950;Aspásia;2000;1861;1175;686
3504008;Assis;2000;87251;83388;3863
3504107;Atibaia;2000;111300;96874;14426
3504206;Auriflama;2000;13513;11888;1625
3504305;Avaí;2000;4596;3196;1400
3504404;Avanhandava;2000;8829;8100;729
3504503;Avaré;2000;76472;72387;4085
3504602;Bady Bassitt;2000;11550;10274;1276
3504701;Balbinos;2000;1313;1062;251
3504800;Bálsamo;2000;7340;6338;1002
3504909;Bananal;2000;9713;7079;2634
3505005;Barão de Antonina;2000;2794;1648;1146
3505104;Barbosa;2000;5837;4875;962
3505203;Bariri;2000;28224;26050;2174
3505302;Barra Bonita;2000;35487;34537;950
3505351;Barra do Chapéu;2000;4846;1448;3398
3505401;Barra do Turvo;2000;8108;2880;5228
3505500;Barretos;2000;103913;98847;5066
3505609;Barrinha;2000;24207;23944;263
3505708;Barueri;2000;208281;208281;0
3505807;Bastos;2000;20588;17040;3548
3505906;Batatais;2000;51112;48285;2827
3506003;Bauru;2000;316064;310442;5622
3506102;Bebedouro;2000;74815;69964;4851
3506201;Bento de Abreu;2000;2394;1948;446
3506300;Bernardino de Campos;2000;10720;9326;1394
3506359;Bertioga;2000;30039;29178;861
3506409;Bilac;2000;6088;5364;724
3506508;Birigui;2000;94300;91018;3282
3506607;Biritiba Mirim;2000;24653;20778;3875
3506706;Boa Esperança do Sul;2000;12573;10753;1820
3506805;Bocaina;2000;9442;8546;896
3506904;Bofete;2000;7384;4777;2607
3507001;Boituva;2000;34368;32537;1831
3507100;Bom Jesus dos Perdões;2000;13313;11223;2090
3507159;Bom Sucesso de Itararé;2000;3231;1954;1277
3507209;Borá;2000;795;623;172
3507308;Boracéia;2000;3739;3259;480
3507407;Borborema;2000;13193;10850;2343
3507456;Borebi;2000;1933;1478;455
3507506;Botucatu;2000;108306;103993;4313
3507605;Bragança Paulista;2000;125031;111091;13940
3507704;Braúna;2000;4383;3416;967
3507753;Brejo Alegre;2000;2308;1781;527
3507803;Brodowski;2000;17139;16285;854
3507902;Brotas;2000;18886;16127;2759
3508009;Buri;2000;17629;13409;4220
3508108;Buritama;2000;13854;12635;1219
3508207;Buritizal;2000;3674;2815;859
3508306;Cabrália Paulista;2000;4656;3992;664
3508405;Cabreúva;2000;33100;25760;7340
3508504;Caçapava;2000;76130;66741;9389
3508603;Cachoeira Paulista;2000;27205;21671;5534
3508702;Caconde;2000;18378;11817;6561
3508801;Cafelândia;2000;15793;13056;2737
3508900;Caiabu;2000;4077;3115;962
3509007;Caieiras;2000;71221;68481;2740
3509106;Caiuá;2000;4192;1769;2423
3509205;Cajamar;2000;50761;48084;2677
3509254;Cajati;2000;29227;20677;8550
3509304;Cajobi;2000;9174;8356;818
3509403;Cajuru;2000;21085;18337;2748
3509452;Campina do Monte Alegre;2000;5209;4180;1029
3509502;Campinas;2000;969396;953030;16366
3509601;Campo Limpo Paulista;2000;63724;62260;1464
3509700;Campos do Jordão;2000;44252;43809;443
3509809;Campos Novos Paulista;2000;4181;2988;1193
3509908;Cananéia;2000;12298;10204;2094
3509957;Canas;2000;3614;3041;573
3510005;Cândido Mota;2000;29280;26549;2731
3510104;Cândido Rodrigues;2000;2613;1946;667
3510153;Canitar;2000;3481;2678;803
3510203;Capão Bonito;2000;46732;36587;10145
3510302;Capela do Alto;2000;14247;11111;3136
3510401;Capivari;2000;41468;33484;7984
3510500;Caraguatatuba;2000;78921;75251;3670
3510609;Carapicuíba;2000;344596;344596;0
3510708;Cardoso;2000;11605;10356;1249
3510807;Casa Branca;2000;26800;21629;5171
3510906;Cássia dos Coqueiros;2000;2871;1665;1206
3511003;Castilho;2000;14948;11959;2989
3511102;Catanduva;2000;105847;104268;1579
3511201;Catiguá;2000;6555;5914;641
3511300;Cedral;2000;6700;4980;1720
3511409;Cerqueira César;2000;15144;13057;2087
3511508;Cerquilho;2000;29508;27996;1512
3511607;Cesário Lange;2000;12883;8921;3962
3511706;Charqueada;2000;13037;11719;1318
3511904;Clementina;2000;5404;4958;446
3512001;Colina;2000;16664;14885;1779
3512100;Colômbia;2000;5954;4120;1834
3512209;Conchal;2000;22676;20297;2379
3512308;Conchas;2000;14904;11165;3739
3512407;Cordeirópolis;2000;17591;16068;1523
3512506;Coroados;2000;4417;3308;1109
3512605;Coronel Macedo;2000;5589;4011;1578
3512704;Corumbataí;2000;3794;1718;2076
3512803;Cosmópolis;2000;44355;42468;1887
3512902;Cosmorama;2000;7372;4304;3068
3513009;Cotia;2000;148987;148987;0
3513108;Cravinhos;2000;28411;27182;1229
3513207;Cristais Paulista;2000;6579;3898;2681
3513306;Cruzália;2000;2610;1594;1016
3513405;Cruzeiro;2000;73492;71179;2313
3513504;Cubatão;2000;108309;107661;648
3513603;Cunha;2000;23090;11134;11956
3513702;Descalvado;2000;28921;24136;4785
3513801;Diadema;2000;357064;357064;0
3513850;Dirce Reis;2000;1623;1075;548
3513900;Divinolândia;2000;12016;6875;5141
3514007;Dobrada;2000;7007;6505;502
3514106;Dois Córregos;2000;22522;20232;2290
3514205;Dolcinópolis;2000;2152;1810;342
3514304;Dourado;2000;8606;7839;767
3514403;Dracena;2000;40500;37153;3347
3514502;Duartina;2000;12475;10783;1692
3514601;Dumont;2000;6307;5870;437
3514700;Echaporã;2000;6827;5186;1641
3514809;Eldorado;2000;14134;6974;7160
3514908;Elias Fausto;2000;13888;10269;3619
3514924;Elisiário;2000;2577;2229;348
3514957;Embaúba;2000;2478;1979;499
3515004;Embu das Artes;2000;207663;207663;0
3515103;Embu-Guaçu;2000;56916;55839;1077
3515129;Emilianópolis;2000;2893;2191;702
3515152;Engenheiro Coelho;2000;10033;7009;3024
3515186;Espírito Santo do Pinhal;2000;40480;34753;5727
3515194;Espírito Santo do Turvo;2000;3677;3241;436
3515202;Estrela d'Oeste;2000;8256;6402;1854
3515301;Estrela do Norte;2000;2625;1786;839
3515350;Euclides da Cunha Paulista;2000;10214;6431;3783
3515400;Fartura;2000;15010;11379;3631
3515509;Fernandópolis;2000;61647;59143;2504
3515608;Fernando Prestes;2000;5434;4113;1321
3515657;Fernão;2000;1432;625;807
3515707;Ferraz de Vasconcelos;2000;142377;141208;1169
3515806;Flora Rica;2000;2177;1568;609
3515905;Floreal;2000;3223;2469;754
3516002;Flórida Paulista;2000;11106;8982;2124
3516101;Florínea;2000;3127;2637;490
3516200;Franca;2000;287737;282203;5534
3516309;Francisco Morato;2000;133738;133575;163
3516408;Franco da Rocha;2000;108122;100272;7850
3516507;Gabriel Monteiro;2000;2726;1952;774
3516606;Gália;2000;7853;5589;2264
3516705;Garça;2000;43162;36386;6776
3516804;Gastão Vidigal;2000;3586;2936;650
3516853;Gavião Peixoto;2000;4126;2749;1377
3516903;General Salgado;2000;10824;8749;2075
3517000;Getulina;2000;10370;7534;2836
3517109;Glicério;2000;4428;3095;1333
3517208;Guaiçara;2000;9211;8070;1141
3517307;Guaimbê;2000;5207;4266;941
3517406;Guaíra;2000;34610;32274;2336
3517505;Guapiaçu;2000;14086;11882;2204
3517604;Guapiara;2000;19726;7539;12187
3517703;Guará;2000;18916;17959;957
3517802;Guaraçaí;2000;8894;6524;2370
3517901;Guaraci;2000;8846;7391;1455
3518008;Guarani d'Oeste;2000;2006;1734;272
3518107;Guarantã;2000;6323;4848;1475
3518206;Guararapes;2000;28843;26130;2713
3518305;Guararema;2000;21904;17710;4194
3518404;Guaratinguetá;2000;104219;99162;5057
3518503;Guareí;2000;10197;6086;4111
3518602;Guariba;2000;31085;30223;862
3518701;Guarujá;2000;264812;264736;76
3518800;Guarulhos;2000;1072717;1049668;23049
3518859;Guatapará;2000;6371;4022;2349
3518909;Guzolândia;2000;4295;3364;931
3519006;Herculândia;2000;7992;6827;1165
3519055;Holambra;2000;7211;3938;3273
3519071;Hortolândia;2000;152523;152523;0
3519105;Iacanga;2000;8282;7074;1208
3519204;Iacri;2000;6783;4775;2008
3519253;Iaras;2000;3054;1895;1159
3519303;Ibaté;2000;26462;25112;1350
3519402;Ibirá;2000;9447;8303;1144
3519501;Ibirarema;2000;5701;5093;608
3519600;Ibitinga;2000;46620;43860;2760
3519709;Ibiúna;2000;64384;21356;43028
3519808;Icém;2000;6772;5747;1025
3519907;Iepê;2000;7257;5958;1299
3520004;Igaraçu do Tietê;2000;22614;22389;225
3520103;Igarapava;2000;25925;24037;1888
3520202;Igaratá;2000;8292;5877;2415
3520301;Iguape;2000;27427;21934;5493
3520400;Ilhabela;2000;20836;20589;247
3520426;Ilha Comprida;2000;6704;6704;0
3520442;Ilha Solteira;2000;23996;23218;778
3520509;Indaiatuba;2000;147050;144740;2310
3520608;Indiana;2000;4932;4061;871
3520707;Indiaporã;2000;4058;3188;870
3520806;Inúbia Paulista;2000;3318;2764;554
3520905;Ipaussu;2000;12553;11030;1523
3521002;Iperó;2000;18384;12649;5735
3521101;Ipeúna;2000;4340;3420;920
3521150;Ipiguá;2000;3476;1944;1532
3521200;Iporanga;2000;4562;2076;2486
3521309;Ipuã;2000;11870;11193;677
3521408;Iracemápolis;2000;15555;14810;745
3521507;Irapuã;2000;6658;5429;1229
3521606;Irapuru;2000;7457;5629;1828
3521705;Itaberá;2000;18911;11100;7811
3521804;Itaí;2000;21039;16903;4136
3521903;Itajobi;2000;14295;10868;3427
3522000;Itaju;2000;2638;1644;994
3522109;Itanhaém;2000;71995;71148;847
3522158;Itaoca;2000;3226;2174;1052
3522208;Itapecerica da Serra;2000;129685;128327;1358
3522307;Itapetininga;2000;125559;112137;13422
3522406;Itapeva;2000;82866;60954;21912
3522505;Itapevi;2000;162433;162433;0
3522604;Itapira;2000;63377;58042;5335
3522653;Itapirapuã Paulista;2000;3577;1652;1925
3522703;Itápolis;2000;37750;32140;5610
3522802;Itaporanga;2000;14354;9931;4423
3522901;Itapuí;2000;10371;9588;783
3523008;Itapura;2000;3838;3332;506
3523107;Itaquaquecetuba;2000;272942;272942;0
3523206;Itararé;2000;46554;42806;3748
3523305;Itariri;2000;13858;7445;6413
3523404;Itatiba;2000;81197;65925;15272
3523503;Itatinga;2000;15446;13533;1913
3523602;Itirapina;2000;12836;11178;1658
3523701;Itirapuã;2000;5412;4312;1100
3523800;Itobi;2000;7466;6204;1262
3523909;Itu;2000;135366;123942;11424
3524006;Itupeva;2000;26166;19259;6907
3524105;Ituverava;2000;36268;34221;2047
3524204;Jaborandi;2000;6424;5857;567
3524303;Jaboticabal;2000;67408;63840;3568
3524402;Jacareí;2000;191291;182555;8736
3524501;Jaci;2000;4180;2819;1360
3524600;Jacupiranga;2000;17041;10043;6998
3524709;Jaguariúna;2000;29597;25812;3785
3524808;Jales;2000;46186;42339;3847
3524907;Jambeiro;2000;3992;1866;2126
3525003;Jandira;2000;91807;91807;0
3525102;Jardinópolis;2000;30729;28066;2663
3525201;Jarinu;2000;17041;10984;6057
3525300;Jaú;2000;112104;107198;4906
3525409;Jeriquara;2000;3280;2510;770
3525508;Joanópolis;2000;10409;10409;0
3525607;João Ramalho;2000;3842;3075;767
3525706;José Bonifácio;2000;28714;25019;3695
3525805;Júlio Mesquita;2000;4166;3850;316
3525854;Jumirim;2000;2196;1093;1103
3525904;Jundiaí;2000;323397;300207;23190
3526001;Junqueirópolis;2000;17005;13420;3585
3526100;Juquiá;2000;20516;12440;8076
3526209;Juquitiba;2000;26459;17387;9072
3526308;Lagoinha;2000;4957;2877;2080
3526407;Laranjal Paulista;2000;22145;19582;2563
3526506;Lavínia;2000;5131;4134;997
3526605;Lavrinhas;2000;6008;5307;701
3526704;Leme;2000;80757;77888;2869
3526803;Lençóis Paulista;2000;55042;52350;2692
3526902;Limeira;2000;249046;238349;10697
3527009;Lindóia;2000;5331;4716;615
3527108;Lins;2000;65952;64218;1734
3527207;Lorena;2000;77990;75097;2893
3527256;Lourdes;2000;2007;1552;455
3527306;Louveira;2000;23903;21888;2015
3527405;Lucélia;2000;18316;15698;2618
3527504;Lucianópolis;2000;2154;1668;486
3527603;Luís Antônio;2000;7160;6558;602
3527702;Luiziânia;2000;4274;3705;569
3527801;Lupércio;2000;4230;2109;2121
3527900;Lutécia;2000;2897;2144;753
3528007;Macatuba;2000;15752;14993;759
3528106;Macaubal;2000;7385;6248;1137
3528205;Macedônia;2000;3781;2682;1099
3528304;Magda;2000;3486;2761;725
3528403;Mairinque;2000;39975;34340;5635
3528502;Mairiporã;2000;60111;48077;12034
3528601;Manduri;2000;8271;6455;1816
3528700;Marabá Paulista;2000;3784;2048;1736
3528809;Maracaí;2000;13004;11420;1584
3528858;Marapoama;2000;2238;1544;694
3528908;Mariápolis;2000;3854;2803;1051
3529005;Marília;2000;197342;189737;7605
3529104;Marinópolis;2000;2195;1647;548
3529203;Martinópolis;2000;22346;17975;4371
3529302;Matão;2000;71753;69168;2585
3529401;Mauá;2000;363392;363392;0
3529500;Mendonça;2000;3759;2764;995
3529609;Meridiano;2000;4025;2657;1368
3529658;Mesópolis;2000;1930;1100;830
3529708;Miguelópolis;2000;19019;17561;1458
3529807;Mineiros do Tietê;2000;11410;10962;448
3529906;Miracatu;2000;22383;10912;11471
3530003;Mira Estrela;2000;2596;1941;655
3530102;Mirandópolis;2000;25936;22287;3649
3530201;Mirante do Paranapanema;2000;16213;9709;6504
3530300;Mirassol;2000;48327;46575;1752
3530409;Mirassolândia;2000;3741;3124;617
3530508;Mococa;2000;65574;57284;8290
3530607;Mogi das Cruzes;2000;330241;302116;28125
3530706;Mogi Guaçu;2000;124228;116184;8044
3530805;Mogi Mirim;2000;81467;72725;8742
3530904;Mombuca;2000;3107;2271;836
3531001;Monções;2000;2055;1743;312
3531100;Mongaguá;2000;35098;34942;156
3531209;Monte Alegre do Sul;2000;6321;3282;3039
3531308;Monte Alto;2000;43613;40765;2848
3531407;Monte Aprazível;2000;18413;15937;2476
3531506;Monte Azul Paulista;2000;19553;17563;1990
3531605;Monte Castelo;2000;4089;3004;1085
3531704;Monteiro Lobato;2000;3615;1515;2100
3531803;Monte Mor;2000;37340;34173;3167
3531902;Morro Agudo;2000;25428;22802;2626
3532009;Morungaba;2000;9911;7786;2125
3532058;Motuca;2000;3871;2446;1425
3532108;Murutinga do Sul;2000;3971;2594;1377
3532157;Nantes;2000;2269;1584;685
3532207;Narandiba;2000;3743;2282;1461
3532306;Natividade da Serra;2000;6952;2853;4099
3532405;Nazaré Paulista;2000;14485;5830;8655
3532504;Neves Paulista;2000;8907;7744;1163
3532603;Nhandeara;2000;10194;7879;2315
3532702;Nipoã;2000;3267;2726;541
3532801;Nova Aliança;2000;4768;3619;1149
3532827;Nova Campina;2000;7295;3907;3388
3532843;Nova Canaã Paulista;2000;2483;822;1661
3532868;Nova Castilho;2000;1042;486;556
3532900;Nova Europa;2000;7307;6475;832
3533007;Nova Granada;2000;17020;15039;1981
3533106;Nova Guataporanga;2000;2087;1728;359
3533205;Nova Independência;2000;2063;1504;559
3533254;Novais;2000;3225;2615;610
3533304;Nova Luzitânia;2000;2749;2235;514
3533403;Nova Odessa;2000;42071;41110;961
3533502;Novo Horizonte;2000;32432;28917;3515
3533601;Nuporanga;2000;6309;5073;1236
3533700;Ocauçu;2000;4164;3005;1159
3533809;Óleo;2000;2994;1773;1221
3533908;Olímpia;2000;46013;42643;3370
3534005;Onda Verde;2000;3413;2319;1094
3534104;Oriente;2000;5884;5062;822
3534203;Orindiúva;2000;4161;3683;478
3534302;Orlândia;2000;36004;35208;796
3534401;Osasco;2000;652593;652593;0
3534500;Oscar Bressane;2000;2552;1855;697
3534609;Osvaldo Cruz;2000;29648;26141;3507
3534708;Ourinhos;2000;93868;89376;4492
3534757;Ouroeste;2000;6290;4661;1629
3534807;Ouro Verde;2000;7148;6345;803
3534906;Pacaembu;2000;12518;9497;3021
3535002;Palestina;2000;9100;7228;1872
3535101;Palmares Paulista;2000;8437;8106;331
3535200;Palmeira d'Oeste;2000;10322;7085;3237
3535309;Palmital;2000;20701;16792;3909
3535408;Panorama;2000;13649;12665;984
3535507;Paraguaçu Paulista;2000;39618;36625;2993
3535606;Paraibuna;2000;17009;5295;11714
3535705;Paraíso;2000;5429;4457;972
3535804;Paranapanema;2000;15510;11668;3842
3535903;Paranapuã;2000;3632;3029;603
3536000;Parapuã;2000;11104;8494;2610
3536109;Pardinho;2000;4732;2867;1865
3536208;Pariquera-Açu;2000;17649;11722;5927
3536257;Parisi;2000;1948;1507;441
3536307;Patrocínio Paulista;2000;11416;8606;2810
3536406;Paulicéia;2000;5302;3781;1521
3536505;Paulínia;2000;51326;50762;564
3536570;Paulistânia;2000;1891;1209;682
3536604;Paulo de Faria;2000;8472;7443;1029
3536703;Pederneiras;2000;36614;34092;2522
3536802;Pedra Bela;2000;5609;1205;4404
3536901;Pedranópolis;2000;2734;1652;1082
3537008;Pedregulho;2000;14994;10909;4085
3537107;Pedreira;2000;35219;34132;1087
3537156;Pedrinhas Paulista;2000;2861;2314;547
3537206;Pedro de Toledo;2000;9187;6159;3028
3537305;Penápolis;2000;54635;50620;4015
3537404;Pereira Barreto;2000;25028;23142;1886
3537503;Pereiras;2000;6226;4166;2060
3537602;Peruíbe;2000;51451;50370;1081
3537701;Piacatu;2000;4625;3807;818
3537800;Piedade;2000;50131;22057;28074
3537909;Pilar do Sul;2000;23948;17472;6476
3538006;Pindamonhangaba;2000;126026;119078;6948
3538105;Pindorama;2000;13109;12146;963
3538204;Pinhalzinho;2000;10986;5291;5695
3538303;Piquerobi;2000;3478;2454;1024
3538501;Piquete;2000;15200;14209;991
3538600;Piracaia;2000;23347;23347;0
3538709;Piracicaba;2000;329158;317374;11784
3538808;Piraju;2000;27897;24296;3601
3538907;Pirajuí;2000;20095;16267;3828
3539004;Pirangi;2000;10038;8687;1351
3539103;Pirapora do Bom Jesus;2000;12395;12395;0
3539202;Pirapozinho;2000;22104;20715;1389
3539301;Pirassununga;2000;64864;57594;7270
3539400;Piratininga;2000;10584;8857;1727
3539509;Pitangueiras;2000;31156;29306;1850
3539608;Planalto;2000;3670;2829;841
3539707;Platina;2000;2867;2119;748
3539806;Poá;2000;95801;94672;1129
3539905;Poloni;2000;4774;4264;510
3540002;Pompéia;2000;18171;16722;1449
3540101;Pongaí;2000;3693;2909;784
3540200;Pontal;2000;29681;28585;1096
3540259;Pontalinda;2000;3539;2682;857
3540309;Pontes Gestal;2000;2539;1935;604
3540408;Populina;2000;4450;3425;1025
3540507;Porangaba;2000;6652;3471;3181
3540606;Porto Feliz;2000;45514;36604;8910
3540705;Porto Ferreira;2000;47437;45568;1869
3540754;Potim;2000;13605;12967;638
3540804;Potirendaba;2000;13656;11684;1972
3540853;Pracinha;2000;1431;1186;245
3540903;Pradópolis;2000;12912;11875;1037
3541000;Praia Grande;2000;193582;193582;0
3541059;Pratânia;2000;3950;2661;1289
3541109;Presidente Alves;2000;4317;3213;1104
3541208;Presidente Bernardes;2000;14662;9929;4733
3541307;Presidente Epitácio;2000;39298;36355;2943
3541406;Presidente Prudente;2000;189186;185229;3957
3541505;Presidente Venceslau;2000;37347;34554;2793
3541604;Promissão;2000;31105;25635;5470
3541653;Quadra;2000;2651;670;1981
3541703;Quatá;2000;11655;10548;1107
3541802;Queiroz;2000;2171;1590;581
3541901;Queluz;2000;9112;7846;1266
3542008;Quintana;2000;5443;4915;528
3542107;Rafard;2000;8360;7169;1191
3542206;Rancharia;2000;28772;24461;4311
3542305;Redenção da Serra;2000;4047;1627;2420
3542404;Regente Feijó;2000;16998;15266;1732
3542503;Reginópolis;2000;4742;3647;1095
3542602;Registro;2000;53752;43066;10686
3542701;Restinga;2000;5584;4142;1442
3542800;Ribeira;2000;3507;1006;2501
3542909;Ribeirão Bonito;2000;11246;9959;1287
3543006;Ribeirão Branco;2000;21231;8985;12246
3543105;Ribeirão Corrente;2000;3881;2939;942
3543204;Ribeirão do Sul;2000;4497;2859;1638
3543238;Ribeirão dos Índios;2000;2222;1760;462
3543253;Ribeirão Grande;2000;7390;2325;5065
3543303;Ribeirão Pires;2000;104508;104508;0
3543402;Ribeirão Preto;2000;504923;502760;2163
3543501;Riversul;2000;7192;5042;2150
3543600;Rifaina;2000;3325;2976;349
3543709;Rincão;2000;10330;8257;2073
3543808;Rinópolis;2000;10255;7948;2307
3543907;Rio Claro;2000;168218;163477;4741
3544004;Rio das Pedras;2000;23494;21954;1540
3544103;Rio Grande da Serra;2000;37091;37091;0
3544202;Riolândia;2000;8560;6860;1700
3544251;Rosana;2000;24229;6198;18031
3544301;Roseira;2000;8577;8013;564
3544400;Rubiácea;2000;2337;1268;1069
3544509;Rubinéia;2000;2615;1838;777
3544608;Sabino;2000;4951;4090;861
3544707;Sagres;2000;2439;1578;861
3544806;Sales;2000;4563;3559;1004
3544905;Sales Oliveira;2000;9325;7841;1484
3545001;Salesópolis;2000;14357;8741;5616
3545100;Salmourão;2000;4401;3561;840
3545159;Saltinho;2000;5799;4813;986
3545209;Salto;2000;93159;92065;1094
3545308;Salto de Pirapora;2000;35072;27384;7688
3545407;Salto Grande;2000;8444;7387;1057
3545506;Sandovalina;2000;3089;1750;1339
3545605;Santa Adélia;2000;13449;12070;1379
3545704;Santa Albertina;2000;5586;4433;1153
3545803;Santa Bárbara d'Oeste;2000;170078;167917;2161
3546009;Santa Branca;2000;13010;11721;1289
3546108;Santa Clara d'Oeste;2000;2123;1464;659
3546207;Santa Cruz da Conceição;2000;3531;2017;1514
3546256;Santa Cruz da Esperança;2000;1796;1197;599
3546306;Santa Cruz das Palmeiras;2000;25556;24029;1527
3546405;Santa Cruz do Rio Pardo;2000;40919;35120;5799
3546504;Santa Ernestina;2000;5741;4374;1367
3546603;Santa Fé do Sul;2000;26512;24911;1601
3546702;Santa Gertrudes;2000;15906;15528;378
3546801;Santa Isabel;2000;43740;33014;10726
3546900;Santa Lúcia;2000;7853;7045;808
3547007;Santa Maria da Serra;2000;4673;3950;723
3547106;Santa Mercedes;2000;2803;2231;572
3547205;Santana da Ponte Pensa;2000;1894;1106;788
3547304;Santana de Parnaíba;2000;74828;74828;0
3547403;Santa Rita d'Oeste;2000;2695;1554;1141
3547502;Santa Rita do Passa Quatro;2000;26138;22366;3772
3547601;Santa Rosa de Viterbo;2000;21435;20196;1239
3547650;Santa Salete;2000;1379;541;838
3547700;Santo Anastácio;2000;20749;19044;1705
3547809;Santo André;2000;649331;649331;0
3547908;Santo Antônio da Alegria;2000;5764;4194;1570
3548005;Santo Antônio de Posse;2000;18124;14326;3798
3548054;Santo Antônio do Aracanguá;2000;6929;4536;2393
3548104;Santo Antônio do Jardim;2000;6154;3274;2880
3548203;Santo Antônio do Pinhal;2000;6328;3031;3297
3548302;Santo Expedito;2000;2526;2001;525
3548401;Santópolis do Aguapeí;2000;3816;3587;229
3548500;Santos;2000;417983;415747;2236
3548609;São Bento do Sapucaí;2000;10355;4520;5835
3548708;São Bernardo do Campo;2000;703177;690917;12260
3548807;São Caetano do Sul;2000;140159;140159;0
3548906;São Carlos;2000;192998;183433;9565
3549003;São Francisco;2000;2863;2055;808
3549102;São João da Boa Vista;2000;77387;71751;5636
3549201;São João das Duas Pontes;2000;2660;2015;645
3549250;São João de Iracema;2000;1671;1158;513
3549300;São João do Pau d'Alho;2000;2180;1633;547
3549409;São Joaquim da Barra;2000;41587;40799;788
3549508;São José da Bela Vista;2000;8075;6967;1108
3549607;São José do Barreiro;2000;4143;2471;1672
3549706;São José do Rio Pardo;2000;50077;41636;8441
3549805;São José do Rio Preto;2000;358523;337096;21427
3549904;São José dos Campos;2000;539313;532743;6570
3549953;São Lourenço da Serra;2000;12199;10650;1549
3550001;São Luiz do Paraitinga;2000;10429;6145;4284
3550100;São Manuel;2000;36545;34043;2502
3550209;São Miguel Arcanjo;2000;30798;17985;12813
3550308;São Paulo;2000;10435546;9814133;621413
3550407;São Pedro;2000;27897;22433;5464
3550506;São Pedro do Turvo;2000;6888;4399;2489
3550605;São Roque;2000;66637;48155;18482
3550704;São Sebastião;2000;58038;57452;586
3550803;São Sebastião da Grama;2000;12454;7494;4960
3550902;São Simão;2000;13675;11940;1735
3551009;São Vicente;2000;303551;303413;138
3551108;Sarapuí;2000;7805;5112;2693
3551207;Sarutaiá;2000;3739;2827;912
3551306;Sebastianópolis do Sul;2000;2546;1649;897
3551405;Serra Azul;2000;7446;6808;638
3551504;Serrana;2000;32603;31819;784
3551603;Serra Negra;2000;23851;20612;3239
3551702;Sertãozinho;2000;94664;90531;4133
3551801;Sete Barras;2000;13908;4644;9264
3551900;Severínia;2000;13605;12161;1444
3552007;Silveiras;2000;5378;2451;2927
3552106;Socorro;2000;32704;20980;11724
3552205;Sorocaba;2000;493468;486726;6742
3552304;Sud Mennucci;2000;7365;6313;1052
3552403;Sumaré;2000;196723;193937;2786
3552502;Suzano;2000;228690;221423;7267
3552551;Suzanápolis;2000;2790;1939;851
3552601;Tabapuã;2000;10493;9017;1476
3552700;Tabatinga;2000;12990;10183;2807
3552809;Taboão da Serra;2000;197644;197644;0
3552908;Taciba;2000;5221;4242;979
3553005;Taguaí;2000;7468;6409;1059
3553104;Taiaçu;2000;5619;4847;772
3553203;Taiúva;2000;5506;4758;748
3553302;Tambaú;2000;22258;19044;3214
3553401;Tanabi;2000;22587;17989;4598
3553500;Tapiraí;2000;8570;5787;2783
3553609;Tapiratiba;2000;12942;9221;3721
3553658;Taquaral;2000;2722;2581;141
3553708;Taquaritinga;2000;52065;47592;4473
3553807;Taquarituba;2000;21982;18328;3654
3553856;Taquarivaí;2000;4473;2282;2191
3553906;Tarabai;2000;5786;5227;559
3553955;Tarumã;2000;10743;9646;1097
3554003;Tatuí;2000;93430;85613;7817
3554102;Taubaté;2000;244165;229855;14310
3554201;Tejupá;2000;5336;2723;2613
3554300;Teodoro Sampaio;2000;20003;15922;4081
3554409;Terra Roxa;2000;7752;7227;525
3554508;Tietê;2000;31710;28678;3032
3554607;Timburi;2000;2731;1812;919
3554656;Torre de Pedra;2000;2144;1257;887
3554706;Torrinha;2000;8837;7289;1548
3554755;Trabiju;2000;1380;1230;150
3554805;Tremembé;2000;34823;29866;4957
3554904;Três Fronteiras;2000;5159;3997;1162
3554953;Tuiuti;2000;5083;2271;2812
3555000;Tupã;2000;63333;60366;2967
3555109;Tupi Paulista;2000;13286;10877;2409
3555208;Turiúba;2000;1895;1491;404
3555307;Turmalina;2000;2366;1547;819
3555356;Ubarana;2000;4220;3811;409
3555406;Ubatuba;2000;66861;65195;1666
3555505;Ubirajara;2000;4156;2997;1159
3555604;Uchoa;2000;9035;7882;1153
3555703;União Paulista;2000;1354;923;431
3555802;Urânia;2000;8825;7065;1760
3555901;Uru;2000;1404;989;415
3556008;Urupês;2000;11833;9787;2046
3556107;Valentim Gentil;2000;8605;7527;1078
3556206;Valinhos;2000;82973;78506;4467
3556305;Valparaíso;2000;18574;16087;2487
3556354;Vargem;2000;6975;2610;4365
3556404;Vargem Grande do Sul;2000;36302;33712;2590
3556453;Vargem Grande Paulista;2000;32683;32683;0
3556503;Várzea Paulista;2000;92800;92800;0
3556602;Vera Cruz;2000;11085;9164;1921
3556701;Vinhedo;2000;47215;46174;1041
3556800;Viradouro;2000;15962;15086;876
3556909;Vista Alegre do Alto;2000;4754;4143;611
3556958;Vitória Brasil;2000;1675;1189;486
3557006;Votorantim;2000;95925;92723;3202
3557105;Votuporanga;2000;75641;72807;2834
3557154;Zacarias;2000;1947;1332;615
3557204;Chavantes;2000;12194;10440;1754
3557303;Estiva Gerbi;2000;8856;7642;1214
4100103;Abatiá;2000;8259;5356;2903
4100202;Adrianópolis;2000;7031;1613;5418
4100301;Agudos do Sul;2000;7221;1466;5755
4100400;Almirante Tamandaré;2000;88277;84755;3522
4100459;Altamira do Paraná;2000;7037;2119;4918
4100509;Altônia;2000;19230;11704;7526
4100608;Alto Paraná;2000;12717;10114;2603
4100707;Alto Piquiri;2000;10761;8405;2356
4100806;Alvorada do Sul;2000;9253;7015;2238
4100905;Amaporã;2000;4655;3587;1068
4101002;Ampére;2000;15623;10403;5220
4101051;Anahy;2000;3011;1669;1342
4101101;Andirá;2000;21663;19927;1736
4101150;Ângulo;2000;2840;2150;690
4101200;Antonina;2000;19174;15837;3337
4101309;Antônio Olinto;2000;7407;612;6795
4101408;Apucarana;2000;107827;100249;7578
4101507;Arapongas;2000;85428;81790;3638
4101606;Arapoti;2000;23884;17487;6397
4101655;Arapuã;2000;4172;1209;2963
4101705;Araruna;2000;13081;9134;3947
4101804;Araucária;2000;94258;86111;8147
4101853;Ariranha do Ivaí;2000;2883;697;2186
4101903;Assaí;2000;18045;13517;4528
4102000;Assis Chateaubriand;2000;33317;27052;6265
4102109;Astorga;2000;23637;20476;3161
4102208;Atalaia;2000;4015;3327;688
4102307;Balsa Nova;2000;10153;3186;6967
4102406;Bandeirantes;2000;33732;27720;6012
4102505;Barbosa Ferraz;2000;14110;9735;4375
4102604;Barracão;2000;9271;5825;3446
4102703;Barra do Jacaré;2000;2723;1693;1030
4102752;Bela Vista da Caroba;2000;4503;757;3746
4102802;Bela Vista do Paraíso;2000;15031;13860;1171
4102901;Bituruna;2000;15994;7506;8488
4103008;Boa Esperança;2000;5162;2579;2583
4103024;Boa Esperança do Iguaçu;2000;3107;576;2531
4103040;Boa Ventura de São Roque;2000;6780;1080;5700
4103057;Boa Vista da Aparecida;2000;8423;4565;3858
4103107;Bocaiúva do Sul;2000;9050;3562;5488
4103156;Bom Jesus do Sul;2000;4154;382;3772
4103206;Bom Sucesso;2000;6173;4724;1449
4103222;Bom Sucesso do Sul;2000;3392;1307;2085
4103305;Borrazópolis;2000;9453;6204;3249
4103354;Braganey;2000;6191;2780;3411
4103370;Brasilândia do Sul;2000;3889;2367;1522
4103404;Cafeara;2000;2485;1781;704
4103453;Cafelândia;2000;11143;8551;2592
4103479;Cafezal do Sul;2000;4648;3069;1579
4103503;Califórnia;2000;7678;5664;2014
4103602;Cambará;2000;22740;20022;2718
4103701;Cambé;2000;88186;81942;6244
4103800;Cambira;2000;6688;4194;2494
4103909;Campina da Lagoa;2000;17018;12408;4610
4103958;Campina do Simão;2000;4365;1261;3104
4104006;Campina Grande do Sul;2000;34566;25973;8593
4104055;Campo Bonito;2000;5128;2244;2884
4104105;Campo do Tenente;2000;6335;3451;2884
4104204;Campo Largo;2000;92782;77223;15559
4104253;Campo Magro;2000;20409;2501;17908
4104303;Campo Mourão;2000;80476;74754;5722
4104402;Cândido de Abreu;2000;18795;4684;14111
4104428;Candói;2000;14185;5158;9027
4104451;Cantagalo;2000;12810;7312;5498
4104501;Capanema;2000;18239;9311;8928
4104600;Capitão Leônidas Marques;2000;14377;9753;4624
4104659;Carambeí;2000;14860;10494;4366
4104709;Carlópolis;2000;13305;8347;4958
4104808;Cascavel;2000;245369;228673;16696
4104907;Castro;2000;63581;43250;20331
4105003;Catanduvas;2000;10421;4709;5712
4105102;Centenário do Sul;2000;11817;9237;2580
4105201;Cerro Azul;2000;16352;3916;12436
4105300;Céu Azul;2000;10445;7197;3248
4105409;Chopinzinho;2000;20543;10529;10014
4105508;Cianorte;2000;57401;49644;7757
4105607;Cidade Gaúcha;2000;9531;7681;1850
4105706;Clevelândia;2000;18338;14814;3524
4105805;Colombo;2000;183329;174962;8367
4105904;Colorado;2000;20957;18772;2185
4106001;Congonhinhas;2000;7851;4704;3147
4106100;Conselheiro Mairinck;2000;3463;2406;1057
4106209;Contenda;2000;13241;6320;6921
4106308;Corbélia;2000;15803;12542;3261
4106407;Cornélio Procópio;2000;46861;42683;4178
4106456;Coronel Domingos Soares;2000;7004;797;6207
4106506;Coronel Vivida;2000;23306;14732;8574
4106555;Corumbataí do Sul;2000;4946;1998;2948
4106571;Cruzeiro do Iguaçu;2000;4394;2214;2180
4106605;Cruzeiro do Oeste;2000;20222;16056;4166
4106704;Cruzeiro do Sul;2000;4759;2834;1925
4106803;Cruz Machado;2000;17667;3459;14208
4106852;Cruzmaltina;2000;3459;1181;2278
4106902;Curitiba;2000;1587315;1587315;0
4107009;Curiúva;2000;12904;6779;6125
4107108;Diamante do Norte;2000;6099;4612;1487
4107124;Diamante do Sul;2000;3659;1114;2545
4107157;Diamante D'Oeste;2000;4878;2480;2398
4107207;Dois Vizinhos;2000;31986;22382;9604
4107256;Douradina;2000;6160;3717;2443
4107306;Doutor Camargo;2000;5777;4679;1098
4107405;Enéas Marques;2000;6382;1250;5132
4107504;Engenheiro Beltrão;2000;14082;11129;2953
4107520;Esperança Nova;2000;2308;667;1641
4107538;Entre Rios do Oeste;2000;3328;2017;1311
4107546;Espigão Alto do Iguaçu;2000;5388;1572;3816
4107553;Farol;2000;3963;1944;2019
4107603;Faxinal;2000;15608;12556;3052
4107652;Fazenda Rio Grande;2000;62877;59196;3681
4107702;Fênix;2000;4942;3836;1106
4107736;Fernandes Pinheiro;2000;6368;1965;4403
4107751;Figueira;2000;9038;7703;1335
4107801;Floraí;2000;5285;4511;774
4107850;Flor da Serra do Sul;2000;5059;590;4469
4107900;Floresta;2000;5122;4386;736
4108007;Florestópolis;2000;12190;10238;1952
4108106;Flórida;2000;2434;2181;253
4108205;Formosa do Oeste;2000;8755;5030;3725
4108304;Foz do Iguaçu;2000;258543;256524;2019
4108320;Francisco Alves;2000;6956;4110;2846
4108403;Francisco Beltrão;2000;67132;54831;12301
4108452;Foz do Jordão;2000;6378;4312;2066
4108502;General Carneiro;2000;13899;8903;4996
4108551;Godoy Moreira;2000;3836;1468;2368
4108601;Goioerê;2000;29750;24534;5216
4108650;Goioxim;2000;8117;1768;6349
4108700;Grandes Rios;2000;7868;3800;4068
4108809;Guaíra;2000;28659;24878;3781
4108908;Guairaçá;2000;5898;4098;1800
4108957;Guamiranga;2000;7150;1628;5522
4109005;Guapirama;2000;4068;2917;1151
4109104;Guaporema;2000;2244;978;1266
4109203;Guaraci;2000;4919;3809;1110
4109302;Guaraniaçu;2000;17201;8126;9075
4109401;Guarapuava;2000;155161;141694;13467
4109500;Guaraqueçaba;2000;8288;2582;5706
4109609;Guaratuba;2000;27257;23156;4101
4109658;Honório Serpa;2000;6896;1443;5453
4109708;Ibaiti;2000;26448;19707;6741
4109757;Ibema;2000;5872;4438;1434
4109807;Ibiporã;2000;42153;39141;3012
4109906;Icaraíma;2000;10048;6519;3529
4110003;Iguaraçu;2000;3598;2814;784
4110052;Iguatu;2000;2255;1227;1028
4110078;Imbaú;2000;9474;5483;3991
4110102;Imbituva;2000;24496;14781;9715
4110201;Inácio Martins;2000;10963;4078;6885
4110300;Inajá;2000;2915;2305;610
4110409;Indianópolis;2000;4212;2435;1777
4110508;Ipiranga;2000;13308;3996;9312
4110607;Iporã;2000;16445;11508;4937
4110656;Iracema do Oeste;2000;2951;2131;820
4110706;Irati;2000;52352;39306;13046
4110805;Iretama;2000;11335;6156;5179
4110904;Itaguajé;2000;4771;3586;1185
4110953;Itaipulândia;2000;6836;3757;3079
4111001;Itambaracá;2000;7090;5303;1787
4111100;Itambé;2000;5956;5378;578
4111209;Itapejara d'Oeste;2000;9162;4961;4201
4111258;Itaperuçu;2000;19344;16234;3110
4111308;Itaúna do Sul;2000;4447;2790;1657
4111407;Ivaí;2000;11899;3708;8191
4111506;Ivaiporã;2000;32270;25889;6381
4111555;Ivaté;2000;6925;3850;3075
4111605;Ivatuba;2000;2796;1926;870
4111704;Jaboti;2000;4590;2641;1949
4111803;Jacarezinho;2000;39625;33515;6110
4111902;Jaguapitã;2000;10932;8733;2199
4112009;Jaguariaíva;2000;30780;25621;5159
4112108;Jandaia do Sul;2000;19676;17079;2597
4112207;Janiópolis;2000;8084;4368;3716
4112306;Japira;2000;4901;2307;2594
4112405;Japurá;2000;7755;6051;1704
4112504;Jardim Alegre;2000;13673;7134;6539
4112603;Jardim Olinda;2000;1523;940;583
4112702;Jataizinho;2000;11327;10317;1010
4112751;Jesuítas;2000;9832;5408;4424
4112801;Joaquim Távora;2000;9661;6972;2689
4112900;Jundiaí do Sul;2000;3659;2266;1393
4112959;Juranda;2000;8134;5910;2224
4113007;Jussara;2000;6299;5256;1043
4113106;Kaloré;2000;5044;2989;2055
4113205;Lapa;2000;41838;24070;17768
4113254;Laranjal;2000;7192;1510;5682
4113304;Laranjeiras do Sul;2000;30025;23562;6463
4113403;Leópolis;2000;4440;2395;2045
4113429;Lidianópolis;2000;4783;1660;3123
4113452;Lindoeste;2000;6224;2382;3842
4113502;Loanda;2000;19549;16948;2601
4113601;Lobato;2000;4064;3366;698
4113700;Londrina;2000;447065;433369;13696
4113734;Luiziana;2000;7540;4138;3402
4113759;Lunardelli;2000;5668;2704;2964
4113809;Lupionópolis;2000;4323;3555;768
4113908;Mallet;2000;12602;6862;5740
4114005;Mamborê;2000;15156;9014;6142
4114104;Mandaguaçu;2000;16828;14113;2715
4114203;Mandaguari;2000;31395;28281;3114
4114302;Mandirituba;2000;17540;6268;11272
4114351;Manfrinópolis;2000;3802;448;3354
4114401;Mangueirinha;2000;17760;6450;11310
4114500;Manoel Ribas;2000;13066;6540;6526
4114609;Marechal Cândido Rondon;2000;41007;31246;9761
4114708;Maria Helena;2000;6384;2719;3665
4114807;Marialva;2000;28702;22113;6589
4114906;Marilândia do Sul;2000;9071;6089;2982
4115002;Marilena;2000;6756;3984;2772
4115101;Mariluz;2000;10296;8255;2041
4115200;Maringá;2000;288653;283978;4675
4115309;Mariópolis;2000;6017;3771;2246
4115358;Maripá;2000;5889;3001;2888
4115408;Marmeleiro;2000;13665;7168;6497
4115457;Marquinho;2000;5659;568;5091
4115507;Marumbi;2000;4612;3380;1232
4115606;Matelândia;2000;14344;10151;4193
4115705;Matinhos;2000;24184;24000;184
4115739;Mato Rico;2000;4496;652;3844
4115754;Mauá da Serra;2000;6471;5344;1127
4115804;Medianeira;2000;37827;33246;4581
4115853;Mercedes;2000;4608;1496;3112
4115903;Mirador;2000;2500;1576;924
4116000;Miraselva;2000;1961;1306;655
4116059;Missal;2000;10433;4972;5461
4116109;Moreira Sales;2000;13395;9383;4012
4116208;Morretes;2000;15275;7153;8122
4116307;Munhoz de Melo;2000;3401;2527;874
4116406;Nossa Senhora das Graças;2000;3833;2848;985
4116505;Nova Aliança do Ivaí;2000;1338;904;434
4116604;Nova América da Colina;2000;3585;2401;1184
4116703;Nova Aurora;2000;13641;9061;4580
4116802;Nova Cantu;2000;9914;3916;5998
4116901;Nova Esperança;2000;25729;21785;3944
4116950;Nova Esperança do Sudoeste;2000;5258;1224;4034
4117008;Nova Fátima;2000;8305;6591;1714
4117057;Nova Laranjeiras;2000;11848;1813;10035
4117107;Nova Londrina;2000;13169;11604;1565
4117206;Nova Olímpia;2000;5280;4325;955
4117214;Nova Santa Bárbara;2000;3611;2871;740
4117222;Nova Santa Rosa;2000;7125;3897;3228
4117255;Nova Prata do Iguaçu;2000;10397;5311;5086
4117271;Nova Tebas;2000;9476;3164;6312
4117297;Novo Itacolomi;2000;2866;1258;1608
4117305;Ortigueira;2000;25216;8363;16853
4117404;Ourizona;2000;3396;2660;736
4117453;Ouro Verde do Oeste;2000;5472;3383;2089
4117503;Paiçandu;2000;30764;29622;1142
4117602;Palmas;2000;34819;31411;3408
4117701;Palmeira;2000;30847;17268;13579
4117800;Palmital;2000;16958;6997;9961
4117909;Palotina;2000;25771;20740;5031
4118006;Paraíso do Norte;2000;9739;8720;1019
4118105;Paranacity;2000;9109;7326;1783
4118204;Paranaguá;2000;127339;122347;4992
4118303;Paranapoema;2000;2393;2159;234
4118402;Paranavaí;2000;75750;70329;5421
4118451;Pato Bragado;2000;4093;2343;1750
4118501;Pato Branco;2000;62234;56805;5429
4118600;Paula Freitas;2000;5060;2200;2860
4118709;Paulo Frontin;2000;6565;1752;4813
4118808;Peabiru;2000;13487;10491;2996
4118857;Perobal;2000;5291;2626;2665
4118907;Pérola;2000;9282;6618;2664
4119004;Pérola d'Oeste;2000;7354;2720;4634
4119103;Piên;2000;9934;2624;7309
4119152;Pinhais;2000;102985;100726;2259
4119202;Pinhalão;2000;6217;3532;2685
4119251;Pinhal de São Bento;2000;2560;737;1823
4119301;Pinhão;2000;28408;13734;14674
4119400;Piraí do Sul;2000;21647;14624;7023
4119509;Piraquara;2000;72886;33829;39057
4119608;Pitanga;2000;35989;18339;17650
4119657;Pitangueiras;2000;2418;1641;777
4119707;Planaltina do Paraná;2000;3992;2549;1443
4119806;Planalto;2000;14122;4814;9308
4119905;Ponta Grossa;2000;273616;266683;6933
4119954;Pontal do Paraná;2000;14323;14149;174
4120002;Porecatu;2000;15881;12372;3509
4120101;Porto Amazonas;2000;4236;2728;1508
4120150;Porto Barreiro;2000;4206;412;3794
4120200;Porto Rico;2000;2550;1651;899
4120309;Porto Vitória;2000;4051;2216;1835
4120333;Prado Ferreira;2000;3152;2371;781
4120358;Pranchita;2000;6260;3108;3152
4120408;Presidente Castelo Branco;2000;4305;3118;1187
4120507;Primeiro de Maio;2000;10728;9728;1000
4120606;Prudentópolis;2000;46346;18276;28070
4120655;Quarto Centenário;2000;5333;2685;2648
4120705;Quatiguá;2000;6742;5929;813
4120804;Quatro Barras;2000;16161;14520;1641
4120853;Quatro Pontes;2000;3646;1794;1852
4120903;Quedas do Iguaçu;2000;27364;19626;7738
4121000;Querência do Norte;2000;11438;7007;4431
4121109;Quinta do Sol;2000;5759;3454;2305
4121208;Quitandinha;2000;15272;3046;12226
4121257;Ramilândia;2000;3868;1827;2041
4121307;Rancho Alegre;2000;4197;3491;706
4121356;Rancho Alegre D'Oeste;2000;3117;2036;1081
4121406;Realeza;2000;16023;9951;6072
4121505;Rebouças;2000;13663;6569;7094
4121604;Renascença;2000;6959;2928;4031
4121703;Reserva;2000;23977;9611;14366
4121752;Reserva do Iguaçu;2000;6678;3340;3338
4121802;Ribeirão Claro;2000;10903;6796;4107
4121901;Ribeirão do Pinhal;2000;14341;10675;3666
4122008;Rio Azul;2000;13023;4334;8689
4122107;Rio Bom;2000;3612;2106;1506
4122156;Rio Bonito do Iguaçu;2000;13791;1878;11913
4122172;Rio Branco do Ivaí;2000;3815;925;2890
4122206;Rio Branco do Sul;2000;29341;20049;9292
4122305;Rio Negro;2000;28710;22460;6250
4122404;Rolândia;2000;49410;44650;4760
4122503;Roncador;2000;13632;6826;6806
4122602;Rondon;2000;8527;5832;2695
4122651;Rosário do Ivaí;2000;6585;2269;4316
4122701;Sabáudia;2000;5413;4036;1377
4122800;Salgado Filho;2000;5338;2158;3180
4122909;Salto do Itararé;2000;5549;3419;2130
4123006;Salto do Lontra;2000;12757;5602;7155
4123105;Santa Amélia;2000;4407;2950;1457
4123204;Santa Cecília do Pavão;2000;4064;3002;1062
4123303;Santa Cruz de Monte Castelo;2000;8578;5651;2927
4123402;Santa Fé;2000;8870;7264;1606
4123501;Santa Helena;2000;20491;9818;10673
4123600;Santa Inês;2000;2099;1193;906
4123709;Santa Isabel do Ivaí;2000;9154;6771;2383
4123808;Santa Izabel do Oeste;2000;11711;5695;6016
4123824;Santa Lúcia;2000;4126;2184;1942
4123857;Santa Maria do Oeste;2000;13639;3175;10464
4123907;Santa Mariana;2000;13470;8668;4802
4123956;Santa Mônica;2000;3190;1335;1855
4124004;Santana do Itararé;2000;5638;3465;2173
4124020;Santa Tereza do Oeste;2000;10754;7534;3220
4124053;Santa Terezinha de Itaipu;2000;18368;16299;2069
4124103;Santo Antônio da Platina;2000;39943;32617;7326
4124202;Santo Antônio do Caiuá;2000;2878;2118;760
4124301;Santo Antônio do Paraíso;2000;2790;1718;1072
4124400;Santo Antônio do Sudoeste;2000;17870;10814;7056
4124509;Santo Inácio;2000;5188;3960;1228
4124608;São Carlos do Ivaí;2000;5904;5252;652
4124707;São Jerônimo da Serra;2000;11750;5331;6419
4124806;São João;2000;11207;5788;5419
4124905;São João do Caiuá;2000;6091;5070;1021
4125001;São João do Ivaí;2000;13196;9288;3908
4125100;São João do Triunfo;2000;12479;3503;8976
4125209;São Jorge d'Oeste;2000;9307;4511;4796
4125308;São Jorge do Ivaí;2000;5590;4558;1032
4125357;São Jorge do Patrocínio;2000;6604;2907;3697
4125407;São José da Boa Vista;2000;6978;3501;3477
4125456;São José das Palmeiras;2000;4102;2259;1843
4125506;São José dos Pinhais;2000;204316;183366;20950
4125555;São Manoel do Paraná;2000;2072;1003;1069
4125605;São Mateus do Sul;2000;36569;21131;15438
4125704;São Miguel do Iguaçu;2000;24432;14260;10172
4125753;São Pedro do Iguaçu;2000;7277;4003;3274
4125803;São Pedro do Ivaí;2000;9473;7730;1743
4125902;São Pedro do Paraná;2000;2738;1492;1246
4126009;São Sebastião da Amoreira;2000;8548;6617;1931
4126108;São Tomé;2000;5045;3691;1354
4126207;Sapopema;2000;6872;3183;3689
4126256;Sarandi;2000;71422;69493;1929
4126272;Saudade do Iguaçu;2000;4608;1987;2621
4126306;Sengés;2000;17778;12745;5033
4126355;Serranópolis do Iguaçu;2000;4740;1928;2812
4126405;Sertaneja;2000;6521;5366;1155
4126504;Sertanópolis;2000;15147;12609;2538
4126603;Siqueira Campos;2000;16000;11768;4232
4126652;Sulina;2000;3918;1195;2723
4126678;Tamarana;2000;9713;4719;4994
4126702;Tamboara;2000;4255;3384;871
4126801;Tapejara;2000;13120;10512;2608
4126900;Tapira;2000;6282;3299;2983
4127007;Teixeira Soares;2000;8192;3785;4407
4127106;Telêmaco Borba;2000;61238;58354;2884
4127205;Terra Boa;2000;14640;11177;3463
4127304;Terra Rica;2000;13797;10516;3281
4127403;Terra Roxa;2000;16300;11042;5258
4127502;Tibagi;2000;18434;9712;8722
4127601;Tijucas do Sul;2000;12260;1846;10414
4127700;Toledo;2000;98200;85968;12232
4127809;Tomazina;2000;9931;4266;5665
4127858;Três Barras do Paraná;2000;11822;4931;6891
4127882;Tunas do Paraná;2000;3611;1345;2266
4127908;Tuneiras do Oeste;2000;9013;5164;3849
4127957;Tupãssi;2000;8018;5420;2598
4127965;Turvo;2000;14530;4179;10351
4128005;Ubiratã;2000;22593;17633;4960
4128104;Umuarama;2000;90690;82625;8065
4128203;União da Vitória;2000;48522;45591;2931
4128302;Uniflor;2000;2362;1658;704
4128401;Uraí;2000;11876;9162;2714
4128500;Wenceslau Braz;2000;19559;14879;4680
4128534;Ventania;2000;8024;5357;2667
4128559;Vera Cruz do Oeste;2000;9651;6966;2685
4128609;Verê;2000;8721;3029;5692
4128625;Alto Paraíso;2000;3783;1838;1945
4128633;Doutor Ulysses;2000;6003;701;5302
4128658;Virmond;2000;4052;1399;2653
4128708;Vitorino;2000;6285;3190;3095
4128807;Xambrê;2000;6500;1875;4625
4200051;Abdon Batista;2000;2775;773;2002
4200101;Abelardo Luz;2000;16440;7228;9212
4200200;Agrolândia;2000;7810;4634;3176
4200309;Agronômica;2000;4257;830;3427
4200408;Água Doce;2000;6843;3176;3667
4200507;Águas de Chapecó;2000;5782;2202;3580
4200556;Águas Frias;2000;2525;414;2111
4200606;Águas Mornas;2000;5390;1715;3675
4200705;Alfredo Wagner;2000;8857;2473;6384
4200754;Alto Bela Vista;2000;2159;558;1601
4200804;Anchieta;2000;7133;2443;4690
4200903;Angelina;2000;5880;1015;4865
4201000;Anita Garibaldi;2000;10273;4188;6085
4201109;Anitápolis;2000;3234;1046;2188
4201208;Antônio Carlos;2000;6434;1760;4674
4201257;Apiúna;2000;8520;3606;4914
4201273;Arabutã;2000;4160;971;3189
4201307;Araquari;2000;23645;22000;1645
4201406;Araranguá;2000;54706;45052;9654
4201505;Armazém;2000;6873;2625;4248
4201604;Arroio Trinta;2000;3490;2097;1393
4201653;Arvoredo;2000;2305;411;1894
4201703;Ascurra;2000;6934;6119;815
4201802;Atalanta;2000;3429;1163;2266
4201901;Aurora;2000;5474;1482;3992
4201950;Balneário Arroio do Silva;2000;6043;5876;167
4202008;Balneário Camboriú;2000;73455;73455;0
4202057;Balneário Barra do Sul;2000;6045;6045;0
4202073;Balneário Gaivota;2000;5450;2977;2473
4202081;Bandeirante;2000;3177;830;2347
4202099;Barra Bonita;2000;2118;256;1862
4202107;Barra Velha;2000;15530;14566;964
4202131;Bela Vista do Toldo;2000;5721;570;5151
4202156;Belmonte;2000;2588;1012;1576
4202206;Benedito Novo;2000;9071;4901;4170
4202305;Biguaçu;2000;48077;42907;5170
4202404;Blumenau;2000;261808;241943;19865
4202438;Bocaina do Sul;2000;2980;415;2565
4202453;Bombinhas;2000;8716;8716;0
4202503;Bom Jardim da Serra;2000;4079;2123;1956
4202537;Bom Jesus;2000;2046;989;1057
4202578;Bom Jesus do Oeste;2000;2150;376;1774
4202602;Bom Retiro;2000;7967;5336;2631
4202701;Botuverá;2000;3756;1076;2680
4202800;Braço do Norte;2000;24802;17879;6923
4202859;Braço do Trombudo;2000;3187;1622;1565
4202875;Brunópolis;2000;3331;707;2624
4202909;Brusque;2000;76058;73256;2802
4203006;Caçador;2000;63322;55542;7780
4203105;Caibi;2000;6354;3060;3294
4203154;Calmon;2000;3467;1392;2075
4203204;Camboriú;2000;41445;39427;2018
4203253;Capão Alto;2000;3020;604;2416
4203303;Campo Alegre;2000;11634;6871;4763
4203402;Campo Belo do Sul;2000;8070;4440;3630
4203501;Campo Erê;2000;10353;5756;4597
4203600;Campos Novos;2000;28729;22556;6173
4203709;Canelinha;2000;9004;4292;4712
4203808;Canoinhas;2000;51631;37904;13727
4203907;Capinzal;2000;19955;15460;4495
4203956;Capivari de Baixo;2000;18561;17436;1125
4204004;Catanduvas;2000;8291;5304;2987
4204103;Caxambu do Sul;2000;5263;2054;3209
4204152;Celso Ramos;2000;2844;497;2347
4204178;Cerro Negro;2000;4098;694;3404
4204194;Chapadão do Lageado;2000;2561;289;2272
4204202;Chapecó;2000;146967;134592;12375
4204251;Cocal do Sul;2000;13726;11407;2319
4204301;Concórdia;2000;63058;45254;17804
4204350;Cordilheira Alta;2000;3093;303;2790
4204400;Coronel Freitas;2000;10621;4494;6127
4204459;Coronel Martins;2000;2388;458;1930
4204509;Corupá;2000;11847;8727;3120
4204558;Correia Pinto;2000;17026;12046;4980
4204608;Criciúma;2000;170420;153049;17371
4204707;Cunha Porã;2000;10229;5287;4942
4204756;Cunhataí;2000;1822;335;1487
4204806;Curitibanos;2000;36061;32438;3623
4204905;Descanso;2000;9129;3885;5244
4205001;Dionísio Cerqueira;2000;14250;8610;5640
4205100;Dona Emma;2000;3309;1368;1941
4205159;Doutor Pedrinho;2000;3082;1669;1413
4205175;Entre Rios;2000;2788;751;2037
4205191;Ermo;2000;2057;593;1464
4205209;Erval Velho;2000;4269;2332;1937
4205308;Faxinal dos Guedes;2000;10767;7044;3723
4205357;Flor do Sertão;2000;1612;195;1417
4205407;Florianópolis;2000;342315;332185;10130
4205431;Formosa do Sul;2000;2725;891;1834
4205456;Forquilhinha;2000;18348;14556;3792
4205506;Fraiburgo;2000;32948;27623;5325
4205555;Frei Rogério;2000;2971;483;2488
4205605;Galvão;2000;4235;2438;1797
4205704;Garopaba;2000;13164;10722;2442
4205803;Garuva;2000;11378;8256;3122
4205902;Gaspar;2000;46414;29601;16813
4206009;Governador Celso Ramos;2000;11598;10842;756
4206108;Grão Pará;2000;5817;2674;3143
4206207;Gravatal;2000;10799;3864;6935
4206306;Guabiruba;2000;12976;12048;928
4206405;Guaraciaba;2000;11038;4365;6673
4206504;Guaramirim;2000;23794;19012;4782
4206603;Guarujá do Sul;2000;4696;2098;2598
4206652;Guatambú;2000;4702;983;3719
4206702;Herval d'Oeste;2000;20044;17140;2904
4206751;Ibiam;2000;1972;501;1471
4206801;Ibicaré;2000;3587;1240;2347
4206900;Ibirama;2000;15802;13115;2687
4207007;Içara;2000;48634;39570;9064
4207106;Ilhota;2000;10574;6461;4113
4207205;Imaruí;2000;13404;3909;9495
4207304;Imbituba;2000;35700;34527;1173
4207403;Imbuia;2000;5246;1955;3291
4207502;Indaial;2000;40194;38382;1812
4207577;Iomerê;2000;2553;683;1870
4207601;Ipira;2000;4979;2214;2765
4207650;Iporã do Oeste;2000;7877;2851;5026
4207684;Ipuaçu;2000;6122;967;5155
4207700;Ipumirim;2000;6907;2484;4423
4207759;Iraceminha;2000;4592;1222;3370
4207809;Irani;2000;8602;5024;3578
4207858;Irati;2000;2202;412;1790
4207908;Irineópolis;2000;9734;2964;6770
4208005;Itá;2000;6764;3422;3342
4208104;Itaiópolis;2000;19086;8055;11031
4208203;Itajaí;2000;147494;141950;5544
4208302;Itapema;2000;25869;24781;1088
4208401;Itapiranga;2000;13998;5382;8616
4208450;Itapoá;2000;8839;8191;648
4208500;Ituporanga;2000;19492;11664;7828
4208609;Jaborá;2000;4194;1362;2832
4208708;Jacinto Machado;2000;10923;4538;6385
4208807;Jaguaruna;2000;14613;10238;4375
4208906;Jaraguá do Sul;2000;108489;96320;12169
4208955;Jardinópolis;2000;1994;815;1179
4209003;Joaçaba;2000;24066;21688;2378
4209102;Joinville;2000;429604;414972;14632
4209151;José Boiteux;2000;4594;1466;3128
4209177;Jupiá;2000;2220;711;1509
4209201;Lacerdópolis;2000;2173;983;1190
4209300;Lages;2000;157682;153582;4100
4209409;Laguna;2000;47568;37284;10284
4209458;Lajeado Grande;2000;1572;476;1096
4209508;Laurentino;2000;5062;3238;1824
4209607;Lauro Müller;2000;13604;9923;3681
4209706;Lebon Régis;2000;11682;6980;4702
4209805;Leoberto Leal;2000;3739;457;3282
4209854;Lindóia do Sul;2000;4877;1321;3556
4209904;Lontras;2000;8381;5309;3072
4210001;Luiz Alves;2000;7974;2124;5850
4210035;Luzerna;2000;5572;3964;1608
4210050;Macieira;2000;1900;304;1596
4210100;Mafra;2000;49940;37713;12227
4210209;Major Gercino;2000;3143;977;2166
4210308;Major Vieira;2000;6906;2199;4707
4210407;Maracajá;2000;5541;3521;2020
4210506;Maravilha;2000;18521;14226;4295
4210555;Marema;2000;2651;941;1710
4210605;Massaranduba;2000;12562;4629;7933
4210704;Matos Costa;2000;3204;1213;1991
4210803;Meleiro;2000;7080;3207;3873
4210852;Mirim Doce;2000;3520;1342;2179
4210902;Modelo;2000;3930;2149;1781
4211009;Mondaí;2000;8728;4049;4679
4211058;Monte Carlo;2000;8579;7305;1274
4211108;Monte Castelo;2000;8350;4573;3777
4211207;Morro da Fumaça;2000;14551;11154;3397
4211256;Morro Grande;2000;2917;737;2180
4211306;Navegantes;2000;39317;36650;2667
4211405;Nova Erechim;2000;3543;1720;1823
4211454;Nova Itaberaba;2000;4256;425;3831
4211504;Nova Trento;2000;9852;6673;3179
4211603;Nova Veneza;2000;11511;7199;4312
4211652;Novo Horizonte;2000;3101;723;2378
4211702;Orleans;2000;20031;12813;7218
4211751;Otacílio Costa;2000;13993;12811;1182
4211801;Ouro;2000;7419;4165;3254
4211850;Ouro Verde;2000;2352;625;1727
4211876;Paial;2000;2052;259;1793
4211892;Painel;2000;2384;824;1560
4211900;Palhoça;2000;102742;97914;4828
4212007;Palma Sola;2000;8206;3192;5014
4212056;Palmeira;2000;2226;808;1418
4212106;Palmitos;2000;16034;8006;8028
4212205;Papanduva;2000;16822;7953;8869
4212239;Paraíso;2000;4796;1302;3494
4212254;Passo de Torres;2000;4400;3522;878
4212270;Passos Maia;2000;4763;748;4015
4212304;Paulo Lopes;2000;5924;3501;2423
4212403;Pedras Grandes;2000;4921;865;4056
4212502;Penha;2000;17678;15993;1685
4212601;Peritiba;2000;3230;1362;1868
4212700;Petrolândia;2000;6406;1811;4595
4212809;Balneário Piçarras;2000;10911;8615;2296
4212908;Pinhalzinho;2000;12356;9313;3043
4213005;Pinheiro Preto;2000;2729;1141;1588
4213104;Piratuba;2000;5812;2710;3102
4213153;Planalto Alegre;2000;2452;739;1713
4213203;Pomerode;2000;22127;18713;3414
4213302;Ponte Alta;2000;5289;3783;1506
4213351;Ponte Alta do Norte;2000;3221;2338;883
4213401;Ponte Serrada;2000;10561;7230;3331
4213500;Porto Belo;2000;10704;9973;731
4213609;Porto União;2000;31858;26579;5279
4213708;Pouso Redondo;2000;12404;6368;6036
4213807;Praia Grande;2000;7286;3937;3349
4213906;Presidente Castello Branco;2000;2160;457;1703
4214003;Presidente Getúlio;2000;12333;7867;4466
4214102;Presidente Nereu;2000;2305;729;1576
4214151;Princesa;2000;2613;568;2045
4214201;Quilombo;2000;10736;4697;6039
4214300;Rancho Queimado;2000;2637;1103;1534
4214409;Rio das Antas;2000;6129;2226;3903
4214508;Rio do Campo;2000;6522;2288;4234
4214607;Rio do Oeste;2000;6730;2626;4104
4214706;Rio dos Cedros;2000;8939;3758;5181
4214805;Rio do Sul;2000;51650;48418;3232
4214904;Rio Fortuna;2000;4320;1213;3107
4215000;Rio Negrinho;2000;37707;32650;5057
4215059;Rio Rufino;2000;2414;553;1861
4215075;Riqueza;2000;5166;1277;3889
4215109;Rodeio;2000;10380;8866;1514
4215208;Romelândia;2000;6491;2120;4371
4215307;Salete;2000;7163;4583;2580
4215356;Saltinho;2000;4298;891;3407
4215406;Salto Veloso;2000;3910;2874;1036
4215455;Sangão;2000;8128;3624;4504
4215505;Santa Cecília;2000;14802;11617;3185
4215554;Santa Helena;2000;2588;662;1926
4215604;Santa Rosa de Lima;2000;2007;423;1584
4215653;Santa Rosa do Sul;2000;7810;3042;4768
4215679;Santa Terezinha;2000;8840;1142;7698
4215687;Santa Terezinha do Progresso;2000;3416;426;2990
4215695;Santiago do Sul;2000;1696;521;1175
4215703;Santo Amaro da Imperatriz;2000;15708;12536;3172
4215752;São Bernardino;2000;3140;529;2611
4215802;São Bento do Sul;2000;65437;61826;3611
4215901;São Bonifácio;2000;3218;652;2566
4216008;São Carlos;2000;9364;5347;4017
4216057;São Cristóvão do Sul;2000;4504;2719;1785
4216107;São Domingos;2000;9540;5430;4110
4216206;São Francisco do Sul;2000;32301;29930;2371
4216255;São João do Oeste;2000;5789;1494;4295
4216305;São João Batista;2000;14861;11273;3588
4216354;São João do Itaperiú;2000;3161;1454;1707
4216404;São João do Sul;2000;6784;1143;5641
4216503;São Joaquim;2000;22836;16129;6707
4216602;São José;2000;173559;171230;2329
4216701;São José do Cedro;2000;13678;6659;7019
4216800;São José do Cerrito;2000;10393;2152;8241
4216909;São Lourenço do Oeste;2000;19647;13407;6240
4217006;São Ludgero;2000;8587;5995;2592
4217105;São Martinho;2000;3274;888;2386
4217154;São Miguel da Boa Vista;2000;2018;331;1687
4217204;São Miguel do Oeste;2000;32324;27392;4932
4217253;São Pedro de Alcântara;2000;3584;2096;1488
4217303;Saudades;2000;8324;2897;5427
4217402;Schroeder;2000;10811;9402;1409
4217501;Seara;2000;16484;10263;6221
4217550;Serra Alta;2000;3330;1201;2129
4217600;Siderópolis;2000;12082;9103;2979
4217709;Sombrio;2000;22962;15925;7037
4217758;Sul Brasil;2000;3116;744;2372
4217808;Taió;2000;16257;7887;8370
4217907;Tangará;2000;8754;4233;4521
4217956;Tigrinhos;2000;1878;213;1665
4218004;Tijucas;2000;23499;18711;4788
4218103;Timbé do Sul;2000;5323;1683;3640
4218202;Timbó;2000;29358;26783;2575
4218251;Timbó Grande;2000;6501;2775;3726
4218301;Três Barras;2000;17124;14223;2901
4218350;Treviso;2000;3144;1561;1583
4218400;Treze de Maio;2000;6716;1764;4952
4218509;Treze Tílias;2000;4840;2907;1933
4218608;Trombudo Central;2000;5795;3229;2566
4218707;Tubarão;2000;88470;69925;18545
4218756;Tunápolis;2000;4777;1217;3560
4218806;Turvo;2000;10887;5637;5250
4218855;União do Oeste;2000;3391;1162;2229
4218905;Urubici;2000;10252;6661;3591
4218954;Urupema;2000;2527;1185;1342
4219002;Urussanga;2000;18727;10650;8077
4219101;Vargeão;2000;3526;1380;2146
4219150;Vargem;2000;3225;651;2574
4219176;Vargem Bonita;2000;5158;2294;2864
4219200;Vidal Ramos;2000;6279;1497;4782
4219309;Videira;2000;41589;35787;5802
4219358;Vitor Meireles;2000;5519;1098;4421
4219408;Witmarsum;2000;3251;612;2639
4219507;Xanxerê;2000;37429;32385;5044
4219606;Xavantina;2000;4404;946;3458
4219705;Xaxim;2000;22857;16058;6799
4219853;Zortéa;2000;2633;2053;580
4300059;Água Santa;2000;4127;1114;3013
4300109;Agudo;2000;17455;5655;11800
4300208;Ajuricaba;2000;7709;3759;3950
4300307;Alecrim;2000;8487;2126;6361
4300406;Alegrete;2000;84338;75092;9246
4300455;Alegria;2000;5367;1607;3760
4300505;Alpestre;2000;10266;2157;8109
4300554;Alto Alegre;2000;2137;719;1418
4300570;Alto Feliz;2000;2834;712;2122
4300604;Alvorada;2000;183968;183365;603
4300638;Amaral Ferrador;2000;5740;1131;4609
4300646;Ametista do Sul;2000;7414;3195;4219
4300661;André da Rocha;2000;1113;374;739
4300703;Anta Gorda;2000;6327;1821;4506
4300802;Antônio Prado;2000;12918;8417;4501
4300851;Arambaré;2000;3917;2757;1160
4300877;Araricá;2000;4032;3493;539
4300901;Aratiba;2000;7116;2557;4559
4301008;Arroio do Meio;2000;16951;12735;4216
4301057;Arroio do Sal;2000;5273;5040;233
4301107;Arroio dos Ratos;2000;13335;12528;807
4301206;Arroio do Tigre;2000;12216;5270;6946
4301305;Arroio Grande;2000;19152;15692;3460
4301404;Arvorezinha;2000;10262;5377;4885
4301503;Augusto Pestana;2000;8173;3328;4845
4301552;Áurea;2000;3889;1262;2627
4301602;Bagé;2000;118767;97290;21477
4301636;Balneário Pinhal;2000;7452;7120;332
4301651;Barão;2000;5397;2288;3109
4301701;Barão de Cotegipe;2000;6927;3287;3640
4301750;Barão do Triunfo;2000;6662;593;6069
4301800;Barracão;2000;5592;2755;2837
4301859;Barra do Guarita;2000;2987;1106;1881
4301875;Barra do Quaraí;2000;3884;2865;1019
4301909;Barra do Ribeiro;2000;11845;8938;2907
4301925;Barra do Rio Azul;2000;2414;364;2050
4301958;Barra Funda;2000;2231;1202;1029
4302006;Barros Cassal;2000;11347;3247;8100
4302055;Benjamin Constant do Sul;2000;2727;256;2471
4302105;Bento Gonçalves;2000;91486;82188;9298
4302154;Boa Vista das Missões;2000;2188;651;1537
4302204;Boa Vista do Buricá;2000;6587;3663;2924
4302253;Boa Vista do Sul;2000;2840;311;2529
4302303;Bom Jesus;2000;12014;8376;3638
4302352;Bom Princípio;2000;9494;6945;2549
4302378;Bom Progresso;2000;2831;1011;1820
4302402;Bom Retiro do Sul;2000;10788;8279;2509
4302451;Boqueirão do Leão;2000;7825;1523;6302
4302501;Bossoroca;2000;7757;4015;3742
4302600;Braga;2000;4198;2340;1858
4302659;Brochier;2000;4372;1207;3165
4302709;Butiá;2000;20322;18976;1346
4302808;Caçapava do Sul;2000;34643;19328;15315
4302907;Cacequi;2000;15311;13015;2296
4303004;Cachoeira do Sul;2000;87873;74119;13754
4303103;Cachoeirinha;2000;107564;107564;0
4303202;Cacique Doble;2000;4770;1496;3274
4303301;Caibaté;2000;7243;2944;4299
4303400;Caiçara;2000;5580;1489;4091
4303509;Camaquã;2000;60383;47069;13314
4303558;Camargo;2000;2498;880;1618
4303608;Cambará do Sul;2000;6840;3047;3793
4303673;Campestre da Serra;2000;3170;903;2267
4303707;Campina das Missões;2000;7014;2275;4739
4303806;Campinas do Sul;2000;8258;4431;3827
4303905;Campo Bom;2000;54018;51838;2180
4304002;Campo Novo;2000;6721;4617;2104
4304101;Campos Borges;2000;3785;2031;1754
4304200;Candelária;2000;29585;13800;15785
4304309;Cândido Godói;2000;7092;1630;5462
4304358;Candiota;2000;8065;2657;5408
4304408;Canela;2000;33625;30760;2865
4304507;Canguçu;2000;51447;17695;33752
4304606;Canoas;2000;306093;306093;0
4304630;Capão da Canoa;2000;30498;30334;164
4304663;Capão do Leão;2000;23718;21354;2364
4304671;Capivari do Sul;2000;3107;2413;694
4304689;Capela de Santana;2000;10032;6277;3755
4304697;Capitão;2000;2565;857;1708
4304705;Carazinho;2000;59894;56276;3618
4304713;Caraá;2000;6403;471;5932
4304804;Carlos Barbosa;2000;20519;15211;5308
4304853;Carlos Gomes;2000;1912;341;1571
4304903;Casca;2000;8440;4118;4322
4304952;Caseiros;2000;2899;1002;1897
4305009;Catuípe;2000;10198;6180;4018
4305108;Caxias do Sul;2000;360419;333391;27028
4305116;Centenário;2000;3127;660;2467
4305124;Cerrito;2000;6925;3968;2957
4305132;Cerro Branco;2000;4297;1137;3160
4305157;Cerro Grande;2000;2601;721;1880
4305173;Cerro Grande do Sul;2000;8273;1616;6657
4305207;Cerro Largo;2000;12665;9341;3324
4305306;Chapada;2000;9746;4736;5010
4305355;Charqueadas;2000;29961;29015;946
4305371;Charrua;2000;3783;568;3215
4305405;Chiapetta;2000;4481;2546;1935
4305439;Chuí;2000;5167;4926;241
4305447;Chuvisca;2000;4502;188;4314
4305454;Cidreira;2000;8882;8510;372
4305504;Ciríaco;2000;5252;2069;3183
4305587;Colinas;2000;2462;1027;1435
4305603;Colorado;2000;4072;1908;2164
4305702;Condor;2000;6491;3420;3071
4305801;Constantina;2000;11667;5802;5865
4305850;Coqueiros do Sul;2000;2695;804;1891
4305871;Coronel Barros;2000;2454;855;1599
4305900;Coronel Bicaco;2000;8435;4283;4152
4305959;Cotiporã;2000;4093;1875;2218
4305975;Coxilha;2000;2979;1621;1358
4306007;Crissiumal;2000;15180;6124;9056
4306056;Cristal;2000;6632;4014;2618
4306072;Cristal do Sul;2000;2874;444;2430
4306106;Cruz Alta;2000;71254;65367;5887
4306205;Cruzeiro do Sul;2000;11664;6172;5492
4306304;David Canabarro;2000;4740;1425;3315
4306320;Derrubadas;2000;3715;786;2929
4306353;Dezesseis de Novembro;2000;3444;593;2851
4306379;Dilermando de Aguiar;2000;3200;1090;2110
4306403;Dois Irmãos;2000;22435;22272;163
4306429;Dois Irmãos das Missões;2000;2365;933;1432
4306452;Dois Lajeados;2000;3224;1214;2010
4306502;Dom Feliciano;2000;13297;2552;10745
4306551;Dom Pedro de Alcântara;2000;2636;701;1935
4306601;Dom Pedrito;2000;40410;35795;4615
4306700;Dona Francisca;2000;3902;2324;1578
4306734;Doutor Maurício Cardoso;2000;6329;2619;3710
4306759;Doutor Ricardo;2000;2128;447;1681
4306767;Eldorado do Sul;2000;27268;19242;8026
4306809;Encantado;2000;18528;16036;2492
4306908;Encruzilhada do Sul;2000;23902;14841;9061
4306924;Engenho Velho;2000;2134;506;1628
4306932;Entre-Ijuís;2000;9702;4440;5262
4306957;Entre Rios do Sul;2000;3491;2069;1422
4306973;Erebango;2000;3023;1975;1048
4307005;Erechim;2000;90347;82026;8321
4307054;Ernestina;2000;3941;1078;2863
4307104;Herval;2000;8487;4461;4026
4307203;Erval Grande;2000;5647;2109;3538
4307302;Erval Seco;2000;9177;3246;5931
4307401;Esmeralda;2000;5521;2415;3106
4307450;Esperança do Sul;2000;3755;423;3332
4307500;Espumoso;2000;16185;10014;6171
4307559;Estação;2000;6228;5267;961
4307609;Estância Velha;2000;35132;34367;765
4307708;Esteio;2000;80048;79961;87
4307807;Estrela;2000;27401;22695;4706
4307815;Estrela Velha;2000;3691;667;3024
4307831;Eugênio de Castro;2000;3313;1108;2205
4307864;Fagundes Varela;2000;2471;1084;1387
4307906;Farroupilha;2000;55308;42705;12603
4308003;Faxinal do Soturno;2000;6841;4292;2549
4308052;Faxinalzinho;2000;2923;1275;1648
4308078;Fazenda Vilanova;2000;2833;1178;1655
4308102;Feliz;2000;11316;7975;3341
4308201;Flores da Cunha;2000;23678;14227;9451
4308250;Floriano Peixoto;2000;2361;226;2135
4308300;Fontoura Xavier;2000;11473;3382;8091
4308409;Formigueiro;2000;7598;2649;4949
4308458;Fortaleza dos Valos;2000;5079;2819;2260
4308508;Frederico Westphalen;2000;26759;20433;6326
4308607;Garibaldi;2000;28337;23112;5225
4308656;Garruchos;2000;3675;1191;2484
4308706;Gaurama;2000;6391;2997;3394
4308805;General Câmara;2000;8737;5172;3565
4308854;Gentil;2000;1771;475;1296
4308904;Getúlio Vargas;2000;16509;13644;2865
4309001;Giruá;2000;18749;13257;5492
4309050;Glorinha;2000;5684;1285;4399
4309100;Gramado;2000;28593;23328;5265
4309126;Gramado dos Loureiros;2000;2543;426;2117
4309159;Gramado Xavier;2000;3666;382;3284
4309209;Gravataí;2000;232629;212144;20485
4309258;Guabiju;2000;1749;631;1118
4309308;Guaíba;2000;94307;91956;2351
4309407;Guaporé;2000;20064;17678;2386
4309506;Guarani das Missões;2000;8990;4984;4006
4309555;Harmonia;2000;3659;1781;1878
4309571;Herveiras;2000;2957;511;2446
4309605;Horizontina;2000;17699;13721;3978
4309654;Hulha Negra;2000;5359;2416;2943
4309704;Humaitá;2000;5228;2461;2767
4309753;Ibarama;2000;4454;956;3498
4309803;Ibiaçá;2000;5233;2676;2557
4309902;Ibiraiaras;2000;7163;3119;4044
4309951;Ibirapuitã;2000;5170;1931;3239
4310009;Ibirubá;2000;18633;13521;5112
4310108;Igrejinha;2000;26767;25530;1237
4310207;Ijuí;2000;78461;67397;11064
4310306;Ilópolis;2000;4255;1749;2506
4310330;Imbé;2000;12242;11905;337
4310363;Imigrante;2000;3850;1235;2615
4310405;Independência;2000;7308;3987;3321
4310413;Inhacorá;2000;2378;1277;1101
4310439;Ipê;2000;5456;2363;3093
4310462;Ipiranga do Sul;2000;2057;644;1413
4310504;Iraí;2000;9250;5590;3660
4310538;Itaara;2000;4578;3315;1263
4310553;Itacurubi;2000;3503;1171;2332
4310579;Itapuca;2000;2691;445;2246
4310603;Itaqui;2000;39770;34823;4947
4310702;Itatiba do Sul;2000;5252;1793;3459
4310751;Ivorá;2000;2495;659;1836
4310801;Ivoti;2000;15318;13785;1533
4310850;Jaboticaba;2000;4536;1408;3128
4310900;Jacutinga;2000;4248;2134;2114
4311007;Jaguarão;2000;30093;27174;2919
4311106;Jaguari;2000;12488;6623;5865
4311122;Jaquirana;2000;4814;2819;1995
4311130;Jari;2000;3751;499;3252
4311155;Jóia;2000;8284;1975;6309
4311205;Júlio de Castilhos;2000;20416;16400;4016
4311254;Lagoão;2000;6098;1188;4910
4311270;Lagoa dos Três Cantos;2000;1627;675;952
4311304;Lagoa Vermelha;2000;29833;23539;6294
4311403;Lajeado;2000;64133;60189;3944
4311429;Lajeado do Bugre;2000;2463;516;1947
4311502;Lavras do Sul;2000;8109;4828;3281
4311601;Liberato Salzano;2000;6574;1066;5508
4311627;Lindolfo Collor;2000;4414;3418;996
4311643;Linha Nova;2000;1564;362;1202
4311700;Machadinho;2000;5728;2780;2948
4311718;Maçambará;2000;5035;1150;3885
4311734;Mampituba;2000;3106;184;2922
4311759;Manoel Viana;2000;6995;5270;1725
4311775;Maquiné;2000;7304;1925;5379
4311791;Maratá;2000;2513;645;1868
4311809;Marau;2000;28361;22853;5508
4311908;Marcelino Ramos;2000;6108;3087;3021
4311981;Mariana Pimentel;2000;3733;619;3114
4312005;Mariano Moro;2000;2474;1070;1404
4312054;Marques de Souza;2000;4241;1464;2777
4312104;Mata;2000;5575;2526;3049
4312138;Mato Castelhano;2000;2454;390;2064
4312153;Mato Leitão;2000;3210;1271;1939
4312203;Maximiliano de Almeida;2000;5651;2588;3063
4312252;Minas do Leão;2000;7321;7008;313
4312302;Miraguaí;2000;5034;1786;3248
4312351;Montauri;2000;1684;492;1192
4312377;Monte Alegre dos Campos;2000;3040;44;2996
4312385;Monte Belo do Sul;2000;2880;621;2259
4312401;Montenegro;2000;54692;48862;5830
4312427;Mormaço;2000;2435;375;2060
4312443;Morrinhos do Sul;2000;3533;700;2833
4312450;Morro Redondo;2000;5998;2151;3847
4312476;Morro Reuter;2000;4984;4156;828
4312500;Mostardas;2000;11658;7029;4629
4312609;Muçum;2000;4728;3675;1053
4312617;Muitos Capões;2000;2867;866;2001
4312625;Muliterno;2000;1768;412;1356
4312658;Não-Me-Toque;2000;14413;11794;2619
4312674;Nicolau Vergueiro;2000;1812;491;1321
4312708;Nonoai;2000;12822;8794;4028
4312757;Nova Alvorada;2000;2757;791;1966
4312807;Nova Araçá;2000;3236;2010;1226
4312906;Nova Bassano;2000;7836;3958;3878
4312955;Nova Boa Vista;2000;2222;533;1689
4313003;Nova Bréscia;2000;4564;1486;3078
4313011;Nova Candelária;2000;2883;267;2616
4313037;Nova Esperança do Sul;2000;4010;2788;1222
4313060;Nova Hartz;2000;15071;12879;2192
4313086;Nova Pádua;2000;2396;530;1866
4313102;Nova Palma;2000;6312;2664;3648
4313201;Nova Petrópolis;2000;16891;12208;4683
4313300;Nova Prata;2000;18344;14419;3925
4313334;Nova Ramada;2000;2723;0;2723
4313359;Nova Roma do Sul;2000;3032;1199;1833
4313375;Nova Santa Rita;2000;15750;11550;4200
4313391;Novo Cabrais;2000;3565;314;3251
4313409;Novo Hamburgo;2000;236193;231989;4204
4313425;Novo Machado;2000;4718;1496;3222
4313441;Novo Tiradentes;2000;2412;564;1848
4313490;Novo Barreiro;2000;3867;820;3047
4313508;Osório;2000;36131;30664;5467
4313607;Paim Filho;2000;4831;2124;2707
4313656;Palmares do Sul;2000;10854;9093;1761
4313706;Palmeira das Missões;2000;38192;30825;7367
4313805;Palmitinho;2000;6943;2577;4366
4313904;Panambi;2000;32610;28291;4319
4313953;Pantano Grande;2000;10979;9276;1703
4314001;Paraí;2000;6020;2823;3197
4314027;Paraíso do Sul;2000;7212;1624;5588
4314035;Pareci Novo;2000;3242;642;2600
4314050;Parobé;2000;44776;43439;1337
4314068;Passa Sete;2000;4644;442;4202
4314076;Passo do Sobrado;2000;5566;974;4592
4314100;Passo Fundo;2000;168458;163764;4694
4314159;Paverama;2000;7744;3634;4110
4314209;Pedro Osório;2000;8107;7291;816
4314308;Pejuçara;2000;4189;2668;1521
4314407;Pelotas;2000;323158;301081;22077
4314423;Picada Café;2000;4673;3968;705
4314456;Pinhal;2000;2503;900;1603
4314472;Pinhal Grande;2000;4725;1506;3219
4314498;Pinheirinho do Vale;2000;4184;677;3507
4314506;Pinheiro Machado;2000;14594;10201;4393
4314555;Pirapó;2000;3349;712;2637
4314605;Piratini;2000;19414;9853;9561
4314704;Planalto;2000;11302;5757;5545
4314753;Poço das Antas;2000;1946;735;1211
4314779;Pontão;2000;3904;1080;2824
4314787;Ponte Preta;2000;2153;397;1756
4314803;Portão;2000;24657;19818;4839
4314902;Porto Alegre;2000;1360590;1320739;39851
4315008;Porto Lucena;2000;6398;2416;3982
4315057;Porto Mauá;2000;2802;924;1878
4315073;Porto Vera Cruz;2000;2464;502;1962
4315107;Porto Xavier;2000;11190;5569;5621
4315131;Pouso Novo;2000;2195;647;1548
4315149;Presidente Lucena;2000;2069;974;1095
4315156;Progresso;2000;6497;1576;4921
4315172;Protásio Alves;2000;2112;369;1743
4315206;Putinga;2000;4629;1500;3129
4315305;Quaraí;2000;24002;22060;1942
4315321;Quevedos;2000;2691;640;2051
4315354;Quinze de Novembro;2000;3582;1767;1815
4315404;Redentora;2000;8846;2762;6084
4315453;Relvado;2000;2294;638;1656
4315503;Restinga Sêca;2000;16400;8187;8213
4315552;Rio dos Índios;2000;4702;597;4105
4315602;Rio Grande;2000;186544;179208;7336
4315701;Rio Pardo;2000;37783;26041;11742
4315750;Riozinho;2000;4071;2528;1543
4315800;Roca Sales;2000;9284;4571;4713
4315909;Rodeio Bonito;2000;5751;3899;1852
4316006;Rolante;2000;17851;13928;3923
4316105;Ronda Alta;2000;10051;4388;5663
4316204;Rondinha;2000;6107;2001;4106
4316303;Roque Gonzales;2000;7799;2738;5061
4316402;Rosário do Sul;2000;41058;36250;4808
4316428;Sagrada Família;2000;2648;650;1998
4316436;Saldanha Marinho;2000;3195;1839;1356
4316451;Salto do Jacuí;2000;12948;9905;3043
4316477;Salvador das Missões;2000;2665;850;1815
4316501;Salvador do Sul;2000;6913;3192;3721
4316600;Sananduva;2000;14744;8990;5754
4316709;Santa Bárbara do Sul;2000;10003;7527;2476
4316758;Santa Clara do Sul;2000;4806;1724;3082
4316808;Santa Cruz do Sul;2000;107632;93786;13846
4316907;Santa Maria;2000;243611;230696;12915
4316956;Santa Maria do Herval;2000;5891;4159;1732
4317004;Santana da Boa Vista;2000;8621;3818;4803
4317103;Sant'Ana do Livramento;2000;90849;84455;6394
4317202;Santa Rosa;2000;65016;55950;9066
4317251;Santa Tereza;2000;1768;551;1217
4317301;Santa Vitória do Palmar;2000;33304;27952;5352
4317400;Santiago;2000;52138;45084;7054
4317509;Santo Ângelo;2000;76745;64900;11845
4317558;Santo Antônio do Palma;2000;2207;484;1723
4317608;Santo Antônio da Patrulha;2000;37035;23483;13552
4317707;Santo Antônio das Missões;2000;12691;7081;5610
4317756;Santo Antônio do Planalto;2000;2001;850;1151
4317806;Santo Augusto;2000;14426;11044;3382
4317905;Santo Cristo;2000;14890;7284;7606
4317954;Santo Expedito do Sul;2000;2683;703;1980
4318002;São Borja;2000;64869;57273;7596
4318051;São Domingos do Sul;2000;2831;1481;1350
4318101;São Francisco de Assis;2000;20810;13728;7082
4318200;São Francisco de Paula;2000;19725;12269;7456
4318309;São Gabriel;2000;62249;53197;9052
4318408;São Jerônimo;2000;20283;15611;4672
4318424;São João da Urtiga;2000;4929;1743;3186
4318432;São João do Polêsine;2000;2745;1061;1684
4318440;São Jorge;2000;2875;1188;1687
4318457;São José das Missões;2000;3000;683;2317
4318465;São José do Herval;2000;2530;730;1800
4318481;São José do Hortêncio;2000;3387;2093;1294
4318499;São José do Inhacorá;2000;2402;728;1674
4318507;São José do Norte;2000;23796;17294;6502
4318606;São José do Ouro;2000;7051;4313;2738
4318622;São José dos Ausentes;2000;3104;1516;1588
4318705;São Leopoldo;2000;193547;192895;652
4318804;São Lourenço do Sul;2000;43691;23463;20228
4318903;São Luiz Gonzaga;2000;39553;32752;6801
4319000;São Marcos;2000;18958;15694;3264
4319109;São Martinho;2000;6321;3010;3311
4319125;São Martinho da Serra;2000;3246;780;2466
4319158;São Miguel das Missões;2000;7682;3144;4538
4319208;São Nicolau;2000;6406;4010;2396
4319307;São Paulo das Missões;2000;7187;1996;5191
4319356;São Pedro da Serra;2000;2843;1201;1642
4319372;São Pedro do Butiá;2000;2862;1128;1734
4319406;São Pedro do Sul;2000;16989;11831;5158
4319505;São Sebastião do Caí;2000;19700;15957;3743
4319604;São Sepé;2000;24621;18926;5695
4319703;São Valentim;2000;4109;1539;2570
4319711;São Valentim do Sul;2000;2140;581;1559
4319737;São Valério do Sul;2000;2625;461;2164
4319752;São Vendelino;2000;1682;1067;615
4319802;São Vicente do Sul;2000;8336;5292;3044
4319901;Sapiranga;2000;69189;65785;3404
4320008;Sapucaia do Sul;2000;122751;121813;938
4320107;Sarandi;2000;18162;14262;3900
4320206;Seberi;2000;11349;5432;5917
4320230;Sede Nova;2000;3208;1570;1638
4320263;Segredo;2000;6911;1684;5227
4320305;Selbach;2000;4861;2788;2073
4320321;Senador Salgado Filho;2000;2927;632;2295
4320354;Sentinela do Sul;2000;4892;1183;3709
4320404;Serafina Corrêa;2000;10894;8416;2478
4320453;Sério;2000;2706;568;2138
4320503;Sertão;2000;7466;3697;3769
4320552;Sertão Santana;2000;5272;912;4360
4320578;Sete de Setembro;2000;2357;386;1971
4320602;Severiano de Almeida;2000;4153;1165;2988
4320651;Silveira Martins;2000;2571;1044;1527
4320677;Sinimbu;2000;10210;1194;9016
4320701;Sobradinho;2000;16328;11670;4658
4320800;Soledade;2000;29727;23356;6371
4320859;Tabaí;2000;3563;1109;2454
4320909;Tapejara;2000;15115;11641;3474
4321006;Tapera;2000;10564;8616;1948
4321105;Tapes;2000;16291;13876;2415
4321204;Taquara;2000;52825;43125;9700
4321303;Taquari;2000;25887;20792;5095
4321329;Taquaruçu do Sul;2000;2921;928;1993
4321352;Tavares;2000;5342;2604;2738
4321402;Tenente Portela;2000;14343;8520;5823
4321436;Terra de Areia;2000;11453;5072;6381
4321451;Teutônia;2000;22891;17358;5533
4321477;Tiradentes do Sul;2000;7497;1521;5976
4321493;Toropi;2000;3196;395;2801
4321501;Torres;2000;30880;27556;3324
4321600;Tramandaí;2000;31040;29688;1352
4321626;Travesseiro;2000;2349;827;1522
4321634;Três Arroios;2000;3144;794;2350
4321667;Três Cachoeiras;2000;9523;4731;4792
4321709;Três Coroas;2000;19430;17067;2363
4321808;Três de Maio;2000;24136;17725;6411
4321832;Três Forquilhas;2000;3239;267;2972
4321857;Três Palmeiras;2000;4620;1720;2900
4321907;Três Passos;2000;24656;18144;6512
4321956;Trindade do Sul;2000;5922;2141;3781
4322004;Triunfo;2000;22166;12887;9279
4322103;Tucunduva;2000;6305;3847;2458
4322152;Tunas;2000;4310;1310;3000
4322186;Tupanci do Sul;2000;1728;459;1269
4322202;Tupanciretã;2000;20947;16958;3989
4322251;Tupandi;2000;2958;1857;1101
4322301;Tuparendi;2000;9542;5107;4435
4322327;Turuçu;2000;3710;1638;2072
4322343;Ubiretama;2000;2677;474;2203
4322350;União da Serra;2000;1908;286;1622
4322376;Unistalda;2000;2644;829;1815
4322400;Uruguaiana;2000;126936;118538;8398
4322509;Vacaria;2000;57341;52425;4916
4322525;Vale Verde;2000;3101;679;2422
4322533;Vale do Sol;2000;10558;720;9838
4322541;Vale Real;2000;4340;3696;644
4322558;Vanini;2000;1887;844;1043
4322608;Venâncio Aires;2000;61234;36193;25041
4322707;Vera Cruz;2000;21300;9901;11399
4322806;Veranópolis;2000;19466;16020;3446
4322855;Vespasiano Corrêa;2000;2209;336;1873
4322905;Viadutos;2000;6087;2434;3653
4323002;Viamão;2000;227429;211612;15817
4323101;Vicente Dutra;2000;6128;2307;3821
4323200;Victor Graeff;2000;3924;1366;2558
4323309;Vila Flores;2000;3086;1045;2041
4323358;Vila Lângaro;2000;2277;230;2047
4323408;Vila Maria;2000;4173;1638;2535
4323457;Vila Nova do Sul;2000;4263;1866;2397
4323507;Vista Alegre;2000;2996;1023;1973
4323606;Vista Alegre do Prata;2000;1618;362;1256
4323705;Vista Gaúcha;2000;2725;520;2205
4323754;Vitória das Missões;2000;3979;592;3387
4323804;Xangri-lá;2000;8197;7624;573
5000203;Água Clara;2000;11015;6685;4330
5000252;Alcinópolis;2000;3679;2308;1371
5000609;Amambai;2000;29484;18818;10666
5000708;Anastácio;2000;22477;17266;5211
5000807;Anaurilândia;2000;7955;4420;3535
5000856;Angélica;2000;7356;5692;1664
5000906;Antônio João;2000;7408;6297;1111
5001003;Aparecida do Taboado;2000;18402;15644;2758
5001102;Aquidauana;2000;43440;33816;9624
5001243;Aral Moreira;2000;8055;3271;4784
5001508;Bandeirantes;2000;6425;4533;1892
5001904;Bataguassu;2000;16197;10757;5440
5002001;Batayporã;2000;10625;7257;3368
5002100;Bela Vista;2000;21764;18023;3741
5002159;Bodoquena;2000;8367;5223;3144
5002209;Bonito;2000;16956;12928;4028
5002308;Brasilândia;2000;11956;7024;4932
5002407;Caarapó;2000;20706;14656;6050
5002605;Camapuã;2000;16446;10613;5833
5002704;Campo Grande;2000;663621;655914;7707
5002803;Caracol;2000;4592;2885;1707
5002902;Cassilândia;2000;20087;17866;2221
5002951;Chapadão do Sul;2000;11658;8820;2838
5003108;Corguinho;2000;3592;1489;2103
5003157;Coronel Sapucaia;2000;12810;9472;3338
5003207;Corumbá;2000;95701;86144;9557
5003256;Costa Rica;2000;15488;11483;4005
5003306;Coxim;2000;30866;27419;3447
5003454;Deodápolis;2000;11350;8436;2914
5003488;Dois Irmãos do Buriti;2000;9335;4363;4972
5003504;Douradina;2000;4732;2703;2029
5003702;Dourados;2000;164949;149928;15021
5003751;Eldorado;2000;11059;8318;2741
5003801;Fátima do Sul;2000;19111;16280;2831
5004007;Glória de Dourados;2000;10035;7208;2827
5004106;Guia Lopes da Laguna;2000;11115;9061;2054
5004304;Iguatemi;2000;13617;9259;4358
5004403;Inocência;2000;7872;4587;3285
5004502;Itaporã;2000;17045;11731;5314
5004601;Itaquiraí;2000;15770;6281;9489
5004700;Ivinhema;2000;21643;15088;6555
5004809;Japorã;2000;6140;1205;4935
5004908;Jaraguari;2000;5389;1415;3974
5005004;Jardim;2000;22542;20953;1589
5005103;Jateí;2000;4054;1303;2751
5005152;Juti;2000;4981;3365;1616
5005202;Ladário;2000;15313;13480;1833
5005251;Laguna Carapã;2000;5531;2200;3331
5005400;Maracaju;2000;26219;21190;5029
5005608;Miranda;2000;23007;12059;10948
5005681;Mundo Novo;2000;15669;13612;2057
5005707;Naviraí;2000;36662;32662;4000
5005806;Nioaque;2000;15086;6081;9005
5006002;Nova Alvorada do Sul;2000;9956;6682;3274
5006200;Nova Andradina;2000;35381;29882;5499
5006259;Novo Horizonte do Sul;2000;6415;2316;4099
5006309;Paranaíba;2000;38406;32027;6379
5006358;Paranhos;2000;10215;5795;4420
5006408;Pedro Gomes;2000;8535;6521;2014
5006606;Ponta Porã;2000;60916;54383;6533
5006903;Porto Murtinho;2000;13316;8339;4977
5007109;Ribas do Rio Pardo;2000;16790;9485;7305
5007208;Rio Brilhante;2000;22640;16677;5963
5007307;Rio Negro;2000;5432;3739;1693
5007406;Rio Verde de Mato Grosso;2000;18138;15416;2722
5007505;Rochedo;2000;4358;2497;1861
5007554;Santa Rita do Pardo;2000;6640;3239;3401
5007695;São Gabriel do Oeste;2000;16821;13631;3190
5007703;Sete Quedas;2000;10936;8999;1937
5007802;Selvíria;2000;6085;4540;1545
5007901;Sidrolândia;2000;23483;15862;7621
5007935;Sonora;2000;9543;8074;1469
5007950;Tacuru;2000;8717;4380;4337
5007976;Taquarussu;2000;3493;2088;1405
5008008;Terenos;2000;11662;5682;5980
5008305;Três Lagoas;2000;79059;73669;5390
5008404;Vicentina;2000;5779;3479;2300
5100102;Acorizal;2000;5817;2773;3044
5100201;Água Boa;2000;16737;11795;4942
5100250;Alta Floresta;2000;46982;37287;9695
5100300;Alto Araguaia;2000;11410;9072;2338
5100359;Alto Boa Vista;2000;6206;1961;4245
5100409;Alto Garças;2000;8335;7080;1255
5100508;Alto Paraguai;2000;8605;6522;2083
5100607;Alto Taquari;2000;4476;3670;806
5100805;Apiacás;2000;6665;4465;2200
5101001;Araguaiana;2000;3426;2267;1159
5101209;Araguainha;2000;1352;1143;209
5101258;Araputanga;2000;13675;10810;2865
5101308;Arenápolis;2000;11746;10763;983
5101407;Aripuanã;2000;27560;14872;12688
5101605;Barão de Melgaço;2000;7682;3636;4046
5101704;Barra do Bugres;2000;27460;21142;6318
5101803;Barra do Garças;2000;52092;47843;4249
5101902;Brasnorte;2000;9815;6310;3505
5102504;Cáceres;2000;85857;66457;19400
5102603;Campinápolis;2000;12419;5717;6702
5102637;Campo Novo do Parecis;2000;17638;14713;2925
5102678;Campo Verde;2000;17221;13065;4156
5102686;Campos de Júlio;2000;2895;2065;830
5102694;Canabrava do Norte;2000;4989;1835;3154
5102702;Canarana;2000;15408;11657;3751
5102793;Carlinda;2000;12296;3074;9222
5102850;Castanheira;2000;7790;3680;4110
5103007;Chapada dos Guimarães;2000;15755;8840;6915
5103056;Cláudia;2000;10249;7852;2397
5103106;Cocalinho;2000;5504;3413;2091
5103205;Colíder;2000;28051;19423;8628
5103304;Comodoro;2000;15046;8865;6181
5103353;Confresa;2000;17841;6209;11632
5103379;Cotriguaçu;2000;8474;3707;4767
5103403;Cuiabá;2000;483346;476532;6814
5103452;Denise;2000;7463;6553;910
5103502;Diamantino;2000;18580;14316;4264
5103601;Dom Aquino;2000;8418;6402;2016
5103700;Feliz Natal;2000;6769;5123;1646
5103809;Figueirópolis D'Oeste;2000;4315;1761;2554
5103858;Gaúcha do Norte;2000;4605;1467;3138
5103908;General Carneiro;2000;4349;2429;1920
5103957;Glória D'Oeste;2000;3361;2111;1250
5104104;Guarantã do Norte;2000;28200;19365;8835
5104203;Guiratinga;2000;12645;11514;1131
5104500;Indiavaí;2000;2056;1259;797
5104559;Itaúba;2000;8565;4876;3689
5104609;Itiquira;2000;9200;3031;6169
5104807;Jaciara;2000;23796;20743;3053
5104906;Jangada;2000;7134;2736;4398
5105002;Jauru;2000;12764;6125;6639
5105101;Juara;2000;30748;23087;7661
5105150;Juína;2000;38017;30470;7547
5105176;Juruena;2000;5448;3745;1703
5105200;Juscimeira;2000;12063;7921;4142
5105234;Lambari D'Oeste;2000;4690;2125;2565
5105259;Lucas do Rio Verde;2000;19316;16145;3171
5105309;Luciara;2000;2494;1921;573
5105507;Vila Bela da Santíssima Trindade;2000;12665;2787;9878
5105580;Marcelândia;2000;14448;9161;5287
5105606;Matupá;2000;11289;8786;2503
5105622;Mirassol d'Oeste;2000;22997;18753;4244
5105903;Nobres;2000;14983;11960;3023
5106000;Nortelândia;2000;7246;6555;691
5106109;Nossa Senhora do Livramento;2000;12141;3898;8243
5106158;Nova Bandeirantes;2000;6951;1872;5079
5106182;Nova Lacerda;2000;4045;1834;2211
5106208;Nova Brasilândia;2000;5786;4036;1750
5106216;Nova Canaã do Norte;2000;11516;4903;6613
5106224;Nova Mutum;2000;14818;10376;4442
5106232;Nova Olímpia;2000;14186;12721;1465
5106240;Nova Ubiratã;2000;5654;1626;4028
5106257;Nova Xavantina;2000;17832;14996;2836
5106265;Novo Mundo;2000;4997;2335;2662
5106273;Novo Horizonte do Norte;2000;3511;1489;2022
5106281;Novo São Joaquim;2000;9464;4149;5315
5106299;Paranaíta;2000;10254;5505;4749
5106307;Paranatinga;2000;15342;11081;4261
5106372;Pedra Preta;2000;13611;10373;3238
5106422;Peixoto de Azevedo;2000;26156;20180;5976
5106455;Planalto da Serra;2000;2881;1672;1209
5106505;Poconé;2000;30773;22326;8447
5106653;Pontal do Araguaia;2000;3736;3090;646
5106703;Ponte Branca;2000;2087;1772;315
5106752;Pontes e Lacerda;2000;43012;29076;13936
5106778;Porto Alegre do Norte;2000;8623;4616;4007
5106802;Porto dos Gaúchos;2000;5665;3364;2301
5106828;Porto Esperidião;2000;9996;3481;6515
5106851;Porto Estrela;2000;4707;2367;2340
5107008;Poxoréu;2000;20030;14046;5984
5107040;Primavera do Leste;2000;39857;36539;3318
5107065;Querência;2000;7274;3920;3354
5107107;São José dos Quatro Marcos;2000;19693;13898;5795
5107156;Reserva do Cabaçal;2000;2418;1557;861
5107180;Ribeirão Cascalheira;2000;8866;4781;4085
5107198;Ribeirãozinho;2000;1980;1351;629
5107206;Rio Branco;2000;5092;3477;1615
5107248;Santa Carmem;2000;3660;2203;1457
5107263;Santo Afonso;2000;3098;1483;1615
5107297;São José do Povo;2000;3056;1508;1548
5107305;São José do Rio Claro;2000;12740;10945;1795
5107354;São José do Xingu;2000;5944;3245;2699
5107404;São Pedro da Cipa;2000;3495;2938;557
5107602;Rondonópolis;2000;150227;141838;8389
5107701;Rosário Oeste;2000;18755;10871;7884
5107750;Salto do Céu;2000;4675;2408;2267
5107776;Santa Terezinha;2000;6270;3358;2912
5107800;Santo Antônio do Leverger;2000;15435;5516;9919
5107859;São Félix do Araguaia;2000;10687;5916;4771
5107875;Sapezal;2000;7866;5493;2373
5107909;Sinop;2000;74831;67706;7125
5107925;Sorriso;2000;35605;31529;4076
5107941;Tabaporã;2000;10842;6214;4628
5107958;Tangará da Serra;2000;58840;51495;7345
5108006;Tapurah;2000;11561;4198;7363
5108055;Terra Nova do Norte;2000;14384;5823;8561
5108105;Tesouro;2000;3130;2538;592
5108204;Torixoréu;2000;4832;3770;1062
5108303;União do Sul;2000;4196;2771;1425
5108402;Várzea Grande;2000;215298;211303;3995
5108501;Vera;2000;9055;8294;761
5108600;Vila Rica;2000;15583;10030;5553
5108808;Nova Guarita;2000;5651;1960;3691
5108857;Nova Marilândia;2000;2354;1559;795
5108907;Nova Maringá;2000;3950;2624;1326
5108956;Nova Monte Verde;2000;6827;2197;4630
5200050;Abadia de Goiás;2000;4971;3009;1962
5200100;Abadiânia;2000;11452;7206;4246
5200134;Acreúna;2000;18301;15883;2418
5200159;Adelândia;2000;2460;2039;421
5200175;Água Fria de Goiás;2000;4469;1748;2721
5200209;Água Limpa;2000;2200;1455;745
5200258;Águas Lindas de Goiás;2000;105746;105583;163
5200308;Alexânia;2000;20335;15200;5135
5200506;Aloândia;2000;2128;1735;393
5200555;Alto Horizonte;2000;2564;1673;891
5200605;Alto Paraíso de Goiás;2000;6182;4179;2003
5200803;Alvorada do Norte;2000;7560;6787;773
5200829;Amaralina;2000;3074;1171;1903
5200852;Americano do Brasil;2000;4933;4116;817
5200902;Amorinópolis;2000;4145;2439;1706
5201108;Anápolis;2000;288085;280164;7921
5201207;Anhanguera;2000;895;840;55
5201306;Anicuns;2000;18754;14729;4025
5201405;Aparecida de Goiânia;2000;336392;335547;845
5201454;Aparecida do Rio Doce;2000;2402;1807;595
5201504;Aporé;2000;3427;2017;1410
5201603;Araçu;2000;4127;3504;623
5201702;Aragarças;2000;16592;16118;474
5201801;Aragoiânia;2000;6424;4262;2162
5202155;Araguapaz;2000;7310;4941;2369
5202353;Arenópolis;2000;3999;2234;1765
5202502;Aruanã;2000;5095;3880;1215
5202601;Aurilândia;2000;4235;3079;1156
5202809;Avelinópolis;2000;2507;1671;836
5203104;Baliza;2000;2270;1077;1193
5203203;Barro Alto;2000;6251;3934;2317
5203302;Bela Vista de Goiás;2000;19210;11468;7742
5203401;Bom Jardim de Goiás;2000;8068;5914;2154
5203500;Bom Jesus de Goiás;2000;16257;14746;1511
5203559;Bonfinópolis;2000;5353;4908;445
5203575;Bonópolis;2000;2598;1131;1467
5203609;Brazabrantes;2000;2772;1723;1049
5203807;Britânia;2000;5279;4289;990
5203906;Buriti Alegre;2000;8718;7371;1347
5203939;Buriti de Goiás;2000;2659;1698;961
5203962;Buritinópolis;2000;3383;1651;1732
5204003;Cabeceiras;2000;6758;4999;1759
5204102;Cachoeira Alta;2000;8646;6081;2565
5204201;Cachoeira de Goiás;2000;1498;1227;271
5204250;Cachoeira Dourada;2000;8525;3940;4585
5204300;Caçu;2000;10575;8092;2483
5204409;Caiapônia;2000;14673;10819;3854
5204508;Caldas Novas;2000;49660;47308;2352
5204557;Caldazinha;2000;2859;1194;1665
5204607;Campestre de Goiás;2000;3167;1988;1179
5204656;Campinaçu;2000;3707;1882;1825
5204706;Campinorte;2000;9641;7074;2567
5204805;Campo Alegre de Goiás;2000;4528;2871;1657
5204904;Campos Belos;2000;17047;14207;2840
5204953;Campos Verdes;2000;8057;7214;843
5205000;Carmo do Rio Verde;2000;7941;5182;2759
5205059;Castelândia;2000;3882;3491;391
5205109;Catalão;2000;64347;57606;6741
5205208;Caturaí;2000;4330;3117;1213
5205307;Cavalcante;2000;9150;3654;5496
5205406;Ceres;2000;22209;18123;4086
5205455;Cezarina;2000;6514;4385;2129
5205471;Chapadão do Céu;2000;3778;2818;960
5205497;Cidade Ocidental;2000;40377;34465;5912
5205513;Cocalzinho de Goiás;2000;14626;6000;8626
5205521;Colinas do Sul;2000;3702;2407;1295
5205703;Córrego do Ouro;2000;2973;1609;1364
5205802;Corumbá de Goiás;2000;9679;5597;4082
5205901;Corumbaíba;2000;6655;4855;1800
5206206;Cristalina;2000;34116;27569;6547
5206305;Cristianópolis;2000;2924;2371;553
5206404;Crixás;2000;14673;11035;3638
5206503;Cromínia;2000;3660;2717;943
5206602;Cumari;2000;3105;2249;856
5206701;Damianópolis;2000;3303;1502;1801
5206800;Damolândia;2000;2573;1885;688
5206909;Davinópolis;2000;2109;1245;864
5207105;Diorama;2000;2498;1442;1056
5207253;Doverlândia;2000;8558;5329;3229
5207352;Edealina;2000;3803;2451;1352
5207402;Edéia;2000;10223;8107;2116
5207501;Estrela do Norte;2000;3398;2988;410
5207535;Faina;2000;7419;3698;3721
5207600;Fazenda Nova;2000;7093;4623;2470
5207808;Firminópolis;2000;9909;7639;2270
5207907;Flores de Goiás;2000;7514;2225;5289
5208004;Formosa;2000;78651;69285;9366
5208103;Formoso;2000;5589;4020;1569
5208301;Divinópolis de Goiás;2000;5172;2993;2179
5208400;Goianápolis;2000;10671;9805;866
5208509;Goiandira;2000;4967;4199;768
5208608;Goianésia;2000;49160;44912;4248
5208707;Goiânia;2000;1093007;1085806;7201
5208806;Goianira;2000;18719;18064;655
5208905;Goiás;2000;27120;19397;7723
5209101;Goiatuba;2000;31130;27806;3324
5209150;Gouvelândia;2000;4009;2956;1053
5209200;Guapó;2000;13997;9916;4081
5209291;Guaraíta;2000;2794;1479;1315
5209408;Guarani de Goiás;2000;4678;1708;2970
5209457;Guarinos;2000;2844;1325;1519
5209606;Heitoraí;2000;3445;2289;1156
5209705;Hidrolândia;2000;13086;7836;5250
5209804;Hidrolina;2000;4548;3041;1507
5209903;Iaciara;2000;11295;7998;3297
5209937;Inaciolândia;2000;5239;4058;1181
5209952;Indiara;2000;11816;9453;2363
5210000;Inhumas;2000;43897;39976;3921
5210109;Ipameri;2000;22628;18840;3788
5210208;Iporá;2000;31300;28192;3108
5210307;Israelândia;2000;3004;2297;707
5210406;Itaberaí;2000;27879;21249;6630
5210562;Itaguari;2000;4385;3508;877
5210604;Itaguaru;2000;5696;4571;1125
5210802;Itajá;2000;6572;4149;2423
5210901;Itapaci;2000;13931;11950;1981
5211008;Itapirapuã;2000;10856;7462;3394
5211206;Itapuranga;2000;26740;19905;6835
5211305;Itarumã;2000;5446;3033;2413
5211404;Itauçu;2000;8277;6157;2120
5211503;Itumbiara;2000;81430;77123;4307
5211602;Ivolândia;2000;2992;1535;1457
5211701;Jandaia;2000;6342;4021;2321
5211800;Jaraguá;2000;33284;24673;8611
5211909;Jataí;2000;75451;68821;6630
5212006;Jaupaci;2000;3154;2513;641
5212055;Jesúpolis;2000;2123;1509;614
5212105;Joviânia;2000;6904;5978;926
5212204;Jussara;2000;20034;15626;4408
5212303;Leopoldo de Bulhões;2000;7766;4704;3062
5212501;Luziânia;2000;141082;130165;10917
5212600;Mairipotaba;2000;2403;1488;915
5212709;Mambaí;2000;4838;3488;1350
5212808;Mara Rosa;2000;11939;8338;3601
5212907;Marzagão;2000;1920;1661;259
5212956;Matrinchã;2000;4520;3254;1266
5213004;Maurilândia;2000;8969;8437;532
5213053;Mimoso de Goiás;2000;2801;1186;1615
5213087;Minaçu;2000;33608;28911;4697
5213103;Mineiros;2000;39024;34660;4364
5213400;Moiporá;2000;2023;1293;730
5213509;Monte Alegre de Goiás;2000;6892;2746;4146
5213707;Montes Claros de Goiás;2000;8052;4759;3293
5213756;Montividiu;2000;7736;5410;2326
5213772;Montividiu do Norte;2000;3789;1210;2579
5213806;Morrinhos;2000;36990;30929;6061
5213855;Morro Agudo de Goiás;2000;2642;1584;1058
5213905;Mossâmedes;2000;5904;3595;2309
5214002;Mozarlândia;2000;11186;9709;1477
5214051;Mundo Novo;2000;8231;4829;3402
5214101;Mutunópolis;2000;3958;3025;933
5214408;Nazário;2000;6631;5871;760
5214507;Nerópolis;2000;18578;17253;1325
5214606;Niquelândia;2000;38573;26578;11995
5214705;Nova América;2000;2185;1428;757
5214804;Nova Aurora;2000;1927;1663;264
5214838;Nova Crixás;2000;11061;7048;4013
5214861;Nova Glória;2000;8944;5688;3256
5214879;Nova Iguaçu de Goiás;2000;2746;1795;951
5214903;Nova Roma;2000;3717;1341;2376
5215009;Nova Veneza;2000;6414;5354;1060
5215207;Novo Brasil;2000;4181;2571;1610
5215231;Novo Gama;2000;74380;73026;1354
5215256;Novo Planalto;2000;3432;2925;507
5215306;Orizona;2000;13067;6382;6685
5215405;Ouro Verde de Goiás;2000;4358;2397;1961
5215504;Ouvidor;2000;4271;3141;1130
5215603;Padre Bernardo;2000;21514;13272;8242
5215652;Palestina de Goiás;2000;3307;1820;1487
5215702;Palmeiras de Goiás;2000;17822;13500;4322
5215801;Palmelo;2000;2309;2200;109
5215900;Palminópolis;2000;3561;2257;1304
5216007;Panamá;2000;2776;1943;833
5216304;Paranaiguara;2000;8192;7229;963
5216403;Paraúna;2000;10834;7686;3148
5216452;Perolândia;2000;2791;1700;1091
5216809;Petrolina de Goiás;2000;10381;6437;3944
5216908;Pilar de Goiás;2000;3339;1200;2139
5217104;Piracanjuba;2000;23557;15206;8351
5217203;Piranhas;2000;12287;10009;2278
5217302;Pirenópolis;2000;21245;12475;8770
5217401;Pires do Rio;2000;26229;24473;1756
5217609;Planaltina;2000;73718;70127;3591
5217708;Pontalina;2000;16556;13382;3174
5218003;Porangatu;2000;39593;33423;6170
5218052;Porteirão;2000;2823;2364;459
5218102;Portelândia;2000;3696;2817;879
5218300;Posse;2000;25696;18388;7308
5218391;Professor Jamil;2000;3403;2177;1226
5218508;Quirinópolis;2000;36512;30822;5690
5218607;Rialma;2000;10210;9156;1054
5218706;Rianápolis;2000;4364;3730;634
5218789;Rio Quente;2000;2097;1648;449
5218805;Rio Verde;2000;116552;106079;10473
5218904;Rubiataba;2000;18087;15206;2881
5219001;Sanclerlândia;2000;7530;5765;1765
5219100;Santa Bárbara de Goiás;2000;4963;4233;730
5219209;Santa Cruz de Goiás;2000;3470;1043;2427
5219258;Santa Fé de Goiás;2000;4083;3030;1053
5219308;Santa Helena de Goiás;2000;34545;32349;2196
5219357;Santa Isabel;2000;3592;1255;2337
5219407;Santa Rita do Araguaia;2000;5087;4628;459
5219456;Santa Rita do Novo Destino;2000;3025;1043;1982
5219506;Santa Rosa de Goiás;2000;3548;2297;1251
5219605;Santa Tereza de Goiás;2000;4697;3920;777
5219704;Santa Terezinha de Goiás;2000;12015;8871;3144
5219712;Santo Antônio da Barra;2000;4052;3291;761
5219738;Santo Antônio de Goiás;2000;3106;2564;542
5219753;Santo Antônio do Descoberto;2000;51897;48398;3499
5219803;São Domingos;2000;9636;4434;5202
5219902;São Francisco de Goiás;2000;6132;4041;2091
5220009;São João d'Aliança;2000;6736;4188;2548
5220058;São João da Paraúna;2000;2024;1357;667
5220108;São Luís de Montes Belos;2000;26383;22271;4112
5220157;São Luiz do Norte;2000;4089;3236;853
5220207;São Miguel do Araguaia;2000;22793;18053;4740
5220264;São Miguel do Passa Quatro;2000;3481;1501;1980
5220280;São Patrício;2000;1835;799;1036
5220405;São Simão;2000;13552;13277;275
5220454;Senador Canedo;2000;53105;50442;2663
5220504;Serranópolis;2000;6447;3723;2724
5220603;Silvânia;2000;20339;10353;9986
5220686;Simolândia;2000;6219;5144;1075
5220702;Sítio d'Abadia;2000;2681;852;1829
5221007;Taquaral de Goiás;2000;3587;2367;1220
5221080;Teresina de Goiás;2000;2585;1775;810
5221197;Terezópolis de Goiás;2000;5083;3616;1467
5221304;Três Ranchos;2000;2831;2276;555
5221403;Trindade;2000;81457;78199;3258
5221452;Trombas;2000;3434;2510;924
5221502;Turvânia;2000;5134;3993;1141
5221551;Turvelândia;2000;3524;2289;1235
5221577;Uirapuru;2000;3043;1405;1638
5221601;Uruaçu;2000;33530;29561;3969
5221700;Uruana;2000;13938;10919;3019
5221809;Urutaí;2000;3104;2213;891
5221858;Valparaíso de Goiás;2000;94856;94856;0
5221908;Varjão;2000;3519;2219;1300
5222005;Vianópolis;2000;11300;7723;3577
5222054;Vicentinópolis;2000;6015;4927;1088
5222203;Vila Boa;2000;3287;2702;585
5222302;Vila Propício;2000;4492;1174;3318
5300108;Brasília;2000;2051146;1961499;89647
1100015;Alta Floresta D'Oeste;2010;24392;13970;10422
1100023;Ariquemes;2010;90353;76525;13828
1100031;Cabixi;2010;6313;2693;3620
1100049;Cacoal;2010;78574;61921;16653
1100056;Cerejeiras;2010;17029;14419;2610
1100064;Colorado do Oeste;2010;18591;13657;4934
1100072;Corumbiara;2010;8783;2590;6193
1100080;Costa Marques;2010;13678;7497;6181
1100098;Espigão D'Oeste;2010;28729;20610;8119
1100106;Guajará-Mirim;2010;41656;35207;6449
1100114;Jaru;2010;52005;35118;16887
1100122;Ji-Paraná;2010;116610;104858;11752
1100130;Machadinho D'Oeste;2010;31135;16173;14962
1100148;Nova Brasilândia D'Oeste;2010;19874;8380;11494
1100155;Ouro Preto do Oeste;2010;37928;28180;9748
1100189;Pimenta Bueno;2010;33822;29417;4405
1100205;Porto Velho;2010;428527;392475;36052
1100254;Presidente Médici;2010;22319;13303;9016
1100262;Rio Crespo;2010;3316;1064;2252
1100288;Rolim de Moura;2010;50648;41429;9219
1100296;Santa Luzia D'Oeste;2010;8886;4525;4361
1100304;Vilhena;2010;76202;72218;3984
1100320;São Miguel do Guaporé;2010;21828;8470;13358
1100338;Nova Mamoré;2010;22546;13067;9479
1100346;Alvorada D'Oeste;2010;16853;8824;8029
1100379;Alto Alegre dos Parecis;2010;12816;3657;9159
1100403;Alto Paraíso;2010;17135;8202;8933
1100452;Buritis;2010;32383;18122;14261
1100502;Novo Horizonte do Oeste;2010;10240;1733;8507
1100601;Cacaulândia;2010;5736;2069;3667
1100700;Campo Novo de Rondônia;2010;12665;3371;9294
1100809;Candeias do Jamari;2010;19779;12887;6892
1100908;Castanheiras;2010;3575;836;2739
1100924;Chupinguaia;2010;8301;3663;4638
1100940;Cujubim;2010;15854;11043;4811
1101005;Governador Jorge Teixeira;2010;10512;2361;8151
1101104;Itapuã do Oeste;2010;8566;5222;3344
1101203;Ministro Andreazza;2010;10352;3074;7278
1101302;Mirante da Serra;2010;11878;6444;5434
1101401;Monte Negro;2010;14091;7390;6701
1101435;Nova União;2010;7493;1541;5952
1101450;Parecis;2010;4810;1774;3036
1101468;Pimenteiras do Oeste;2010;2315;1292;1023
1101476;Primavera de Rondônia;2010;3524;1284;2240
1101484;São Felipe D'Oeste;2010;6018;1444;4574
1101492;São Francisco do Guaporé;2010;16035;8227;7808
1101500;Seringueiras;2010;11629;4397;7232
1101559;Teixeirópolis;2010;4888;1716;3172
1101609;Theobroma;2010;10649;1978;8671
1101708;Urupá;2010;12974;5137;7837
1101757;Vale do Anari;2010;9384;3192;6192
1101807;Vale do Paraíso;2010;8210;2276;5934
1200013;Acrelândia;2010;12538;5916;6622
1200054;Assis Brasil;2010;6072;3700;2372
1200104;Brasiléia;2010;21398;14257;7141
1200138;Bujari;2010;8471;3693;4778
1200179;Capixaba;2010;8798;3929;4869
1200203;Cruzeiro do Sul;2010;78507;55326;23181
1200252;Epitaciolândia;2010;15100;10618;4482
1200302;Feijó;2010;32412;16636;15776
1200328;Jordão;2010;6577;2272;4305
1200336;Mâncio Lima;2010;15206;8750;6456
1200344;Manoel Urbano;2010;7981;5278;2703
1200351;Marechal Thaumaturgo;2010;14227;3969;10258
1200385;Plácido de Castro;2010;17209;10382;6827
1200393;Porto Walter;2010;9176;3323;5853
1200401;Rio Branco;2010;336038;308545;27493
1200427;Rodrigues Alves;2010;14389;4315;10074
1200435;Santa Rosa do Purus;2010;4691;1892;2799
1200450;Senador Guiomard;2010;20179;12703;7476
1200500;Sena Madureira;2010;38029;25112;12917
1200609;Tarauacá;2010;35590;19351;16239
1200708;Xapuri;2010;16091;10330;5761
1200807;Porto Acre;2010;14880;1982;12898
1300029;Alvarães;2010;14088;7887;6201
1300060;Amaturá;2010;9467;4960;4507
1300086;Anamã;2010;10214;4174;6040
1300102;Anori;2010;16317;10000;6317
1300144;Apuí;2010;18007;10595;7412
1300201;Atalaia do Norte;2010;15153;6893;8260
1300300;Autazes;2010;32135;13893;18242
1300409;Barcelos;2010;25718;11157;14561
1300508;Barreirinha;2010;27355;12418;14937
1300607;Benjamin Constant;2010;33411;20138;13273
1300631;Beruri;2010;15486;7778;7708
1300680;Boa Vista do Ramos;2010;14979;7550;7429
1300706;Boca do Acre;2010;30632;19348;11284
1300805;Borba;2010;34961;14434;20527
1300839;Caapiranga;2010;10975;5140;5835
1300904;Canutama;2010;12738;6682;6056
1301001;Carauari;2010;25774;19744;6030
1301100;Careiro;2010;32734;9437;23297
1301159;Careiro da Várzea;2010;23930;1000;22930
1301209;Coari;2010;75965;49651;26314
1301308;Codajás;2010;23206;15806;7400
1301407;Eirunepé;2010;30665;22166;8499
1301506;Envira;2010;16338;10552;5786
1301605;Fonte Boa;2010;22817;15115;7702
1301654;Guajará;2010;13974;7427;6547
1301704;Humaitá;2010;44227;30501;13726
1301803;Ipixuna;2010;22254;9499;12755
1301852;Iranduba;2010;40781;28979;11802
1301902;Itacoatiara;2010;86839;58157;28682
1301951;Itamarati;2010;8038;4472;3566
1302009;Itapiranga;2010;8211;6451;1760
1302108;Japurá;2010;7326;3298;4028
1302207;Juruá;2010;10802;5686;5116
1302306;Jutaí;2010;17992;10552;7440
1302405;Lábrea;2010;37701;24207;13494
1302504;Manacapuru;2010;85141;59866;25275
1302553;Manaquiri;2010;22801;7078;15723
1302603;Manaus;2010;1802014;1792881;9133
1302702;Manicoré;2010;47017;20349;26668
1302801;Maraã;2010;17528;8753;8775
1302900;Maués;2010;52236;25832;26404
1303007;Nhamundá;2010;18278;7010;11268
1303106;Nova Olinda do Norte;2010;30696;13626;17070
1303205;Novo Airão;2010;14723;9499;5224
1303304;Novo Aripuanã;2010;21451;14074;7377
1303403;Parintins;2010;102033;69890;32143
1303502;Pauini;2010;18166;9264;8902
1303536;Presidente Figueiredo;2010;27175;13001;14174
1303569;Rio Preto da Eva;2010;25719;12205;13514
1303601;Santa Isabel do Rio Negro;2010;18146;6856;11290
1303700;Santo Antônio do Içá;2010;24481;12947;11534
1303809;São Gabriel da Cachoeira;2010;37896;19054;18842
1303908;São Paulo de Olivença;2010;31422;14263;17159
1303957;São Sebastião do Uatumã;2010;10705;5904;4801
1304005;Silves;2010;8444;4029;4415
1304062;Tabatinga;2010;52272;36355;15917
1304104;Tapauá;2010;19077;10618;8459
1304203;Tefé;2010;61453;50069;11384
1304237;Tonantins;2010;17079;8899;8180
1304260;Uarini;2010;11891;6795;5096
1304302;Urucará;2010;17094;9886;7208
1304401;Urucurituba;2010;17837;10448;7389
1400027;Amajari;2010;9327;1219;8108
1400050;Alto Alegre;2010;16448;4780;11668
1400100;Boa Vista;2010;284313;277799;6514
1400159;Bonfim;2010;10943;3711;7232
1400175;Cantá;2010;13902;2257;11645
1400209;Caracaraí;2010;18398;10910;7488
1400233;Caroebe;2010;8114;3324;4790
1400282;Iracema;2010;8696;4078;4618
1400308;Mucajaí;2010;14792;9109;5683
1400407;Normandia;2010;8940;2311;6629
1400456;Pacaraima;2010;10433;4514;5919
1400472;Rorainópolis;2010;24279;11532;12747
1400506;São João da Baliza;2010;6769;4755;2014
1400605;São Luiz;2010;6750;4455;2295
1400704;Uiramutã;2010;8375;1138;7237
1500107;Abaetetuba;2010;141100;82998;58102
1500131;Abel Figueiredo;2010;6780;6034;746
1500206;Acará;2010;53569;12621;40948
1500305;Afuá;2010;35042;9478;25564
1500347;Água Azul do Norte;2010;25057;4876;20181
1500404;Alenquer;2010;52626;27722;24904
1500503;Almeirim;2010;33614;19965;13649
1500602;Altamira;2010;99075;84092;14983
1500701;Anajás;2010;24759;9494;15265
1500800;Ananindeua;2010;471980;470819;1161
1500859;Anapu;2010;20543;9833;10710
1500909;Augusto Corrêa;2010;40497;18240;22257
1500958;Aurora do Pará;2010;26546;8168;18378
1501006;Aveiro;2010;15849;3179;12670
1501105;Bagre;2010;23864;10661;13203
1501204;Baião;2010;36882;18555;18327
1501253;Bannach;2010;3431;1282;2149
1501303;Barcarena;2010;99859;36297;63562
1501402;Belém;2010;1393399;1381475;11924
1501451;Belterra;2010;16318;6852;9466
1501501;Benevides;2010;51651;28912;22739
1501576;Bom Jesus do Tocantins;2010;15298;8158;7140
1501600;Bonito;2010;13630;3827;9803
1501709;Bragança;2010;113227;72621;40606
1501725;Brasil Novo;2010;15690;6899;8791
1501758;Brejo Grande do Araguaia;2010;7317;4308;3009
1501782;Breu Branco;2010;52493;29308;23185
1501808;Breves;2010;92860;46671;46189
1501907;Bujaru;2010;25695;8099;17596
1501956;Cachoeira do Piriá;2010;26484;5532;20952
1502004;Cachoeira do Arari;2010;20443;7356;13087
1502103;Cametá;2010;120896;52838;68058
1502152;Canaã dos Carajás;2010;26716;20727;5989
1502202;Capanema;2010;63639;50732;12907
1502301;Capitão Poço;2010;51893;21441;30452
1502400;Castanhal;2010;173149;153378;19771
1502509;Chaves;2010;21005;2510;18495
1502608;Colares;2010;11381;3661;7720
1502707;Conceição do Araguaia;2010;45557;32464;13093
1502756;Concórdia do Pará;2010;28216;15088;13128
1502764;Cumaru do Norte;2010;10466;2711;7755
1502772;Curionópolis;2010;18288;12530;5758
1502806;Curralinho;2010;28549;10930;17619
1502855;Curuá;2010;12254;5781;6473
1502905;Curuçá;2010;34294;12174;22120
1502939;Dom Eliseu;2010;51319;32516;18803
1502954;Eldorado do Carajás;2010;31786;16578;15208
1503002;Faro;2010;8177;6128;2049
1503044;Floresta do Araguaia;2010;17768;8714;9054
1503077;Garrafão do Norte;2010;25034;8607;16427
1503093;Goianésia do Pará;2010;30436;21082;9354
1503101;Gurupá;2010;29062;9580;19482
1503200;Igarapé-Açu;2010;35887;21207;14680
1503309;Igarapé-Miri;2010;58077;26205;31872
1503408;Inhangapi;2010;10037;2771;7266
1503457;Ipixuna do Pará;2010;51309;12227;39082
1503507;Irituia;2010;31364;6524;24840
1503606;Itaituba;2010;97493;70682;26811
1503705;Itupiranga;2010;51220;20490;30730
1503754;Jacareacanga;2010;14103;4930;9173
1503804;Jacundá;2010;51360;45683;5677
1503903;Juruti;2010;47086;15852;31234
1504000;Limoeiro do Ajuru;2010;25021;6197;18824
1504059;Mãe do Rio;2010;27904;23052;4852
1504109;Magalhães Barata;2010;8115;3795;4320
1504208;Marabá;2010;233669;186270;47399
1504307;Maracanã;2010;28376;11656;16720
1504406;Marapanim;2010;26605;11704;14901
1504422;Marituba;2010;108246;107123;1123
1504455;Medicilândia;2010;27328;9559;17769
1504505;Melgaço;2010;24808;5503;19305
1504604;Mocajuba;2010;26731;18279;8452
1504703;Moju;2010;70018;25162;44856
1504802;Monte Alegre;2010;55462;24565;30897
1504901;Muaná;2010;34204;14521;19683
1504950;Nova Esperança do Piriá;2010;20158;7964;12194
1504976;Nova Ipixuna;2010;14645;7726;6919
1505007;Nova Timboteua;2010;13670;5520;8150
1505031;Novo Progresso;2010;25124;17717;7407
1505064;Novo Repartimento;2010;62050;27950;34100
1505106;Óbidos;2010;49333;25466;23867
1505205;Oeiras do Pará;2010;28595;11432;17163
1505304;Oriximiná;2010;62794;40147;22647
1505403;Ourém;2010;16311;7438;8873
1505437;Ourilândia do Norte;2010;27359;19913;7446
1505486;Pacajá;2010;39979;13747;26232
1505494;Palestina do Pará;2010;7475;4546;2929
1505502;Paragominas;2010;97819;76511;21308
1505536;Parauapebas;2010;153908;138690;15218
1505551;Pau D'Arco;2010;6033;3641;2392
1505601;Peixe-Boi;2010;7854;4169;3685
1505635;Piçarra;2010;12697;3581;9116
1505650;Placas;2010;23934;4854;19080
1505700;Ponta de Pedras;2010;25999;12424;13575
1505809;Portel;2010;52172;24852;27320
1505908;Porto de Moz;2010;33956;14583;19373
1506005;Prainha;2010;29349;8959;20390
1506104;Primavera;2010;10268;6391;3877
1506112;Quatipuru;2010;12411;5313;7098
1506138;Redenção;2010;75556;70065;5491
1506161;Rio Maria;2010;17697;13512;4185
1506187;Rondon do Pará;2010;46964;34696;12268
1506195;Rurópolis;2010;40087;15273;24814
1506203;Salinópolis;2010;37421;33391;4030
1506302;Salvaterra;2010;20183;12672;7511
1506351;Santa Bárbara do Pará;2010;17141;5458;11683
1506401;Santa Cruz do Arari;2010;8155;3994;4161
1506500;Santa Izabel do Pará;2010;59466;43000;16466
1506559;Santa Luzia do Pará;2010;19424;8693;10731
1506583;Santa Maria das Barreiras;2010;17206;6357;10849
1506609;Santa Maria do Pará;2010;23026;13328;9698
1506708;Santana do Araguaia;2010;56153;29663;26490
1506807;Santarém;2010;294580;215790;78790
1506906;Santarém Novo;2010;6141;1809;4332
1507003;Santo Antônio do Tauá;2010;26674;14871;11803
1507102;São Caetano de Odivelas;2010;16891;6958;9933
1507151;São Domingos do Araguaia;2010;23130;15254;7876
1507201;São Domingos do Capim;2010;29846;6589;23257
1507300;São Félix do Xingu;2010;91340;45113;46227
1507409;São Francisco do Pará;2010;15060;5113;9947
1507458;São Geraldo do Araguaia;2010;25587;13590;11997
1507466;São João da Ponta;2010;5265;1031;4234
1507474;São João de Pirabas;2010;20647;10487;10160
1507508;São João do Araguaia;2010;13155;2586;10569
1507607;São Miguel do Guamá;2010;51567;31884;19683
1507706;São Sebastião da Boa Vista;2010;22904;9902;13002
1507755;Sapucaia;2010;5047;3325;1722
1507805;Senador José Porfírio;2010;13045;6470;6575
1507904;Soure;2010;23001;21015;1986
1507953;Tailândia;2010;79297;58713;20584
1507961;Terra Alta;2010;10262;4334;5928
1507979;Terra Santa;2010;16949;11334;5615
1508001;Tomé-Açu;2010;56518;31563;24955
1508035;Tracuateua;2010;27455;7256;20199
1508050;Trairão;2010;16875;5679;11196
1508084;Tucumã;2010;33690;26907;6783
1508100;Tucuruí;2010;97128;92442;4686
1508126;Ulianópolis;2010;43341;28525;14816
1508159;Uruará;2010;44789;24430;20359
1508209;Vigia;2010;47889;32353;15536
1508308;Viseu;2010;56716;18397;38319
1508357;Vitória do Xingu;2010;13431;6330;7101
1508407;Xinguara;2010;40573;31492;9081
1600055;Serra do Navio;2010;4380;2575;1805
1600105;Amapá;2010;8069;6959;1110
1600154;Pedra Branca do Amapari;2010;10772;5963;4809
1600204;Calçoene;2010;9000;7307;1693
1600212;Cutias;2010;4696;2442;2254
1600238;Ferreira Gomes;2010;5802;4275;1527
1600253;Itaubal;2010;4265;1754;2511
1600279;Laranjal do Jari;2010;39942;37904;2038
1600303;Macapá;2010;398204;381091;17113
1600402;Mazagão;2010;17032;8272;8760
1600501;Oiapoque;2010;20509;13852;6657
1600535;Porto Grande;2010;16809;10809;6000
1600550;Pracuúba;2010;3793;1881;1912
1600600;Santana;2010;101262;99111;2151
1600709;Tartarugalzinho;2010;12563;6516;6047
1600808;Vitória do Jari;2010;12428;10302;2126
1700251;Abreulândia;2010;2391;1476;915
1700301;Aguiarnópolis;2010;5162;4142;1020
1700350;Aliança do Tocantins;2010;5671;4756;915
1700400;Almas;2010;7586;6009;1577
1700707;Alvorada;2010;8374;7765;609
1701002;Ananás;2010;9865;8144;1721
1701051;Angico;2010;3175;1938;1237
1701101;Aparecida do Rio Negro;2010;4213;3313;900
1701309;Aragominas;2010;5882;2230;3652
1701903;Araguacema;2010;6317;2925;3392
1702000;Araguaçu;2010;8786;5882;2904
1702109;Araguaína;2010;150484;142925;7559
1702158;Araguanã;2010;5030;3386;1644
1702208;Araguatins;2010;31329;20135;11194
1702307;Arapoema;2010;6742;5455;1287
1702406;Arraias;2010;10645;7371;3274
1702554;Augustinópolis;2010;15950;13176;2774
1702703;Aurora do Tocantins;2010;3446;2482;964
1702901;Axixá do Tocantins;2010;9275;7621;1654
1703008;Babaçulândia;2010;10424;4929;5495
1703057;Bandeirantes do Tocantins;2010;3122;1685;1437
1703073;Barra do Ouro;2010;4123;2186;1937
1703107;Barrolândia;2010;5349;4479;870
1703206;Bernardo Sayão;2010;4456;2187;2269
1703305;Bom Jesus do Tocantins;2010;3768;2826;942
1703602;Brasilândia do Tocantins;2010;2064;1436;628
1703701;Brejinho de Nazaré;2010;5185;4195;990
1703800;Buriti do Tocantins;2010;9768;7454;2314
1703826;Cachoeirinha;2010;2148;1731;417
1703842;Campos Lindos;2010;8139;4819;3320
1703867;Cariri do Tocantins;2010;3756;2093;1663
1703883;Carmolândia;2010;2316;1824;492
1703891;Carrasco Bonito;2010;3688;1967;1721
1703909;Caseara;2010;4601;2737;1864
1704105;Centenário;2010;2566;1504;1062
1704600;Chapada de Areia;2010;1335;749;586
1705102;Chapada da Natividade;2010;3277;1656;1621
1705508;Colinas do Tocantins;2010;30838;29607;1231
1705557;Combinado;2010;4669;4000;669
1705607;Conceição do Tocantins;2010;4182;2911;1271
1706001;Couto Magalhães;2010;5009;1884;3125
1706100;Cristalândia;2010;7234;5924;1310
1706258;Crixás do Tocantins;2010;1564;872;692
1706506;Darcinópolis;2010;5273;3489;1784
1707009;Dianópolis;2010;19112;16444;2668
1707108;Divinópolis do Tocantins;2010;6363;4466;1897
1707207;Dois Irmãos do Tocantins;2010;7161;2777;4384
1707306;Dueré;2010;4592;3055;1537
1707405;Esperantina;2010;9476;4614;4862
1707553;Fátima;2010;3805;3135;670
1707652;Figueirópolis;2010;5340;4054;1286
1707702;Filadélfia;2010;8505;5538;2967
1708205;Formoso do Araguaia;2010;18427;13333;5094
1708254;Fortaleza do Tabocão;2010;2419;1968;451
1708304;Goianorte;2010;4956;2760;2196
1709005;Goiatins;2010;12064;4949;7115
1709302;Guaraí;2010;23200;21128;2072
1709500;Gurupi;2010;76755;75000;1755
1709807;Ipueiras;2010;1639;958;681
1710508;Itacajá;2010;7104;4273;2831
1710706;Itaguatins;2010;6029;3396;2633
1710904;Itapiratins;2010;3532;1914;1618
1711100;Itaporã do Tocantins;2010;2445;1563;882
1711506;Jaú do Tocantins;2010;3507;1310;2197
1711803;Juarina;2010;2231;1033;1198
1711902;Lagoa da Confusão;2010;10210;6332;3878
1711951;Lagoa do Tocantins;2010;3525;2538;987
1712009;Lajeado;2010;2773;2166;607
1712157;Lavandeira;2010;1605;1023;582
1712405;Lizarda;2010;3725;2583;1142
1712454;Luzinópolis;2010;2622;1675;947
1712504;Marianópolis do Tocantins;2010;4352;2383;1969
1712702;Mateiros;2010;2223;1417;806
1712801;Maurilândia do Tocantins;2010;3154;2017;1137
1713205;Miracema do Tocantins;2010;20684;17937;2747
1713304;Miranorte;2010;12623;11036;1587
1713601;Monte do Carmo;2010;6716;2881;3835
1713700;Monte Santo do Tocantins;2010;2085;450;1635
1713809;Palmeiras do Tocantins;2010;5740;3232;2508
1713957;Muricilândia;2010;3152;1800;1352
1714203;Natividade;2010;9000;7195;1805
1714302;Nazaré;2010;4386;1991;2395
1714880;Nova Olinda;2010;10686;7465;3221
1715002;Nova Rosalândia;2010;3770;2468;1302
1715101;Novo Acordo;2010;3762;3083;679
1715150;Novo Alegre;2010;2286;1699;587
1715259;Novo Jardim;2010;2457;1776;681
1715507;Oliveira de Fátima;2010;1037;817;220
1715705;Palmeirante;2010;4954;1926;3028
1715754;Palmeirópolis;2010;7339;5981;1358
1716109;Paraíso do Tocantins;2010;44417;42473;1944
1716208;Paranã;2010;10338;4720;5618
1716307;Pau D'Arco;2010;4588;2900;1688
1716505;Pedro Afonso;2010;11539;10016;1523
1716604;Peixe;2010;10384;5235;5149
1716653;Pequizeiro;2010;5054;2390;2664
1716703;Colméia;2010;8611;6370;2241
1717008;Pindorama do Tocantins;2010;4506;2947;1559
1717206;Piraquê;2010;2920;1122;1798
1717503;Pium;2010;6694;3779;2915
1717800;Ponte Alta do Bom Jesus;2010;4544;2501;2043
1717909;Ponte Alta do Tocantins;2010;7180;4527;2653
1718006;Porto Alegre do Tocantins;2010;2796;1919;877
1718204;Porto Nacional;2010;49146;42435;6711
1718303;Praia Norte;2010;7659;4468;3191
1718402;Presidente Kennedy;2010;3681;3227;454
1718451;Pugmil;2010;2369;2004;365
1718501;Recursolândia;2010;3768;1990;1778
1718550;Riachinho;2010;4191;1812;2379
1718659;Rio da Conceição;2010;1714;1574;140
1718709;Rio dos Bois;2010;2570;1029;1541
1718758;Rio Sono;2010;6254;2407;3847
1718808;Sampaio;2010;3864;3516;348
1718840;Sandolândia;2010;3326;1764;1562
1718865;Santa Fé do Araguaia;2010;6599;4374;2225
1718881;Santa Maria do Tocantins;2010;2894;1725;1169
1718899;Santa Rita do Tocantins;2010;2128;918;1210
1718907;Santa Rosa do Tocantins;2010;4568;2947;1621
1719004;Santa Tereza do Tocantins;2010;2523;1616;907
1720002;Santa Terezinha do Tocantins;2010;2474;1594;880
1720101;São Bento do Tocantins;2010;4608;2716;1892
1720150;São Félix do Tocantins;2010;1437;931;506
1720200;São Miguel do Tocantins;2010;10481;2547;7934
1720259;São Salvador do Tocantins;2010;2910;1607;1303
1720309;São Sebastião do Tocantins;2010;4283;3283;1000
1720499;São Valério;2010;4383;2723;1660
1720655;Silvanópolis;2010;5068;4061;1007
1720804;Sítio Novo do Tocantins;2010;9148;4875;4273
1720853;Sucupira;2010;1742;1106;636
1720903;Taguatinga;2010;15051;10627;4424
1720937;Taipas do Tocantins;2010;1945;1557;388
1720978;Talismã;2010;2562;1363;1199
1721000;Palmas;2010;228332;221742;6590
1721109;Tocantínia;2010;6736;2955;3781
1721208;Tocantinópolis;2010;22619;18318;4301
1721257;Tupirama;2010;1574;930;644
1721307;Tupiratins;2010;2097;1065;1032
1722081;Wanderlândia;2010;10981;5868;5113
1722107;Xambioá;2010;11484;9738;1746
2100055;Açailândia;2010;104047;78237;25810
2100105;Afonso Cunha;2010;5905;3234;2671
2100154;Água Doce do Maranhão;2010;11581;3133;8448
2100204;Alcântara;2010;21851;6399;15452
2100303;Aldeias Altas;2010;23952;13634;10318
2100402;Altamira do Maranhão;2010;11063;4583;6480
2100436;Alto Alegre do Maranhão;2010;24599;19374;5225
2100477;Alto Alegre do Pindaré;2010;31057;9829;21228
2100501;Alto Parnaíba;2010;10766;7028;3738
2100550;Amapá do Maranhão;2010;6431;4841;1590
2100600;Amarante do Maranhão;2010;37932;15308;22624
2100709;Anajatuba;2010;25291;7015;18276
2100808;Anapurus;2010;13939;7164;6775
2100832;Apicum-Açu;2010;14959;9162;5797
2100873;Araguanã;2010;13973;5377;8596
2100907;Araioses;2010;42505;12045;30460
2100956;Arame;2010;31702;12551;19151
2101004;Arari;2010;28488;17483;11005
2101103;Axixá;2010;11407;4703;6704
2101202;Bacabal;2010;100014;77860;22154
2101251;Bacabeira;2010;14925;3324;11601
2101301;Bacuri;2010;16604;8686;7918
2101350;Bacurituba;2010;5293;1424;3869
2101400;Balsas;2010;83528;72771;10757
2101509;Barão de Grajaú;2010;17841;10338;7503
2101608;Barra do Corda;2010;82830;51648;31182
2101707;Barreirinhas;2010;54930;22326;32604
2101731;Belágua;2010;6524;3263;3261
2101772;Bela Vista do Maranhão;2010;12049;5170;6879
2101806;Benedito Leite;2010;5469;2813;2656
2101905;Bequimão;2010;20344;6606;13738
2101939;Bernardo do Mearim;2010;5996;2324;3672
2101970;Boa Vista do Gurupi;2010;7949;5619;2330
2102002;Bom Jardim;2010;39049;16386;22663
2102036;Bom Jesus das Selvas;2010;28459;13431;15028
2102077;Bom Lugar;2010;14818;4181;10637
2102101;Brejo;2010;33359;12340;21019
2102150;Brejo de Areia;2010;5577;2853;2724
2102200;Buriti;2010;27013;8399;18614
2102309;Buriti Bravo;2010;22899;17014;5885
2102325;Buriticupu;2010;65237;35789;29448
2102358;Buritirana;2010;14784;4146;10638
2102374;Cachoeira Grande;2010;8446;3792;4654
2102408;Cajapió;2010;10593;3885;6708
2102507;Cajari;2010;18338;4284;14054
2102556;Campestre do Maranhão;2010;13369;10621;2748
2102606;Cândido Mendes;2010;18505;11911;6594
2102705;Cantanhede;2010;20448;12959;7489
2102754;Capinzal do Norte;2010;10698;5610;5088
2102804;Carolina;2010;23959;16237;7722
2102903;Carutapera;2010;22006;16224;5782
2103000;Caxias;2010;155129;118534;36595
2103109;Cedral;2010;10297;2397;7900
2103125;Central do Maranhão;2010;7887;4086;3801
2103158;Centro do Guilherme;2010;12565;7072;5493
2103174;Centro Novo do Maranhão;2010;17622;5522;12100
2103208;Chapadinha;2010;73350;52882;20468
2103257;Cidelândia;2010;13681;6036;7645
2103307;Codó;2010;118038;81045;36993
2103406;Coelho Neto;2010;46750;38729;8021
2103505;Colinas;2010;39132;25575;13557
2103554;Conceição do Lago-Açu;2010;14436;6869;7567
2103604;Coroatá;2010;61725;43057;18668
2103703;Cururupu;2010;32652;22270;10382
2103752;Davinópolis;2010;12579;10487;2092
2103802;Dom Pedro;2010;22681;15261;7420
2103901;Duque Bacelar;2010;10649;5340;5309
2104008;Esperantinópolis;2010;18452;10035;8417
2104057;Estreito;2010;35835;25778;10057
2104073;Feira Nova do Maranhão;2010;8126;1927;6199
2104081;Fernando Falcão;2010;9241;1506;7735
2104099;Formosa da Serra Negra;2010;17757;5915;11842
2104107;Fortaleza dos Nogueiras;2010;11646;7019;4627
2104206;Fortuna;2010;15098;9504;5594
2104305;Godofredo Viana;2010;10635;6723;3912
2104404;Gonçalves Dias;2010;17482;7770;9712
2104503;Governador Archer;2010;10205;6630;3575
2104552;Governador Edison Lobão;2010;15895;6957;8938
2104602;Governador Eugênio Barros;2010;15991;4690;11301
2104628;Governador Luiz Rocha;2010;7337;5187;2150
2104651;Governador Newton Bello;2010;11921;4291;7630
2104677;Governador Nunes Freire;2010;25401;15945;9456
2104701;Graça Aranha;2010;6140;2912;3228
2104800;Grajaú;2010;62093;37041;25052
2104909;Guimarães;2010;12081;6909;5172
2105005;Humberto de Campos;2010;26189;10506;15683
2105104;Icatu;2010;25145;7816;17329
2105153;Igarapé do Meio;2010;12550;6207;6343
2105203;Igarapé Grande;2010;11041;6664;4377
2105302;Imperatriz;2010;247505;234547;12958
2105351;Itaipava do Grajaú;2010;14297;4296;10001
2105401;Itapecuru Mirim;2010;62110;34668;27442
2105427;Itinga do Maranhão;2010;24863;17640;7223
2105450;Jatobá;2010;8526;3740;4786
2105476;Jenipapo dos Vieiras;2010;15440;2519;12921
2105500;João Lisboa;2010;20381;15336;5045
2105609;Joselândia;2010;15433;5960;9473
2105658;Junco do Maranhão;2010;4020;2819;1201
2105708;Lago da Pedra;2010;46083;30046;16037
2105807;Lago do Junco;2010;10729;3913;6816
2105906;Lago Verde;2010;15412;5052;10360
2105922;Lagoa do Mato;2010;10934;4453;6481
2105948;Lago dos Rodrigues;2010;7794;4849;2945
2105963;Lagoa Grande do Maranhão;2010;10517;5499;5018
2105989;Lajeado Novo;2010;6923;3194;3729
2106003;Lima Campos;2010;11423;6793;4630
2106102;Loreto;2010;11390;6360;5030
2106201;Luís Domingues;2010;6510;5503;1007
2106300;Magalhães de Almeida;2010;17587;8963;8624
2106326;Maracaçumé;2010;19155;15829;3326
2106359;Marajá do Sena;2010;8051;1158;6893
2106375;Maranhãozinho;2010;14065;9020;5045
2106409;Mata Roma;2010;15150;7132;8018
2106508;Matinha;2010;21885;8883;13002
2106607;Matões;2010;31015;13635;17380
2106631;Matões do Norte;2010;13794;4679;9115
2106672;Milagres do Maranhão;2010;8118;1760;6358
2106706;Mirador;2010;20452;9373;11079
2106755;Miranda do Norte;2010;24427;19519;4908
2106805;Mirinzal;2010;14218;9031;5187
2106904;Monção;2010;31738;11759;19979
2107001;Montes Altos;2010;9413;5126;4287
2107100;Morros;2010;17783;6720;11063
2107209;Nina Rodrigues;2010;12464;4439;8025
2107258;Nova Colinas;2010;4885;2210;2675
2107308;Nova Iorque;2010;4590;2876;1714
2107357;Nova Olinda do Maranhão;2010;19134;11862;7272
2107407;Olho d'Água das Cunhãs;2010;18601;9592;9009
2107456;Olinda Nova do Maranhão;2010;13181;5981;7200
2107506;Paço do Lumiar;2010;105121;78811;26310
2107605;Palmeirândia;2010;18764;3459;15305
2107704;Paraibano;2010;20103;15746;4357
2107803;Parnarama;2010;34586;13530;21056
2107902;Passagem Franca;2010;17562;10464;7098
2108009;Pastos Bons;2010;18067;12307;5760
2108058;Paulino Neves;2010;14519;4654;9865
2108108;Paulo Ramos;2010;20079;10825;9254
2108207;Pedreiras;2010;39448;32937;6511
2108256;Pedro do Rosário;2010;22732;5890;16842
2108306;Penalva;2010;34267;16593;17674
2108405;Peri Mirim;2010;13803;3668;10135
2108454;Peritoró;2010;21201;7752;13449
2108504;Pindaré-Mirim;2010;31152;22417;8735
2108603;Pinheiro;2010;78162;46509;31653
2108702;Pio XII;2010;22016;12459;9557
2108801;Pirapemas;2010;17381;11039;6342
2108900;Poção de Pedras;2010;19708;8378;11330
2109007;Porto Franco;2010;21530;16866;4664
2109056;Porto Rico do Maranhão;2010;6030;2411;3619
2109106;Presidente Dutra;2010;44731;32000;12731
2109205;Presidente Juscelino;2010;11541;4120;7421
2109239;Presidente Médici;2010;6374;3904;2470
2109270;Presidente Sarney;2010;17165;4288;12877
2109304;Presidente Vargas;2010;10717;4581;6136
2109403;Primeira Cruz;2010;13954;4289;9665
2109452;Raposa;2010;26327;16675;9652
2109502;Riachão;2010;20209;10205;10004
2109551;Ribamar Fiquene;2010;7318;3677;3641
2109601;Rosário;2010;39576;23252;16324
2109700;Sambaíba;2010;5487;2836;2651
2109759;Santa Filomena do Maranhão;2010;7061;2293;4768
2109809;Santa Helena;2010;39110;19578;19532
2109908;Santa Inês;2010;77282;73197;4085
2110005;Santa Luzia;2010;74043;25789;48254
2110039;Santa Luzia do Paruá;2010;22644;12591;10053
2110104;Santa Quitéria do Maranhão;2010;29191;14141;15050
2110203;Santa Rita;2010;32366;14915;17451
2110237;Santana do Maranhão;2010;11661;1842;9819
2110278;Santo Amaro do Maranhão;2010;13820;3630;10190
2110302;Santo Antônio dos Lopes;2010;14288;5732;8556
2110401;São Benedito do Rio Preto;2010;17799;11049;6750
2110500;São Bento;2010;40736;23508;17228
2110609;São Bernardo;2010;26476;11800;14676
2110658;São Domingos do Azeitão;2010;6983;4961;2022
2110708;São Domingos do Maranhão;2010;33607;17313;16294
2110807;São Félix de Balsas;2010;4702;1628;3074
2110856;São Francisco do Brejão;2010;10261;4836;5425
2110906;São Francisco do Maranhão;2010;12146;4104;8042
2111003;São João Batista;2010;19920;5344;14576
2111029;São João do Carú;2010;12309;6323;5986
2111052;São João do Paraíso;2010;10814;5276;5538
2111078;São João do Soter;2010;17238;6646;10592
2111102;São João dos Patos;2010;24928;20567;4361
2111201;São José de Ribamar;2010;163045;37709;125336
2111250;São José dos Basílios;2010;7496;3006;4490
2111300;São Luís;2010;1014837;958545;56292
2111409;São Luís Gonzaga do Maranhão;2010;20153;7896;12257
2111508;São Mateus do Maranhão;2010;39093;28712;10381
2111532;São Pedro da Água Branca;2010;12028;10712;1316
2111573;São Pedro dos Crentes;2010;4425;2437;1988
2111607;São Raimundo das Mangabeiras;2010;17474;12533;4941
2111631;São Raimundo do Doca Bezerra;2010;6090;1731;4359
2111672;São Roberto;2010;5957;2845;3112
2111706;São Vicente Ferrer;2010;20863;5431;15432
2111722;Satubinha;2010;11990;3634;8356
2111748;Senador Alexandre Costa;2010;10256;6164;4092
2111763;Senador La Rocque;2010;17998;8739;9259
2111789;Serrano do Maranhão;2010;10940;4227;6713
2111805;Sítio Novo;2010;17002;5139;11863
2111904;Sucupira do Norte;2010;10444;4944;5500
2111953;Sucupira do Riachão;2010;4613;2862;1751
2112001;Tasso Fragoso;2010;7796;4648;3148
2112100;Timbiras;2010;27997;17471;10526
2112209;Timon;2010;155460;135133;20327
2112233;Trizidela do Vale;2010;18953;16170;2783
2112274;Tufilândia;2010;5596;2732;2864
2112308;Tuntum;2010;39183;17927;21256
2112407;Turiaçu;2010;33933;10931;23002
2112456;Turilândia;2010;22846;10353;12493
2112506;Tutóia;2010;52788;18680;34108
2112605;Urbano Santos;2010;24573;17374;7199
2112704;Vargem Grande;2010;49412;26687;22725
2112803;Viana;2010;49496;26915;22581
2112852;Vila Nova dos Martírios;2010;11258;6188;5070
2112902;Vitória do Mearim;2010;31217;14811;16406
2113009;Vitorino Freire;2010;31658;16176;15482
2114007;Zé Doca;2010;50173;30864;19309
2200053;Acauã;2010;6749;901;5848
2200103;Agricolândia;2010;5098;3602;1496
2200202;Água Branca;2010;16451;14539;1912
2200251;Alagoinha do Piauí;2010;7341;2669;4672
2200277;Alegrete do Piauí;2010;5153;2837;2316
2200301;Alto Longá;2010;13646;6714;6932
2200400;Altos;2010;38822;27388;11434
2200459;Alvorada do Gurguéia;2010;5050;1849;3201
2200509;Amarante;2010;17135;8772;8363
2200608;Angical do Piauí;2010;6672;5214;1458
2200707;Anísio de Abreu;2010;9098;4503;4595
2200806;Antônio Almeida;2010;3039;2224;815
2200905;Aroazes;2010;5779;3430;2349
2200954;Aroeiras do Itaim;2010;2440;238;2202
2201002;Arraial;2010;4688;2433;2255
2201051;Assunção do Piauí;2010;7503;3378;4125
2201101;Avelino Lopes;2010;11067;6714;4353
2201150;Baixa Grande do Ribeiro;2010;10516;6487;4029
2201176;Barra D'Alcântara;2010;3852;2032;1820
2201200;Barras;2010;44850;22126;22724
2201309;Barreiras do Piauí;2010;3234;1875;1359
2201408;Barro Duro;2010;6607;4789;1818
2201507;Batalha;2010;25774;9607;16167
2201556;Bela Vista do Piauí;2010;3778;1243;2535
2201572;Belém do Piauí;2010;3284;1603;1681
2201606;Beneditinos;2010;9911;6261;3650
2201705;Bertolínia;2010;5319;3894;1425
2201739;Betânia do Piauí;2010;6015;1678;4337
2201770;Boa Hora;2010;6296;1524;4772
2201804;Bocaina;2010;4369;1746;2623
2201903;Bom Jesus;2010;22629;17623;5006
2201919;Bom Princípio do Piauí;2010;5304;1654;3650
2201929;Bonfim do Piauí;2010;5393;1635;3758
2201945;Boqueirão do Piauí;2010;6193;2666;3527
2201960;Brasileira;2010;7966;3483;4483
2201988;Brejo do Piauí;2010;3850;1426;2424
2202000;Buriti dos Lopes;2010;19074;10294;8780
2202026;Buriti dos Montes;2010;7974;2421;5553
2202059;Cabeceiras do Piauí;2010;9928;1657;8271
2202075;Cajazeiras do Piauí;2010;3343;1112;2231
2202083;Cajueiro da Praia;2010;7163;2779;4384
2202091;Caldeirão Grande do Piauí;2010;5671;1662;4009
2202109;Campinas do Piauí;2010;5408;1807;3601
2202117;Campo Alegre do Fidalgo;2010;4693;1224;3469
2202133;Campo Grande do Piauí;2010;5592;1569;4023
2202174;Campo Largo do Piauí;2010;6803;1430;5373
2202208;Campo Maior;2010;45177;33521;11656
2202251;Canavieira;2010;3921;1738;2183
2202307;Canto do Buriti;2010;20020;11130;8890
2202406;Capitão de Campos;2010;10953;6347;4606
2202455;Capitão Gervásio Oliveira;2010;3878;1162;2716
2202505;Caracol;2010;10212;4028;6184
2202539;Caraúbas do Piauí;2010;5525;972;4553
2202554;Caridade do Piauí;2010;4826;1579;3247
2202604;Castelo do Piauí;2010;18336;11479;6857
2202653;Caxingó;2010;5039;966;4073
2202703;Cocal;2010;26036;12020;14016
2202711;Cocal de Telha;2010;4525;2667;1858
2202729;Cocal dos Alves;2010;5572;1782;3790
2202737;Coivaras;2010;3811;1173;2638
2202752;Colônia do Gurguéia;2010;6036;4850;1186
2202778;Colônia do Piauí;2010;7433;2644;4789
2202802;Conceição do Canindé;2010;4475;2363;2112
2202851;Coronel José Dias;2010;4541;1491;3050
2202901;Corrente;2010;25407;15693;9714
2203008;Cristalândia do Piauí;2010;7831;2945;4886
2203107;Cristino Castro;2010;9981;7262;2719
2203206;Curimatá;2010;10761;7084;3677
2203230;Currais;2010;4704;924;3780
2203255;Curralinhos;2010;4183;1331;2852
2203271;Curral Novo do Piauí;2010;4869;1379;3490
2203305;Demerval Lobão;2010;13278;10873;2405
2203354;Dirceu Arcoverde;2010;6675;2369;4306
2203404;Dom Expedito Lopes;2010;6569;3572;2997
2203420;Domingos Mourão;2010;4264;958;3306
2203453;Dom Inocêncio;2010;9245;2018;7227
2203503;Elesbão Veloso;2010;14512;10124;4388
2203602;Eliseu Martins;2010;4665;3821;844
2203701;Esperantina;2010;37767;23158;14609
2203750;Fartura do Piauí;2010;5074;1369;3705
2203800;Flores do Piauí;2010;4366;1987;2379
2203859;Floresta do Piauí;2010;2482;861;1621
2203909;Floriano;2010;57690;49970;7720
2204006;Francinópolis;2010;5235;3275;1960
2204105;Francisco Ayres;2010;4477;2154;2323
2204154;Francisco Macedo;2010;2879;1159;1720
2204204;Francisco Santos;2010;8592;3979;4613
2204303;Fronteiras;2010;11117;7288;3829
2204352;Geminiano;2010;5475;1216;4259
2204402;Gilbués;2010;10402;5991;4411
2204501;Guadalupe;2010;10268;9842;426
2204550;Guaribas;2010;4401;1275;3126
2204600;Hugo Napoleão;2010;3771;3098;673
2204659;Ilha Grande;2010;8914;7445;1469
2204709;Inhuma;2010;14845;7279;7566
2204808;Ipiranga do Piauí;2010;9327;5746;3581
2204907;Isaías Coelho;2010;8221;1865;6356
2205003;Itainópolis;2010;11109;2530;8579
2205102;Itaueira;2010;10678;5949;4729
2205151;Jacobina do Piauí;2010;5722;1024;4698
2205201;Jaicós;2010;18035;8508;9527
2205250;Jardim do Mulato;2010;4309;1183;3126
2205276;Jatobá do Piauí;2010;4656;888;3768
2205300;Jerumenha;2010;4390;2469;1921
2205359;João Costa;2010;2960;701;2259
2205409;Joaquim Pires;2010;13817;4256;9561
2205458;Joca Marques;2010;5100;1677;3423
2205508;José de Freitas;2010;37085;21601;15484
2205516;Juazeiro do Piauí;2010;4757;1479;3278
2205524;Júlio Borges;2010;5373;1618;3755
2205532;Jurema;2010;4517;866;3651
2205540;Lagoinha do Piauí;2010;2656;1582;1074
2205557;Lagoa Alegre;2010;8008;3042;4966
2205565;Lagoa do Barro do Piauí;2010;4523;994;3529
2205573;Lagoa de São Francisco;2010;6422;2092;4330
2205581;Lagoa do Piauí;2010;3863;1672;2191
2205599;Lagoa do Sítio;2010;4850;1723;3127
2205607;Landri Sales;2010;5281;3957;1324
2205706;Luís Correia;2010;28406;12645;15761
2205805;Luzilândia;2010;24721;13268;11453
2205854;Madeiro;2010;7816;3364;4452
2205904;Manoel Emídio;2010;5213;3315;1898
2205953;Marcolândia;2010;7812;6707;1105
2206001;Marcos Parente;2010;4456;3845;611
2206050;Massapê do Piauí;2010;6220;936;5284
2206100;Matias Olímpio;2010;10473;4796;5677
2206209;Miguel Alves;2010;32289;10711;21578
2206308;Miguel Leão;2010;1253;862;391
2206357;Milton Brandão;2010;6769;1701;5068
2206407;Monsenhor Gil;2010;10333;5309;5024
2206506;Monsenhor Hipólito;2010;7391;3485;3906
2206605;Monte Alegre do Piauí;2010;10345;2981;7364
2206654;Morro Cabeça no Tempo;2010;4068;1404;2664
2206670;Morro do Chapéu do Piauí;2010;6499;2298;4201
2206696;Murici dos Portelas;2010;8464;1689;6775
2206704;Nazaré do Piauí;2010;7321;3503;3818
2206720;Nazária;2010;8068;1652;6416
2206753;Nossa Senhora de Nazaré;2010;4556;1363;3193
2206803;Nossa Senhora dos Remédios;2010;8206;3693;4513
2206902;Novo Oriente do Piauí;2010;6498;3280;3218
2206951;Novo Santo Antônio;2010;3260;916;2344
2207009;Oeiras;2010;35640;21997;13643
2207108;Olho D'Água do Piauí;2010;2626;1064;1562
2207207;Padre Marcos;2010;6657;2352;4305
2207306;Paes Landim;2010;4059;2376;1683
2207355;Pajeú do Piauí;2010;3363;1426;1937
2207405;Palmeira do Piauí;2010;4993;1764;3229
2207504;Palmeirais;2010;13745;5342;8403
2207553;Paquetá;2010;4147;557;3590
2207603;Parnaguá;2010;10276;5339;4937
2207702;Parnaíba;2010;145705;137485;8220
2207751;Passagem Franca do Piauí;2010;4546;2482;2064
2207777;Patos do Piauí;2010;6105;1689;4416
2207793;Pau D'Arco do Piauí;2010;3757;556;3201
2207801;Paulistana;2010;19785;10656;9129
2207850;Pavussu;2010;3663;1793;1870
2207900;Pedro II;2010;37496;22666;14830
2207934;Pedro Laurentino;2010;2407;819;1588
2207959;Nova Santa Rita;2010;4187;704;3483
2208007;Picos;2010;73414;58307;15107
2208106;Pimenteiras;2010;11733;4795;6938
2208205;Pio IX;2010;17671;5291;12380
2208304;Piracuruca;2010;27553;19247;8306
2208403;Piripiri;2010;61834;44540;17294
2208502;Porto;2010;11897;7503;4394
2208551;Porto Alegre do Piauí;2010;2559;1802;757
2208601;Prata do Piauí;2010;3085;2552;533
2208650;Queimada Nova;2010;8553;1156;7397
2208700;Redenção do Gurguéia;2010;8400;5335;3065
2208809;Regeneração;2010;17556;13805;3751
2208858;Riacho Frio;2010;4241;2222;2019
2208874;Ribeira do Piauí;2010;4263;1030;3233
2208908;Ribeiro Gonçalves;2010;6845;4449;2396
2209005;Rio Grande do Piauí;2010;6273;4094;2179
2209104;Santa Cruz do Piauí;2010;6027;4067;1960
2209153;Santa Cruz dos Milagres;2010;3794;2127;1667
2209203;Santa Filomena;2010;6096;3544;2552
2209302;Santa Luz;2010;5513;3109;2404
2209351;Santana do Piauí;2010;4917;1939;2978
2209377;Santa Rosa do Piauí;2010;5149;3655;1494
2209401;Santo Antônio de Lisboa;2010;6007;3920;2087
2209450;Santo Antônio dos Milagres;2010;2059;807;1252
2209500;Santo Inácio do Piauí;2010;3648;2297;1351
2209559;São Braz do Piauí;2010;4313;1021;3292
2209609;São Félix do Piauí;2010;3069;1641;1428
2209658;São Francisco de Assis do Piauí;2010;5567;1429;4138
2209708;São Francisco do Piauí;2010;6298;1983;4315
2209757;São Gonçalo do Gurguéia;2010;2825;1219;1606
2209807;São Gonçalo do Piauí;2010;4754;3308;1446
2209856;São João da Canabrava;2010;4445;1233;3212
2209872;São João da Fronteira;2010;5608;2272;3336
2209906;São João da Serra;2010;6157;3447;2710
2209955;São João da Varjota;2010;4651;1389;3262
2209971;São João do Arraial;2010;7336;3701;3635
2210003;São João do Piauí;2010;19548;13470;6078
2210052;São José do Divino;2010;5148;2710;2438
2210102;São José do Peixe;2010;3700;1889;1811
2210201;São José do Piauí;2010;6591;1929;4662
2210300;São Julião;2010;5675;2328;3347
2210359;São Lourenço do Piauí;2010;4427;1113;3314
2210375;São Luis do Piauí;2010;2561;814;1747
2210383;São Miguel da Baixa Grande;2010;2110;1358;752
2210391;São Miguel do Fidalgo;2010;2976;1085;1891
2210409;São Miguel do Tapuio;2010;18134;6675;11459
2210508;São Pedro do Piauí;2010;13639;8195;5444
2210607;São Raimundo Nonato;2010;32327;21266;11061
2210623;Sebastião Barros;2010;3560;1112;2448
2210631;Sebastião Leal;2010;4116;1922;2194
2210656;Sigefredo Pacheco;2010;9619;3176;6443
2210706;Simões;2010;14180;5689;8491
2210805;Simplício Mendes;2010;12077;7163;4914
2210904;Socorro do Piauí;2010;4522;1630;2892
2210938;Sussuapara;2010;6229;1582;4647
2210953;Tamboril do Piauí;2010;2753;1512;1241
2210979;Tanque do Piauí;2010;2620;1239;1381
2211001;Teresina;2010;814230;767559;46671
2211100;União;2010;42654;20965;21689
2211209;Uruçuí;2010;20149;15505;4644
2211308;Valença do Piauí;2010;20326;15798;4528
2211357;Várzea Branca;2010;4913;1147;3766
2211407;Várzea Grande;2010;4336;2581;1755
2211506;Vera Mendes;2010;2986;966;2020
2211605;Vila Nova do Piauí;2010;3076;759;2317
2211704;Wall Ferraz;2010;4280;1166;3114
2300101;Abaiara;2010;10496;4552;5944
2300150;Acarape;2010;15338;7982;7356
2300200;Acaraú;2010;57551;28242;29309
2300309;Acopiara;2010;51160;25228;25932
2300408;Aiuaba;2010;16203;3951;12252
2300507;Alcântaras;2010;10771;3448;7323
2300606;Altaneira;2010;6856;4957;1899
2300705;Alto Santo;2010;16359;8041;8318
2300754;Amontada;2010;39232;15947;23285
2300804;Antonina do Norte;2010;6984;4999;1985
2300903;Apuiarés;2010;13925;5772;8153
2301000;Aquiraz;2010;72628;67083;5545
2301109;Aracati;2010;69159;44035;25124
2301208;Aracoiaba;2010;25391;13737;11654
2301257;Ararendá;2010;10491;4906;5585
2301307;Araripe;2010;20685;12733;7952
2301406;Aratuba;2010;11529;3769;7760
2301505;Arneiroz;2010;7650;3879;3771
2301604;Assaré;2010;22445;11952;10493
2301703;Aurora;2010;24566;11825;12741
2301802;Baixio;2010;6026;3304;2722
2301851;Banabuiú;2010;17315;8753;8562
2301901;Barbalha;2010;55323;38022;17301
2301950;Barreira;2010;19573;8127;11446
2302008;Barro;2010;21514;13160;8354
2302057;Barroquinha;2010;14476;9770;4706
2302107;Baturité;2010;33321;24437;8884
2302206;Beberibe;2010;49311;21611;27700
2302305;Bela Cruz;2010;30878;12997;17881
2302404;Boa Viagem;2010;52498;26604;25894
2302503;Brejo Santo;2010;45193;28055;17138
2302602;Camocim;2010;60158;44657;15501
2302701;Campos Sales;2010;26506;19081;7425
2302800;Canindé;2010;74473;46875;27598
2302909;Capistrano;2010;17062;6212;10850
2303006;Caridade;2010;20020;11523;8497
2303105;Cariré;2010;18347;8301;10046
2303204;Caririaçu;2010;26393;14031;12362
2303303;Cariús;2010;18567;8310;10257
2303402;Carnaubal;2010;16746;7960;8786
2303501;Cascavel;2010;66142;56157;9985
2303600;Catarina;2010;18745;8728;10017
2303659;Catunda;2010;9952;5395;4557
2303709;Caucaia;2010;325441;290220;35221
2303808;Cedro;2010;24527;15159;9368
2303907;Chaval;2010;12615;9168;3447
2303931;Choró;2010;12853;3794;9059
2303956;Chorozinho;2010;18915;11426;7489
2304004;Coreaú;2010;21954;14223;7731
2304103;Crateús;2010;72812;52644;20168
2304202;Crato;2010;121428;100916;20512
2304236;Croatá;2010;17069;9038;8031
2304251;Cruz;2010;22479;9569;12910
2304269;Deputado Irapuan Pinheiro;2010;9095;4133;4962
2304277;Ererê;2010;6840;3458;3382
2304285;Eusébio;2010;46033;46033;0
2304301;Farias Brito;2010;19007;8871;10136
2304350;Forquilha;2010;21786;15473;6313
2304400;Fortaleza;2010;2452185;2452185;0
2304459;Fortim;2010;14817;9608;5209
2304509;Frecheirinha;2010;12991;7636;5355
2304608;General Sampaio;2010;6218;3648;2570
2304657;Graça;2010;15049;5815;9234
2304707;Granja;2010;52645;25892;26753
2304806;Granjeiro;2010;4629;1370;3259
2304905;Groaíras;2010;10228;7076;3152
2304954;Guaiúba;2010;24091;18877;5214
2305001;Guaraciaba do Norte;2010;37775;17403;20372
2305100;Guaramiranga;2010;4164;2495;1669
2305209;Hidrolândia;2010;19325;11054;8271
2305233;Horizonte;2010;55187;51049;4138
2305266;Ibaretama;2010;12922;4447;8475
2305308;Ibiapina;2010;23808;10743;13065
2305332;Ibicuitinga;2010;11335;5742;5593
2305357;Icapuí;2010;18392;5787;12605
2305407;Icó;2010;65456;30463;34993
2305506;Iguatu;2010;96495;74627;21868
2305605;Independência;2010;25573;11473;14100
2305654;Ipaporanga;2010;11343;4136;7207
2305704;Ipaumirim;2010;12009;7133;4876
2305803;Ipu;2010;40296;25581;14715
2305902;Ipueiras;2010;37862;18358;19504
2306009;Iracema;2010;13722;9819;3903
2306108;Irauçuba;2010;22324;14343;7981
2306207;Itaiçaba;2010;7316;4279;3037
2306256;Itaitinga;2010;35817;35565;252
2306306;Itapajé;2010;48350;33990;14360
2306405;Itapipoca;2010;116065;66909;49156
2306504;Itapiúna;2010;18626;8819;9807
2306553;Itarema;2010;37471;15938;21533
2306603;Itatira;2010;18894;9522;9372
2306702;Jaguaretama;2010;17863;8469;9394
2306801;Jaguaribara;2010;10399;7212;3187
2306900;Jaguaribe;2010;34409;23268;11141
2307007;Jaguaruana;2010;32236;19135;13101
2307106;Jardim;2010;26688;8994;17694
2307205;Jati;2010;7660;4489;3171
2307254;Jijoca de Jericoacoara;2010;17002;5556;11446
2307304;Juazeiro do Norte;2010;249939;240128;9811
2307403;Jucás;2010;23807;14150;9657
2307502;Lavras da Mangabeira;2010;31090;18132;12958
2307601;Limoeiro do Norte;2010;56264;32483;23781
2307635;Madalena;2010;18088;8915;9173
2307650;Maracanaú;2010;209057;207635;1422
2307700;Maranguape;2010;113561;86309;27252
2307809;Marco;2010;24703;15435;9268
2307908;Martinópole;2010;10214;8007;2207
2308005;Massapê;2010;35191;23983;11208
2308104;Mauriti;2010;44240;23285;20955
2308203;Meruoca;2010;13693;7420;6273
2308302;Milagres;2010;28316;13556;14760
2308351;Milhã;2010;13086;5969;7117
2308377;Miraíma;2010;12800;6847;5953
2308401;Missão Velha;2010;34274;15419;18855
2308500;Mombaça;2010;42690;18816;23874
2308609;Monsenhor Tabosa;2010;16705;9362;7343
2308708;Morada Nova;2010;62065;35401;26664
2308807;Moraújo;2010;8070;3604;4466
2308906;Morrinhos;2010;20700;9612;11088
2309003;Mucambo;2010;14102;9066;5036
2309102;Mulungu;2010;11485;4198;7287
2309201;Nova Olinda;2010;14256;9696;4560
2309300;Nova Russas;2010;30965;23244;7721
2309409;Novo Oriente;2010;27453;14230;13223
2309458;Ocara;2010;24007;7605;16402
2309508;Orós;2010;21389;16023;5366
2309607;Pacajus;2010;61838;50675;11163
2309706;Pacatuba;2010;72299;62095;10204
2309805;Pacoti;2010;11607;4745;6862
2309904;Pacujá;2010;5986;3723;2263
2310001;Palhano;2010;8866;4515;4351
2310100;Palmácia;2010;12005;4957;7048
2310209;Paracuru;2010;31636;20054;11582
2310258;Paraipaba;2010;30041;13435;16606
2310308;Parambu;2010;31309;14106;17203
2310407;Paramoti;2010;11308;5540;5768
2310506;Pedra Branca;2010;41890;24510;17380
2310605;Penaforte;2010;8226;6399;1827
2310704;Pentecoste;2010;35400;21394;14006
2310803;Pereiro;2010;15757;5433;10324
2310852;Pindoretama;2010;18683;11280;7403
2310902;Piquet Carneiro;2010;15467;7440;8027
2310951;Pires Ferreira;2010;10216;3354;6862
2311009;Poranga;2010;12001;7798;4203
2311108;Porteiras;2010;15061;6189;8872
2311207;Potengi;2010;10276;5714;4562
2311231;Potiretama;2010;6126;2703;3423
2311264;Quiterianópolis;2010;19921;6305;13616
2311306;Quixadá;2010;80604;57485;23119
2311355;Quixelô;2010;15000;4929;10071
2311405;Quixeramobim;2010;71887;43424;28463
2311504;Quixeré;2010;19412;11930;7482
2311603;Redenção;2010;26415;15134;11281
2311702;Reriutaba;2010;19455;10590;8865
2311801;Russas;2010;69833;44952;24881
2311900;Saboeiro;2010;15752;8455;7297
2311959;Salitre;2010;15453;6263;9190
2312007;Santana do Acaraú;2010;29946;15372;14574
2312106;Santana do Cariri;2010;17170;8822;8348
2312205;Santa Quitéria;2010;42763;22260;20503
2312304;São Benedito;2010;44178;24554;19624
2312403;São Gonçalo do Amarante;2010;43890;28537;15353
2312502;São João do Jaguaribe;2010;7900;3169;4731
2312601;São Luís do Curu;2010;12332;7961;4371
2312700;Senador Pompeu;2010;26469;15706;10763
2312809;Senador Sá;2010;6852;5068;1784
2312908;Sobral;2010;188233;166310;21923
2313005;Solonópole;2010;17665;9106;8559
2313104;Tabuleiro do Norte;2010;29204;18806;10398
2313203;Tamboril;2010;25451;14202;11249
2313252;Tarrafas;2010;8910;2624;6286
2313302;Tauá;2010;55716;32259;23457
2313351;Tejuçuoca;2010;16827;6335;10492
2313401;Tianguá;2010;68892;45819;23073
2313500;Trairi;2010;51422;18784;32638
2313559;Tururu;2010;14408;5288;9120
2313609;Ubajara;2010;31787;15350;16437
2313708;Umari;2010;7545;3918;3627
2313757;Umirim;2010;18802;11091;7711
2313807;Uruburetama;2010;19765;14689;5076
2313906;Uruoca;2010;12883;7671;5212
2313955;Varjota;2010;17593;14416;3177
2314003;Várzea Alegre;2010;38434;23896;14538
2314102;Viçosa do Ceará;2010;54955;17827;37128
2400109;Acari;2010;11035;8902;2133
2400208;Açu;2010;53227;39359;13868
2400307;Afonso Bezerra;2010;10844;5759;5085
2400406;Água Nova;2010;2980;1908;1072
2400505;Alexandria;2010;13507;9189;4318
2400604;Almino Afonso;2010;4871;3479;1392
2400703;Alto do Rodrigues;2010;12305;8873;3432
2400802;Angicos;2010;11549;10085;1464
2400901;Antônio Martins;2010;6907;3784;3123
2401008;Apodi;2010;34763;17531;17232
2401107;Areia Branca;2010;25315;20317;4998
2401206;Arês;2010;12924;8069;4855
2401305;Augusto Severo;2010;9289;5002;4287
2401404;Baía Formosa;2010;8573;7128;1445
2401453;Baraúna;2010;24182;15210;8972
2401503;Barcelona;2010;3950;1756;2194
2401602;Bento Fernandes;2010;5113;2067;3046
2401651;Bodó;2010;2425;1393;1032
2401701;Bom Jesus;2010;9440;6768;2672
2401800;Brejinho;2010;11577;8925;2652
2401859;Caiçara do Norte;2010;6016;5894;122
2401909;Caiçara do Rio do Vento;2010;3308;2526;782
2402006;Caicó;2010;62709;57461;5248
2402105;Campo Redondo;2010;10266;5197;5069
2402204;Canguaretama;2010;30916;20235;10681
2402303;Caraúbas;2010;19576;13704;5872
2402402;Carnaúba dos Dantas;2010;7429;6028;1401
2402501;Carnaubais;2010;9762;4757;5005
2402600;Ceará-Mirim;2010;68141;35494;32647
2402709;Cerro Corá;2010;10916;4742;6174
2402808;Coronel Ezequiel;2010;5405;2273;3132
2402907;Coronel João Pessoa;2010;4772;1777;2995
2403004;Cruzeta;2010;7967;6521;1446
2403103;Currais Novos;2010;42652;37777;4875
2403202;Doutor Severiano;2010;6492;2783;3709
2403251;Parnamirim;2010;202456;202456;0
2403301;Encanto;2010;5231;2130;3101
2403400;Equador;2010;5822;4810;1012
2403509;Espírito Santo;2010;10475;5000;5475
2403608;Extremoz;2010;24569;15769;8800
2403707;Felipe Guerra;2010;5734;3875;1859
2403756;Fernando Pedroza;2010;2854;2437;417
2403806;Florânia;2010;8959;6857;2102
2403905;Francisco Dantas;2010;2874;1647;1227
2404002;Frutuoso Gomes;2010;4233;2812;1421
2404101;Galinhos;2010;2159;1235;924
2404200;Goianinha;2010;22481;15477;7004
2404309;Governador Dix-Sept Rosado;2010;12374;6806;5568
2404408;Grossos;2010;9393;7039;2354
2404507;Guamaré;2010;12404;4407;7997
2404606;Ielmo Marinho;2010;12171;1546;10625
2404705;Ipanguaçu;2010;13856;5383;8473
2404804;Ipueira;2010;2077;1889;188
2404853;Itajá;2010;6932;5701;1231
2404903;Itaú;2010;5564;4789;775
2405009;Jaçanã;2010;7925;5333;2592
2405108;Jandaíra;2010;6801;3954;2847
2405207;Janduís;2010;5345;3992;1353
2405306;Januário Cicco;2010;9011;3209;5802
2405405;Japi;2010;5522;4107;1415
2405504;Jardim de Angicos;2010;2607;433;2174
2405603;Jardim de Piranhas;2010;13506;10596;2910
2405702;Jardim do Seridó;2010;12113;9835;2278
2405801;João Câmara;2010;32227;22657;9570
2405900;João Dias;2010;2601;1166;1435
2406007;José da Penha;2010;5868;3542;2326
2406106;Jucurutu;2010;17692;10567;7125
2406155;Jundiá;2010;3582;960;2622
2406205;Lagoa d'Anta;2010;6227;3982;2245
2406304;Lagoa de Pedras;2010;6989;2237;4752
2406403;Lagoa de Velhos;2010;2668;1793;875
2406502;Lagoa Nova;2010;13983;6801;7182
2406601;Lagoa Salgada;2010;7564;5005;2559
2406700;Lajes;2010;10381;8068;2313
2406809;Lajes Pintadas;2010;4612;2390;2222
2406908;Lucrécia;2010;3633;2280;1353
2407005;Luís Gomes;2010;9610;6686;2924
2407104;Macaíba;2010;69467;42631;26836
2407203;Macau;2010;28954;22015;6939
2407252;Major Sales;2010;3536;2900;636
2407302;Marcelino Vieira;2010;8265;4894;3371
2407401;Martins;2010;8218;5036;3182
2407500;Maxaranguape;2010;10441;3889;6552
2407609;Messias Targino;2010;4188;3638;550
2407708;Montanhas;2010;11413;8870;2543
2407807;Monte Alegre;2010;20685;9002;11683
2407906;Monte das Gameleiras;2010;2261;1283;978
2408003;Mossoró;2010;259815;237241;22574
2408102;Natal;2010;803739;803739;0
2408201;Nísia Floresta;2010;23784;9380;14404
2408300;Nova Cruz;2010;35490;24380;11110
2408409;Olho d'Água do Borges;2010;4295;3240;1055
2408508;Ouro Branco;2010;4699;3258;1441
2408607;Paraná;2010;3952;821;3131
2408706;Paraú;2010;3859;3341;518
2408805;Parazinho;2010;4845;3137;1708
2408904;Parelhas;2010;20354;17084;3270
2408953;Rio do Fogo;2010;10059;3748;6311
2409100;Passa e Fica;2010;11100;6755;4345
2409209;Passagem;2010;2895;1191;1704
2409308;Patu;2010;11964;10159;1805
2409332;Santa Maria;2010;4762;3051;1711
2409407;Pau dos Ferros;2010;27745;25551;2194
2409506;Pedra Grande;2010;3521;1161;2360
2409605;Pedra Preta;2010;2590;990;1600
2409704;Pedro Avelino;2010;7171;4120;3051
2409803;Pedro Velho;2010;14114;7248;6866
2409902;Pendências;2010;13432;10574;2858
2410009;Pilões;2010;3453;2533;920
2410108;Poço Branco;2010;13949;7417;6532
2410207;Portalegre;2010;7320;3843;3477
2410256;Porto do Mangue;2010;5217;3027;2190
2410306;Serra Caiada;2010;8768;5313;3455
2410405;Pureza;2010;8424;2996;5428
2410504;Rafael Fernandes;2010;4692;2709;1983
2410603;Rafael Godeiro;2010;3063;1933;1130
2410702;Riacho da Cruz;2010;3165;2674;491
2410801;Riacho de Santana;2010;4156;1710;2446
2410900;Riachuelo;2010;7067;4342;2725
2411007;Rodolfo Fernandes;2010;4418;3734;684
2411056;Tibau;2010;3687;2835;852
2411106;Ruy Barbosa;2010;3595;1736;1859
2411205;Santa Cruz;2010;35797;30499;5298
2411403;Santana do Matos;2010;13809;6895;6914
2411429;Santana do Seridó;2010;2526;1653;873
2411502;Santo Antônio;2010;22216;14280;7936
2411601;São Bento do Norte;2010;2975;1038;1937
2411700;São Bento do Trairí;2010;3905;1884;2021
2411809;São Fernando;2010;3401;2297;1104
2411908;São Francisco do Oeste;2010;3874;2948;926
2412005;São Gonçalo do Amarante;2010;87668;74099;13569
2412104;São João do Sabugi;2010;5922;4756;1166
2412203;São José de Mipibu;2010;39776;18232;21544
2412302;São José do Campestre;2010;12356;10272;2084
2412401;São José do Seridó;2010;4231;3302;929
2412500;São Miguel;2010;22157;14500;7657
2412559;São Miguel do Gostoso;2010;8670;4131;4539
2412609;São Paulo do Potengi;2010;15843;11468;4375
2412708;São Pedro;2010;6235;3494;2741
2412807;São Rafael;2010;8111;5538;2573
2412906;São Tomé;2010;10827;5941;4886
2413003;São Vicente;2010;6028;3765;2263
2413102;Senador Elói de Souza;2010;5637;2423;3214
2413201;Senador Georgino Avelino;2010;3924;3881;43
2413300;Serra de São Bento;2010;5743;3262;2481
2413359;Serra do Mel;2010;10287;2698;7589
2413409;Serra Negra do Norte;2010;7770;4997;2773
2413508;Serrinha;2010;6581;2121;4460
2413557;Serrinha dos Pintos;2010;4540;2404;2136
2413607;Severiano Melo;2010;5752;2118;3634
2413706;Sítio Novo;2010;5020;2390;2630
2413805;Taboleiro Grande;2010;2317;1887;430
2413904;Taipu;2010;11836;4084;7752
2414001;Tangará;2010;14175;9734;4441
2414100;Tenente Ananias;2010;9883;6825;3058
2414159;Tenente Laurentino Cruz;2010;5406;1152;4254
2414209;Tibau do Sul;2010;11385;6861;4524
2414308;Timbaúba dos Batistas;2010;2295;1728;567
2414407;Touros;2010;31089;7922;23167
2414456;Triunfo Potiguar;2010;3368;2197;1171
2414506;Umarizal;2010;10659;9069;1590
2414605;Upanema;2010;12992;6298;6694
2414704;Várzea;2010;5236;4321;915
2414753;Venha-Ver;2010;3821;1199;2622
2414803;Vera Cruz;2010;10719;4695;6024
2414902;Viçosa;2010;1618;1541;77
2415008;Vila Flor;2010;2872;2784;88
2500106;Água Branca;2010;9449;4061;5388
2500205;Aguiar;2010;5530;2701;2829
2500304;Alagoa Grande;2010;28479;17531;10948
2500403;Alagoa Nova;2010;19681;9794;9887
2500502;Alagoinha;2010;13576;9034;4542
2500536;Alcantil;2010;5239;2064;3175
2500577;Algodão de Jandaíra;2010;2366;1231;1135
2500601;Alhandra;2010;18007;11153;6854
2500700;São João do Rio do Peixe;2010;18201;6885;11316
2500734;Amparo;2010;2088;1062;1026
2500775;Aparecida;2010;7676;3638;4038
2500809;Araçagi;2010;17224;6804;10420
2500908;Arara;2010;12653;8924;3729
2501005;Araruna;2010;18879;9328;9551
2501104;Areia;2010;23829;14598;9231
2501153;Areia de Baraúnas;2010;1927;1017;910
2501203;Areial;2010;6470;4600;1870
2501302;Aroeiras;2010;19082;9531;9551
2501351;Assunção;2010;3522;2846;676
2501401;Baía da Traição;2010;8012;3092;4920
2501500;Bananeiras;2010;21851;8668;13183
2501534;Baraúna;2010;4220;3187;1033
2501575;Barra de Santana;2010;8206;731;7475
2501609;Barra de Santa Rosa;2010;14157;7956;6201
2501708;Barra de São Miguel;2010;5611;2364;3247
2501807;Bayeux;2010;99716;98793;923
2501906;Belém;2010;17093;14195;2898
2502003;Belém do Brejo do Cruz;2010;7143;5260;1883
2502052;Bernardino Batista;2010;3075;858;2217
2502102;Boa Ventura;2010;5751;3522;2229
2502151;Boa Vista;2010;6227;3208;3019
2502201;Bom Jesus;2010;2400;988;1412
2502300;Bom Sucesso;2010;5035;2030;3005
2502409;Bonito de Santa Fé;2010;10804;7399;3405
2502508;Boqueirão;2010;16888;12006;4882
2502607;Igaracy;2010;6156;4121;2035
2502706;Borborema;2010;5111;3732;1379
2502805;Brejo do Cruz;2010;13123;9898;3225
2502904;Brejo dos Santos;2010;6198;4634;1564
2503001;Caaporã;2010;20362;17548;2814
2503100;Cabaceiras;2010;5035;2217;2818
2503209;Cabedelo;2010;57944;57944;0
2503308;Cachoeira dos Índios;2010;9546;3403;6143
2503407;Cacimba de Areia;2010;3557;1674;1883
2503506;Cacimba de Dentro;2010;16748;9158;7590
2503555;Cacimbas;2010;6814;1641;5173
2503605;Caiçara;2010;7220;5190;2030
2503704;Cajazeiras;2010;58446;47501;10945
2503753;Cajazeirinhas;2010;3033;1000;2033
2503803;Caldas Brandão;2010;5637;3224;2413
2503902;Camalaú;2010;5749;2887;2862
2504009;Campina Grande;2010;385213;367209;18004
2504033;Capim;2010;5601;4106;1495
2504074;Caraúbas;2010;3899;1517;2382
2504108;Carrapateira;2010;2378;1713;665
2504157;Casserengue;2010;7058;3458;3600
2504207;Catingueira;2010;4812;2884;1928
2504306;Catolé do Rocha;2010;28759;21323;7436
2504355;Caturité;2010;4543;1024;3519
2504405;Conceição;2010;18363;11433;6930
2504504;Condado;2010;6584;4562;2022
2504603;Conde;2010;21400;14487;6913
2504702;Congo;2010;4687;2942;1745
2504801;Coremas;2010;15149;11419;3730
2504850;Coxixola;2010;1771;782;989
2504900;Cruz do Espírito Santo;2010;16257;7440;8817
2505006;Cubati;2010;6866;4769;2097
2505105;Cuité;2010;19978;13462;6516
2505204;Cuitegi;2010;6889;5608;1281
2505238;Cuité de Mamanguape;2010;6202;2069;4133
2505279;Curral de Cima;2010;5209;473;4736
2505303;Curral Velho;2010;2505;1410;1095
2505352;Damião;2010;4900;2278;2622
2505402;Desterro;2010;7991;4889;3102
2505501;Vista Serrana;2010;3512;1586;1926
2505600;Diamante;2010;6616;3818;2798
2505709;Dona Inês;2010;10517;4655;5862
2505808;Duas Estradas;2010;3638;2839;799
2505907;Emas;2010;3317;2132;1185
2506004;Esperança;2010;31095;21631;9464
2506103;Fagundes;2010;11405;5465;5940
2506202;Frei Martinho;2010;2933;1807;1126
2506251;Gado Bravo;2010;8376;908;7468
2506301;Guarabira;2010;55326;48960;6366
2506400;Gurinhém;2010;13872;5795;8077
2506509;Gurjão;2010;3159;2128;1031
2506608;Ibiara;2010;6031;3686;2345
2506707;Imaculada;2010;11352;5063;6289
2506806;Ingá;2010;18180;11599;6581
2506905;Itabaiana;2010;24481;19731;4750
2507002;Itaporanga;2010;23192;17629;5563
2507101;Itapororoca;2010;16997;10856;6141
2507200;Itatuba;2010;10201;5955;4246
2507309;Jacaraú;2010;13942;8032;5910
2507408;Jericó;2010;7538;4729;2809
2507507;João Pessoa;2010;723515;720954;2561
2507606;Juarez Távora;2010;7459;5852;1607
2507705;Juazeirinho;2010;16776;9124;7652
2507804;Junco do Seridó;2010;6643;4369;2274
2507903;Juripiranga;2010;10237;9586;651
2508000;Juru;2010;9826;4359;5467
2508109;Lagoa;2010;4681;2304;2377
2508208;Lagoa de Dentro;2010;7370;3975;3395
2508307;Lagoa Seca;2010;25900;10570;15330
2508406;Lastro;2010;2841;1335;1506
2508505;Livramento;2010;7164;3752;3412
2508554;Logradouro;2010;3942;1723;2219
2508604;Lucena;2010;11730;10152;1578
2508703;Mãe d'Água;2010;4019;1569;2450
2508802;Malta;2010;5613;4905;708
2508901;Mamanguape;2010;42303;34234;8069
2509008;Manaíra;2010;10759;6027;4732
2509057;Marcação;2010;7609;2849;4760
2509107;Mari;2010;21176;17455;3721
2509156;Marizópolis;2010;6173;5357;816
2509206;Massaranduba;2010;12902;4484;8418
2509305;Mataraca;2010;7407;6548;859
2509339;Matinhas;2010;4321;682;3639
2509370;Mato Grosso;2010;2702;1201;1501
2509396;Maturéia;2010;5939;3857;2082
2509404;Mogeiro;2010;12491;5583;6908
2509503;Montadas;2010;4990;3156;1834
2509602;Monte Horebe;2010;4508;2501;2007
2509701;Monteiro;2010;30852;20261;10591
2509800;Mulungu;2010;9469;4536;4933
2509909;Natuba;2010;10566;3634;6932
2510006;Nazarezinho;2010;7280;3184;4096
2510105;Nova Floresta;2010;10533;7892;2641
2510204;Nova Olinda;2010;6070;3227;2843
2510303;Nova Palmeira;2010;4361;2552;1809
2510402;Olho d'Água;2010;6931;3868;3063
2510501;Olivedos;2010;3627;1902;1725
2510600;Ouro Velho;2010;2928;2047;881
2510659;Parari;2010;1256;699;557
2510709;Passagem;2010;2233;1109;1124
2510808;Patos;2010;100674;97278;3396
2510907;Paulista;2010;11788;5720;6068
2511004;Pedra Branca;2010;3721;2365;1356
2511103;Pedra Lavrada;2010;7475;3075;4400
2511202;Pedras de Fogo;2010;27032;16358;10674
2511301;Piancó;2010;15465;11278;4187
2511400;Picuí;2010;18222;12120;6102
2511509;Pilar;2010;11191;7673;3518
2511608;Pilões;2010;6978;3332;3646
2511707;Pilõezinhos;2010;5155;2747;2408
2511806;Pirpirituba;2010;10326;7894;2432
2511905;Pitimbu;2010;17024;10416;6608
2512002;Pocinhos;2010;17032;9618;7414
2512036;Poço Dantas;2010;3751;977;2774
2512077;Poço de José de Moura;2010;3978;1425;2553
2512101;Pombal;2010;32110;25753;6357
2512200;Prata;2010;3854;2444;1410
2512309;Princesa Isabel;2010;21283;14528;6755
2512408;Puxinanã;2010;12923;4217;8706
2512507;Queimadas;2010;41049;22236;18813
2512606;Quixaba;2010;1699;633;1066
2512705;Remígio;2010;17581;12953;4628
2512721;Pedro Régis;2010;5765;2148;3617
2512747;Riachão;2010;3266;2026;1240
2512754;Riachão do Bacamarte;2010;4264;2663;1601
2512762;Riachão do Poço;2010;4164;1287;2877
2512788;Riacho de Santo Antônio;2010;1722;1186;536
2512804;Riacho dos Cavalos;2010;8314;4025;4289
2512903;Rio Tinto;2010;22976;13057;9919
2513000;Salgadinho;2010;3508;1203;2305
2513109;Salgado de São Félix;2010;11976;5250;6726
2513158;Santa Cecília;2010;6658;1868;4790
2513208;Santa Cruz;2010;6471;2988;3483
2513307;Santa Helena;2010;5369;2702;2667
2513356;Santa Inês;2010;3539;1430;2109
2513406;Santa Luzia;2010;14719;13479;1240
2513505;Santana de Mangueira;2010;5331;2231;3100
2513604;Santana dos Garrotes;2010;7266;3736;3530
2513653;Joca Claudino;2010;2615;840;1775
2513703;Santa Rita;2010;120310;103717;16593
2513802;Santa Teresinha;2010;4581;2208;2373
2513851;Santo André;2010;2638;865;1773
2513901;São Bento;2010;30879;25040;5839
2513927;São Bentinho;2010;4138;2845;1293
2513943;São Domingos do Cariri;2010;2420;1034;1386
2513968;São Domingos;2010;2855;994;1861
2513984;São Francisco;2010;3364;1363;2001
2514008;São João do Cariri;2010;4344;2347;1997
2514107;São João do Tigre;2010;4396;1529;2867
2514206;São José da Lagoa Tapada;2010;7564;3315;4249
2514305;São José de Caiana;2010;6010;2729;3281
2514404;São José de Espinharas;2010;4760;1617;3143
2514453;São José dos Ramos;2010;5508;2373;3135
2514503;São José de Piranhas;2010;19096;10815;8281
2514552;São José de Princesa;2010;4219;695;3524
2514602;São José do Bonfim;2010;3233;1361;1872
2514651;São José do Brejo do Cruz;2010;1684;958;726
2514701;São José do Sabugi;2010;4010;2579;1431
2514800;São José dos Cordeiros;2010;3985;1643;2342
2514909;São Mamede;2010;7748;5929;1819
2515005;São Miguel de Taipu;2010;6696;2977;3719
2515104;São Sebastião de Lagoa de Roça;2010;11041;4659;6382
2515203;São Sebastião do Umbuzeiro;2010;3235;2097;1138
2515302;Sapé;2010;50143;38141;12002
2515401;São Vicente do Seridó;2010;10230;4597;5633
2515500;Serra Branca;2010;12973;8418;4555
2515609;Serra da Raiz;2010;3204;2135;1069
2515708;Serra Grande;2010;2975;1776;1199
2515807;Serra Redonda;2010;7050;3608;3442
2515906;Serraria;2010;6238;3467;2771
2515930;Sertãozinho;2010;4395;3215;1180
2515971;Sobrado;2010;7373;883;6490
2516003;Solânea;2010;26693;19332;7361
2516102;Soledade;2010;13739;10231;3508
2516151;Sossêgo;2010;3169;1582;1587
2516201;Sousa;2010;65803;51881;13922
2516300;Sumé;2010;16060;12236;3824
2516409;Tacima;2010;10262;4368;5894
2516508;Taperoá;2010;14936;8939;5997
2516607;Tavares;2010;14103;6616;7487
2516706;Teixeira;2010;14153;9631;4522
2516755;Tenório;2010;2813;1673;1140
2516805;Triunfo;2010;9220;4309;4911
2516904;Uiraúna;2010;14584;10349;4235
2517001;Umbuzeiro;2010;9298;3986;5312
2517100;Várzea;2010;2504;1835;669
2517209;Vieirópolis;2010;5045;996;4049
2517407;Zabelê;2010;2075;1472;603
2600054;Abreu e Lima;2010;94429;86625;7804
2600104;Afogados da Ingazeira;2010;35088;27402;7686
2600203;Afrânio;2010;17586;5861;11725
2600302;Agrestina;2010;22679;16957;5722
2600401;Água Preta;2010;33095;18750;14345
2600500;Águas Belas;2010;40235;24564;15671
2600609;Alagoinha;2010;13759;7769;5990
2600708;Aliança;2010;37415;20247;17168
2600807;Altinho;2010;22353;12776;9577
2600906;Amaraji;2010;21939;16045;5894
2601003;Angelim;2010;10202;6087;4115
2601052;Araçoiaba;2010;18156;15268;2888
2601102;Araripina;2010;77302;46908;30394
2601201;Arcoverde;2010;68793;62668;6125
2601300;Barra de Guabiraba;2010;12776;11390;1386
2601409;Barreiros;2010;40732;33982;6750
2601508;Belém de Maria;2010;11353;7892;3461
2601607;Belém do São Francisco;2010;20253;12582;7671
2601706;Belo Jardim;2010;72432;58233;14199
2601805;Betânia;2010;12003;3712;8291
2601904;Bezerros;2010;58668;49740;8928
2602001;Bodocó;2010;35158;12824;22334
2602100;Bom Conselho;2010;45503;29779;15724
2602209;Bom Jardim;2010;37826;15195;22631
2602308;Bonito;2010;37566;26208;11358
2602407;Brejão;2010;8844;3564;5280
2602506;Brejinho;2010;7307;3386;3921
2602605;Brejo da Madre de Deus;2010;45180;35124;10056
2602704;Buenos Aires;2010;12537;7917;4620
2602803;Buíque;2010;52105;21195;30910
2602902;Cabo de Santo Agostinho;2010;185025;167783;17242
2603009;Cabrobó;2010;30873;19798;11075
2603108;Cachoeirinha;2010;18819;15205;3614
2603207;Caetés;2010;26577;7520;19057
2603306;Calçado;2010;11125;3810;7315
2603405;Calumbi;2010;5648;2180;3468
2603454;Camaragibe;2010;144466;144466;0
2603504;Camocim de São Félix;2010;17104;14327;2777
2603603;Camutanga;2010;8156;6534;1622
2603702;Canhotinho;2010;24521;14106;10415
2603801;Capoeiras;2010;19593;6263;13330
2603900;Carnaíba;2010;18574;7624;10950
2603926;Carnaubeira da Penha;2010;11782;1982;9800
2604007;Carpina;2010;74858;72056;2802
2604106;Caruaru;2010;314912;279589;35323
2604155;Casinhas;2010;13766;1704;12062
2604205;Catende;2010;37820;28861;8959
2604304;Cedro;2010;10778;6291;4487
2604403;Chã de Alegria;2010;12404;9565;2839
2604502;Chã Grande;2010;20137;13692;6445
2604601;Condado;2010;24282;22637;1645
2604700;Correntes;2010;17419;10329;7090
2604809;Cortês;2010;12452;7901;4551
2604908;Cumaru;2010;17183;8039;9144
2605004;Cupira;2010;23390;20787;2603
2605103;Custódia;2010;33855;21716;12139
2605152;Dormentes;2010;16917;6004;10913
2605202;Escada;2010;63517;53964;9553
2605301;Exu;2010;31636;16303;15333
2605400;Feira Nova;2010;20571;16313;4258
2605459;Fernando de Noronha;2010;2630;2630;0
2605509;Ferreiros;2010;11430;9162;2268
2605608;Flores;2010;22169;9364;12805
2605707;Floresta;2010;29285;19973;9312
2605806;Frei Miguelinho;2010;14293;3389;10904
2605905;Gameleira;2010;27912;19504;8408
2606002;Garanhuns;2010;129408;115356;14052
2606101;Glória do Goitá;2010;29019;15434;13585
2606200;Goiana;2010;75644;58025;17619
2606309;Granito;2010;6855;3178;3677
2606408;Gravatá;2010;76458;68385;8073
2606507;Iati;2010;18360;7718;10642
2606606;Ibimirim;2010;26954;14895;12059
2606705;Ibirajuba;2010;7534;3140;4394
2606804;Igarassu;2010;102021;93931;8090
2606903;Iguaracy;2010;11779;6110;5669
2607000;Inajá;2010;19081;7958;11123
2607109;Ingazeira;2010;4496;2456;2040
2607208;Ipojuca;2010;80637;59719;20918
2607307;Ipubi;2010;28120;17278;10842
2607406;Itacuruba;2010;4369;3708;661
2607505;Itaíba;2010;26256;9688;16568
2607604;Ilha de Itamaracá;2010;21884;16993;4891
2607653;Itambé;2010;35398;29424;5974
2607703;Itapetim;2010;13881;8426;5455
2607752;Itapissuma;2010;23769;18320;5449
2607802;Itaquitinga;2010;15692;12064;3628
2607901;Jaboatão dos Guararapes;2010;644620;630595;14025
2607950;Jaqueira;2010;11501;7082;4419
2608008;Jataúba;2010;15819;9184;6635
2608057;Jatobá;2010;13963;6082;7881
2608107;João Alfredo;2010;30743;15020;15723
2608206;Joaquim Nabuco;2010;15773;11504;4269
2608255;Jucati;2010;10604;2828;7776
2608305;Jupi;2010;13705;8356;5349
2608404;Jurema;2010;14541;8753;5788
2608453;Lagoa do Carro;2010;16007;11632;4375
2608503;Lagoa de Itaenga;2010;20659;17118;3541
2608602;Lagoa do Ouro;2010;12132;6029;6103
2608701;Lagoa dos Gatos;2010;15615;8641;6974
2608750;Lagoa Grande;2010;22760;10416;12344
2608800;Lajedo;2010;36628;26395;10233
2608909;Limoeiro;2010;55439;44560;10879
2609006;Macaparana;2010;23925;14833;9092
2609105;Machados;2010;13596;8454;5142
2609154;Manari;2010;18083;3818;14265
2609204;Maraial;2010;12230;8559;3671
2609303;Mirandiba;2010;14308;7141;7167
2609402;Moreno;2010;56696;50197;6499
2609501;Nazaré da Mata;2010;30796;27182;3614
2609600;Olinda;2010;377779;370332;7447
2609709;Orobó;2010;22878;8233;14645
2609808;Orocó;2010;13180;4617;8563
2609907;Ouricuri;2010;64358;32596;31762
2610004;Palmares;2010;59526;46886;12640
2610103;Palmeirina;2010;8189;5178;3011
2610202;Panelas;2010;25645;13964;11681
2610301;Paranatama;2010;11001;2241;8760
2610400;Parnamirim;2010;20224;8377;11847
2610509;Passira;2010;28628;13945;14683
2610608;Paudalho;2010;51357;36332;15025
2610707;Paulista;2010;300466;300466;0
2610806;Pedra;2010;20944;11998;8946
2610905;Pesqueira;2010;62931;45126;17805
2611002;Petrolândia;2010;32492;23621;8871
2611101;Petrolina;2010;293962;219172;74790
2611200;Poção;2010;11242;6988;4254
2611309;Pombos;2010;24046;16011;8035
2611408;Primavera;2010;13439;8579;4860
2611507;Quipapá;2010;24186;11786;12400
2611533;Quixaba;2010;6739;2495;4244
2611606;Recife;2010;1537704;1537704;0
2611705;Riacho das Almas;2010;19162;8762;10400
2611804;Ribeirão;2010;44439;34003;10436
2611903;Rio Formoso;2010;22151;13373;8778
2612000;Sairé;2010;11240;6305;4935
2612109;Salgadinho;2010;9312;3062;6250
2612208;Salgueiro;2010;56629;45713;10916
2612307;Saloá;2010;15309;7668;7641
2612406;Sanharó;2010;21955;12500;9455
2612455;Santa Cruz;2010;13594;4447;9147
2612471;Santa Cruz da Baixa Verde;2010;11768;5277;6491
2612505;Santa Cruz do Capibaribe;2010;87582;85594;1988
2612554;Santa Filomena;2010;13371;2226;11145
2612604;Santa Maria da Boa Vista;2010;39435;14876;24559
2612703;Santa Maria do Cambucá;2010;13021;3275;9746
2612802;Santa Terezinha;2010;10991;6876;4115
2612901;São Benedito do Sul;2010;13941;7158;6783
2613008;São Bento do Una;2010;53242;27899;25343
2613107;São Caitano;2010;35274;27079;8195
2613206;São João;2010;21312;9656;11656
2613305;São Joaquim do Monte;2010;20488;14122;6366
2613404;São José da Coroa Grande;2010;18180;13436;4744
2613503;São José do Belmonte;2010;32617;16168;16449
2613602;São José do Egito;2010;31829;20960;10869
2613701;São Lourenço da Mata;2010;102895;96777;6118
2613800;São Vicente Férrer;2010;17000;11201;5799
2613909;Serra Talhada;2010;79232;61275;17957
2614006;Serrita;2010;18331;6356;11975
2614105;Sertânia;2010;33787;18557;15230
2614204;Sirinhaém;2010;40296;21484;18812
2614303;Moreilândia;2010;11132;6838;4294
2614402;Solidão;2010;5744;1831;3913
2614501;Surubim;2010;58515;44036;14479
2614600;Tabira;2010;26427;19769;6658
2614709;Tacaimbó;2010;12725;7085;5640
2614808;Tacaratu;2010;22068;9192;12876
2614857;Tamandaré;2010;20715;15170;5545
2615003;Taquaritinga do Norte;2010;24903;17961;6942
2615102;Terezinha;2010;6737;2860;3877
2615201;Terra Nova;2010;9278;5014;4264
2615300;Timbaúba;2010;53825;46367;7458
2615409;Toritama;2010;35554;34125;1429
2615508;Tracunhaém;2010;13055;10969;2086
2615607;Trindade;2010;26116;22464;3652
2615706;Triunfo;2010;15006;7944;7062
2615805;Tupanatinga;2010;24425;8534;15891
2615904;Tuparetama;2010;7925;6351;1574
2616001;Venturosa;2010;16052;10343;5709
2616100;Verdejante;2010;9142;2692;6450
2616183;Vertente do Lério;2010;7873;1813;6060
2616209;Vertentes;2010;18222;12941;5281
2616308;Vicência;2010;30732;13805;16927
2616407;Vitória de Santo Antão;2010;129974;113429;16545
2616506;Xexéu;2010;14093;9170;4923
2700102;Água Branca;2010;19377;5101;14276
2700201;Anadia;2010;17424;8949;8475
2700300;Arapiraca;2010;214006;181481;32525
2700409;Atalaia;2010;44322;22457;21865
2700508;Barra de Santo Antônio;2010;14230;13242;988
2700607;Barra de São Miguel;2010;7574;6521;1053
2700706;Batalha;2010;17076;12042;5034
2700805;Belém;2010;4551;1872;2679
2700904;Belo Monte;2010;7030;1171;5859
2701001;Boca da Mata;2010;25776;17450;8326
2701100;Branquinha;2010;10583;6673;3910
2701209;Cacimbinhas;2010;10195;5402;4793
2701308;Cajueiro;2010;20409;16484;3925
2701357;Campestre;2010;6598;5540;1058
2701407;Campo Alegre;2010;50816;22161;28655
2701506;Campo Grande;2010;9032;4185;4847
2701605;Canapi;2010;17250;5538;11712
2701704;Capela;2010;17077;12650;4427
2701803;Carneiros;2010;8290;4702;3588
2701902;Chã Preta;2010;7146;4488;2658
2702009;Coité do Nóia;2010;10926;3737;7189
2702108;Colônia Leopoldina;2010;20019;15319;4700
2702207;Coqueiro Seco;2010;5526;4973;553
2702306;Coruripe;2010;52130;46043;6087
2702355;Craíbas;2010;22641;7328;15313
2702405;Delmiro Gouveia;2010;48096;34854;13242
2702504;Dois Riachos;2010;10880;5085;5795
2702553;Estrela de Alagoas;2010;17251;4029;13222
2702603;Feira Grande;2010;21321;3421;17900
2702702;Feliz Deserto;2010;4345;3481;864
2702801;Flexeiras;2010;12325;8017;4308
2702900;Girau do Ponciano;2010;36600;11298;25302
2703007;Ibateguara;2010;15149;9335;5814
2703106;Igaci;2010;25188;6184;19004
2703205;Igreja Nova;2010;23292;4775;18517
2703304;Inhapi;2010;17898;6699;11199
2703403;Jacaré dos Homens;2010;5413;3032;2381
2703502;Jacuípe;2010;6997;4355;2642
2703601;Japaratinga;2010;7754;3308;4446
2703700;Jaramataia;2010;5558;2913;2645
2703759;Jequiá da Praia;2010;12029;2879;9150
2703809;Joaquim Gomes;2010;22575;14477;8098
2703908;Jundiá;2010;4202;2827;1375
2704005;Junqueiro;2010;23836;7803;16033
2704104;Lagoa da Canoa;2010;18250;9165;9085
2704203;Limoeiro de Anadia;2010;26992;2246;24746
2704302;Maceió;2010;932748;932078;670
2704401;Major Isidoro;2010;18897;9306;9591
2704500;Maragogi;2010;28749;18625;10124
2704609;Maravilha;2010;10284;5137;5147
2704708;Marechal Deodoro;2010;45977;43392;2585
2704807;Maribondo;2010;13619;9978;3641
2704906;Mar Vermelho;2010;3652;1638;2014
2705002;Mata Grande;2010;24698;5674;19024
2705101;Matriz de Camaragibe;2010;23785;22096;1689
2705200;Messias;2010;15682;14263;1419
2705309;Minador do Negrão;2010;5275;2252;3023
2705408;Monteirópolis;2010;6935;2515;4420
2705507;Murici;2010;26710;22108;4602
2705606;Novo Lino;2010;12060;7328;4732
2705705;Olho d'Água das Flores;2010;20364;13989;6375
2705804;Olho d'Água do Casado;2010;8491;4027;4464
2705903;Olho d'Água Grande;2010;4957;1203;3754
2706000;Olivença;2010;11047;3137;7910
2706109;Ouro Branco;2010;10912;6880;4032
2706208;Palestina;2010;5112;3237;1875
2706307;Palmeira dos Índios;2010;70368;51610;18758
2706406;Pão de Açúcar;2010;23811;10769;13042
2706422;Pariconha;2010;10264;2796;7468
2706448;Paripueira;2010;11347;10049;1298
2706505;Passo de Camaragibe;2010;14763;7228;7535
2706604;Paulo Jacinto;2010;7426;4908;2518
2706703;Penedo;2010;60378;45020;15358
2706802;Piaçabuçu;2010;17203;10436;6767
2706901;Pilar;2010;33305;31801;1504
2707008;Pindoba;2010;2866;1637;1229
2707107;Piranhas;2010;23045;13189;9856
2707206;Poço das Trincheiras;2010;13872;2043;11829
2707305;Porto Calvo;2010;25708;20197;5511
2707404;Porto de Pedras;2010;8429;4798;3631
2707503;Porto Real do Colégio;2010;19334;6606;12728
2707602;Quebrangulo;2010;11480;6474;5006
2707701;Rio Largo;2010;68481;55947;12534
2707800;Roteiro;2010;6656;5830;826
2707909;Santa Luzia do Norte;2010;6891;6172;719
2708006;Santana do Ipanema;2010;44932;27185;17747
2708105;Santana do Mundaú;2010;10961;5658;5303
2708204;São Brás;2010;6718;3183;3535
2708303;São José da Laje;2010;22686;15391;7295
2708402;São José da Tapera;2010;30088;11637;18451
2708501;São Luís do Quitunde;2010;32412;20588;11824
2708600;São Miguel dos Campos;2010;54577;52566;2011
2708709;São Miguel dos Milagres;2010;7163;2261;4902
2708808;São Sebastião;2010;32010;12309;19701
2708907;Satuba;2010;14603;12792;1811
2708956;Senador Rui Palmeira;2010;13047;3944;9103
2709004;Tanque d'Arca;2010;6122;2140;3982
2709103;Taquarana;2010;19020;7314;11706
2709152;Teotônio Vilela;2010;41152;34785;6367
2709202;Traipu;2010;25702;8027;17675
2709301;União dos Palmares;2010;62358;47651;14707
2709400;Viçosa;2010;25407;18313;7094
2800100;Amparo de São Francisco;2010;2275;1840;435
2800209;Aquidabã;2010;20056;11457;8599
2800308;Aracaju;2010;571149;571149;0
2800407;Arauá;2010;10878;4487;6391
2800506;Areia Branca;2010;16857;8191;8666
2800605;Barra dos Coqueiros;2010;24976;20886;4090
2800670;Boquim;2010;25533;15994;9539
2800704;Brejo Grande;2010;7742;4022;3720
2801009;Campo do Brito;2010;16749;8330;8419
2801108;Canhoba;2010;3956;1499;2457
2801207;Canindé de São Francisco;2010;24686;14063;10623
2801306;Capela;2010;30761;19742;11019
2801405;Carira;2010;20007;11167;8840
2801504;Carmópolis;2010;13503;10716;2787
2801603;Cedro de São João;2010;5633;5035;598
2801702;Cristinápolis;2010;16519;8336;8183
2801900;Cumbe;2010;3813;2271;1542
2802007;Divina Pastora;2010;4326;2099;2227
2802106;Estância;2010;64409;54760;9649
2802205;Feira Nova;2010;5324;3587;1737
2802304;Frei Paulo;2010;13874;8213;5661
2802403;Gararu;2010;11405;3051;8354
2802502;General Maynard;2010;2929;1843;1086
2802601;Gracho Cardoso;2010;5645;2703;2942
2802700;Ilha das Flores;2010;8348;5435;2913
2802809;Indiaroba;2010;15831;5585;10246
2802908;Itabaiana;2010;86967;67709;19258
2803005;Itabaianinha;2010;38910;19409;19501
2803104;Itabi;2010;4972;2752;2220
2803203;Itaporanga d'Ajuda;2010;30419;11869;18550
2803302;Japaratuba;2010;16864;7903;8961
2803401;Japoatã;2010;12938;4312;8626
2803500;Lagarto;2010;94861;48867;45994
2803609;Laranjeiras;2010;26902;21257;5645
2803708;Macambira;2010;6401;3063;3338
2803807;Malhada dos Bois;2010;3456;1600;1856
2803906;Malhador;2010;12042;5626;6416
2804003;Maruim;2010;16343;12041;4302
2804102;Moita Bonita;2010;11001;4600;6401
2804201;Monte Alegre de Sergipe;2010;13627;8043;5584
2804300;Muribeca;2010;7344;3288;4056
2804409;Neópolis;2010;18506;10517;7989
2804458;Nossa Senhora Aparecida;2010;8508;3455;5053
2804508;Nossa Senhora da Glória;2010;32497;21617;10880
2804607;Nossa Senhora das Dores;2010;24580;16027;8553
2804706;Nossa Senhora de Lourdes;2010;6238;3291;2947
2804805;Nossa Senhora do Socorro;2010;160827;155823;5004
2804904;Pacatuba;2010;13137;2688;10449
2805000;Pedra Mole;2010;2974;1197;1777
2805109;Pedrinhas;2010;8833;6471;2362
2805208;Pinhão;2010;5973;3319;2654
2805307;Pirambu;2010;8369;4906;3463
2805406;Poço Redondo;2010;30880;8538;22342
2805505;Poço Verde;2010;21983;12312;9671
2805604;Porto da Folha;2010;27146;9955;17191
2805703;Propriá;2010;28451;24390;4061
2805802;Riachão do Dantas;2010;19386;4872;14514
2805901;Riachuelo;2010;9355;7855;1500
2806008;Ribeirópolis;2010;17173;11928;5245
2806107;Rosário do Catete;2010;9221;6509;2712
2806206;Salgado;2010;19365;6694;12671
2806305;Santa Luzia do Itanhy;2010;12969;2915;10054
2806404;Santana do São Francisco;2010;7038;4523;2515
2806503;Santa Rosa de Lima;2010;3749;2137;1612
2806602;Santo Amaro das Brotas;2010;11410;8211;3199
2806701;São Cristóvão;2010;78864;66665;12199
2806800;São Domingos;2010;10271;5147;5124
2806909;São Francisco;2010;3393;2379;1014
2807006;São Miguel do Aleixo;2010;3698;1747;1951
2807105;Simão Dias;2010;38702;20426;18276
2807204;Siriri;2010;8004;3181;4823
2807303;Telha;2010;2957;1127;1830
2807402;Tobias Barreto;2010;48040;32228;15812
2807501;Tomar do Geru;2010;12855;4812;8043
2807600;Umbaúba;2010;22434;13923;8511
2900108;Abaíra;2010;8316;3736;4580
2900207;Abaré;2010;17064;9029;8035
2900306;Acajutiba;2010;14653;12774;1879
2900355;Adustina;2010;15702;5572;10130
2900405;Água Fria;2010;15731;5777;9954
2900504;Érico Cardoso;2010;10859;2016;8843
2900603;Aiquara;2010;4602;2680;1922
2900702;Alagoinhas;2010;141949;124042;17907
2900801;Alcobaça;2010;21271;11085;10186
2900900;Almadina;2010;6357;5080;1277
2901007;Amargosa;2010;34351;24891;9460
2901106;Amélia Rodrigues;2010;25190;19957;5233
2901155;América Dourada;2010;15961;10832;5129
2901205;Anagé;2010;25516;4924;20592
2901304;Andaraí;2010;13960;7773;6187
2901353;Andorinha;2010;14414;6208;8206
2901403;Angical;2010;14073;6531;7542
2901502;Anguera;2010;10242;4326;5916
2901601;Antas;2010;17072;6360;10712
2901700;Antônio Cardoso;2010;11554;3225;8329
2901809;Antônio Gonçalves;2010;11015;5783;5232
2901908;Aporá;2010;17731;8505;9226
2901957;Apuarema;2010;7459;5117;2342
2902005;Aracatu;2010;13743;3938;9805
2902054;Araçás;2010;11561;5807;5754
2902104;Araci;2010;51651;19638;32013
2902203;Aramari;2010;10036;5125;4911
2902252;Arataca;2010;10392;5588;4804
2902302;Aratuípe;2010;8599;5513;3086
2902401;Aurelino Leal;2010;13595;11426;2169
2902500;Baianópolis;2010;13850;3482;10368
2902609;Baixa Grande;2010;20060;8338;11722
2902658;Banzaê;2010;11814;4042;7772
2902708;Barra;2010;49325;22446;26879
2902807;Barra da Estiva;2010;21187;10404;10783
2902906;Barra do Choça;2010;34788;22407;12381
2903003;Barra do Mendes;2010;13987;6256;7731
2903102;Barra do Rocha;2010;6313;3806;2507
2903201;Barreiras;2010;137427;123741;13686
2903235;Barro Alto;2010;13612;6712;6900
2903276;Barrocas;2010;14191;5695;8496
2903300;Barro Preto;2010;6453;5295;1158
2903409;Belmonte;2010;21798;11420;10378
2903508;Belo Campo;2010;16021;9029;6992
2903607;Biritinga;2010;14836;3517;11319
2903706;Boa Nova;2010;15411;5804;9607
2903805;Boa Vista do Tupim;2010;17991;6593;11398
2903904;Bom Jesus da Lapa;2010;63480;43099;20381
2903953;Bom Jesus da Serra;2010;10113;2768;7345
2904001;Boninal;2010;13695;4607;9088
2904050;Bonito;2010;14834;6232;8602
2904100;Boquira;2010;22037;7364;14673
2904209;Botuporã;2010;11154;4076;7078
2904308;Brejões;2010;14282;4937;9345
2904407;Brejolândia;2010;11077;1984;9093
2904506;Brotas de Macaúbas;2010;10717;3118;7599
2904605;Brumado;2010;64602;45131;19471
2904704;Buerarema;2010;18605;15277;3328
2904753;Buritirama;2010;19600;7905;11695
2904803;Caatiba;2010;11420;5398;6022
2904852;Cabaceiras do Paraguaçu;2010;17327;4644;12683
2904902;Cachoeira;2010;32026;16387;15639
2905008;Caculé;2010;22236;13309;8927
2905107;Caém;2010;10368;3655;6713
2905156;Caetanos;2010;13639;3291;10348
2905206;Caetité;2010;47515;28447;19068
2905305;Cafarnaum;2010;17209;10563;6646
2905404;Cairu;2010;15374;8147;7227
2905503;Caldeirão Grande;2010;12491;4558;7933
2905602;Camacan;2010;31472;24685;6787
2905701;Camaçari;2010;242970;231973;10997
2905800;Camamu;2010;35180;15618;19562
2905909;Campo Alegre de Lourdes;2010;28090;8126;19964
2906006;Campo Formoso;2010;66616;24863;41753
2906105;Canápolis;2010;9410;3225;6185
2906204;Canarana;2010;24067;11455;12612
2906303;Canavieiras;2010;32336;25903;6433
2906402;Candeal;2010;8895;3476;5419
2906501;Candeias;2010;83158;75994;7164
2906600;Candiba;2010;13210;7725;5485
2906709;Cândido Sales;2010;27918;19286;8632
2906808;Cansanção;2010;32908;11021;21887
2906824;Canudos;2010;15732;8698;7034
2906857;Capela do Alto Alegre;2010;11527;5595;5932
2906873;Capim Grosso;2010;26577;21762;4815
2906899;Caraíbas;2010;10222;2513;7709
2906907;Caravelas;2010;21414;11730;9684
2907004;Cardeal da Silva;2010;8899;2901;5998
2907103;Carinhanha;2010;28380;12585;15795
2907202;Casa Nova;2010;64940;37543;27397
2907301;Castro Alves;2010;25408;15686;9722
2907400;Catolândia;2010;2612;967;1645
2907509;Catu;2010;51077;42755;8322
2907558;Caturama;2010;8843;2374;6469
2907608;Central;2010;17013;8157;8856
2907707;Chorrochó;2010;10734;2631;8103
2907806;Cícero Dantas;2010;32300;17726;14574
2907905;Cipó;2010;15755;11287;4468
2908002;Coaraci;2010;20964;19130;1834
2908101;Cocos;2010;18153;8572;9581
2908200;Conceição da Feira;2010;20391;13137;7254
2908309;Conceição do Almeida;2010;17889;7926;9963
2908408;Conceição do Coité;2010;62040;36278;25762
2908507;Conceição do Jacuípe;2010;30123;23539;6584
2908606;Conde;2010;23620;12129;11491
2908705;Condeúba;2010;16898;7462;9436
2908804;Contendas do Sincorá;2010;4663;2297;2366
2908903;Coração de Maria;2010;22401;9400;13001
2909000;Cordeiros;2010;8168;2551;5617
2909109;Coribe;2010;14307;6141;8166
2909208;Coronel João Sá;2010;17066;7043;10023
2909307;Correntina;2010;31249;12604;18645
2909406;Cotegipe;2010;13636;6648;6988
2909505;Cravolândia;2010;5041;3180;1861
2909604;Crisópolis;2010;20046;8612;11434
2909703;Cristópolis;2010;13280;3133;10147
2909802;Cruz das Almas;2010;58606;49885;8721
2909901;Curaçá;2010;32168;13719;18449
2910008;Dário Meira;2010;12836;5090;7746
2910057;Dias d'Ávila;2010;66440;62473;3967
2910107;Dom Basílio;2010;11355;2241;9114
2910206;Dom Macedo Costa;2010;3874;1761;2113
2910305;Elísio Medrado;2010;7947;3248;4699
2910404;Encruzilhada;2010;23766;5130;18636
2910503;Entre Rios;2010;39872;23824;16048
2910602;Esplanada;2010;32802;20822;11980
2910701;Euclides da Cunha;2010;56289;27416;28873
2910727;Eunápolis;2010;100196;93413;6783
2910750;Fátima;2010;17652;6916;10736
2910776;Feira da Mata;2010;6184;3243;2941
2910800;Feira de Santana;2010;556642;510635;46007
2910859;Filadélfia;2010;16740;9022;7718
2910909;Firmino Alves;2010;5384;4337;1047
2911006;Floresta Azul;2010;10660;7343;3317
2911105;Formosa do Rio Preto;2010;22528;13647;8881
2911204;Gandu;2010;30336;24848;5488
2911253;Gavião;2010;4561;2538;2023
2911303;Gentio do Ouro;2010;10622;5350;5272
2911402;Glória;2010;15076;2827;12249
2911501;Gongogi;2010;8357;5358;2999
2911600;Governador Mangabeira;2010;19818;7417;12401
2911659;Guajeru;2010;10412;2077;8335
2911709;Guanambi;2010;78833;62565;16268
2911808;Guaratinga;2010;22165;10425;11740
2911857;Heliópolis;2010;13192;5428;7764
2911907;Iaçu;2010;25736;20168;5568
2912004;Ibiassucê;2010;10062;4706;5356
2912103;Ibicaraí;2010;24272;17885;6387
2912202;Ibicoara;2010;17282;10961;6321
2912301;Ibicuí;2010;15785;11964;3821
2912400;Ibipeba;2010;17008;10049;6959
2912509;Ibipitanga;2010;14171;5155;9016
2912608;Ibiquera;2010;4866;2461;2405
2912707;Ibirapitanga;2010;22598;6163;16435
2912806;Ibirapuã;2010;7956;4532;3424
2912905;Ibirataia;2010;18943;15742;3201
2913002;Ibitiara;2010;15508;3437;12071
2913101;Ibititá;2010;17840;8338;9502
2913200;Ibotirama;2010;25424;19501;5923
2913309;Ichu;2010;5255;3365;1890
2913408;Igaporã;2010;15205;7864;7341
2913457;Igrapiúna;2010;13343;4275;9068
2913507;Iguaí;2010;25705;14580;11125
2913606;Ilhéus;2010;184236;155281;28955
2913705;Inhambupe;2010;36306;15635;20671
2913804;Ipecaetá;2010;15331;2637;12694
2913903;Ipiaú;2010;44390;40384;4006
2914000;Ipirá;2010;59343;29009;30334
2914109;Ipupiara;2010;9285;5979;3306
2914208;Irajuba;2010;7002;3273;3729
2914307;Iramaia;2010;11990;5373;6617
2914406;Iraquara;2010;22601;6757;15844
2914505;Irará;2010;27466;11246;16220
2914604;Irecê;2010;66181;61019;5162
2914653;Itabela;2010;28390;21384;7006
2914703;Itaberaba;2010;61631;48485;13146
2914802;Itabuna;2010;204667;199749;4918
2914901;Itacaré;2010;24318;13642;10676
2915007;Itaeté;2010;14924;6209;8715
2915106;Itagi;2010;13051;10210;2841
2915205;Itagibá;2010;15193;9572;5621
2915304;Itagimirim;2010;7110;5649;1461
2915353;Itaguaçu da Bahia;2010;13209;2598;10611
2915403;Itaju do Colônia;2010;7309;5860;1449
2915502;Itajuípe;2010;21081;16839;4242
2915601;Itamaraju;2010;63069;49785;13284
2915700;Itamari;2010;7903;5839;2064
2915809;Itambé;2010;23089;19698;3391
2915908;Itanagra;2010;7598;2327;5271
2916005;Itanhém;2010;20216;14206;6010
2916104;Itaparica;2010;20725;20725;0
2916203;Itapé;2010;10995;7180;3815
2916302;Itapebi;2010;10495;8268;2227
2916401;Itapetinga;2010;68273;66276;1997
2916500;Itapicuru;2010;32261;6675;25586
2916609;Itapitanga;2010;10207;7591;2616
2916708;Itaquara;2010;7678;4608;3070
2916807;Itarantim;2010;18539;15302;3237
2916856;Itatim;2010;14522;10112;4410
2916906;Itiruçu;2010;12693;9526;3167
2917003;Itiúba;2010;36113;9699;26414
2917102;Itororó;2010;19914;18100;1814
2917201;Ituaçu;2010;18127;6569;11558
2917300;Ituberá;2010;26591;19252;7339
2917334;Iuiu;2010;10900;5284;5616
2917359;Jaborandi;2010;8973;3040;5933
2917409;Jacaraci;2010;13651;4923;8728
2917508;Jacobina;2010;79247;55868;23379
2917607;Jaguaquara;2010;51011;38850;12161
2917706;Jaguarari;2010;30343;16612;13731
2917805;Jaguaripe;2010;16467;5298;11169
2917904;Jandaíra;2010;10331;6147;4184
2918001;Jequié;2010;151895;139426;12469
2918100;Jeremoabo;2010;37680;17437;20243
2918209;Jiquiriçá;2010;14118;5581;8537
2918308;Jitaúna;2010;14115;9260;4855
2918357;João Dourado;2010;22549;13569;8980
2918407;Juazeiro;2010;197965;160775;37190
2918456;Jucuruçu;2010;10290;2292;7998
2918506;Jussara;2010;15052;10052;5000
2918555;Jussari;2010;6474;4876;1598
2918605;Jussiape;2010;8031;3068;4963
2918704;Lafaiete Coutinho;2010;3901;2104;1797
2918753;Lagoa Real;2010;13934;2808;11126
2918803;Laje;2010;22201;6080;16121
2918902;Lajedão;2010;3733;2076;1657
2919009;Lajedinho;2010;3936;1245;2691
2919058;Lajedo do Tabocal;2010;8305;5149;3156
2919108;Lamarão;2010;9560;2085;7475
2919157;Lapão;2010;25646;10050;15596
2919207;Lauro de Freitas;2010;163449;163449;0
2919306;Lençóis;2010;10368;8037;2331
2919405;Licínio de Almeida;2010;12311;6253;6058
2919504;Livramento de Nossa Senhora;2010;42693;20530;22163
2919553;Luís Eduardo Magalhães;2010;60105;54881;5224
2919603;Macajuba;2010;11229;6871;4358
2919702;Macarani;2010;17093;13639;3454
2919801;Macaúbas;2010;47051;15411;31640
2919900;Macururé;2010;8073;2860;5213
2919926;Madre de Deus;2010;17376;16854;522
2919959;Maetinga;2010;7038;2817;4221
2920007;Maiquinique;2010;8782;6916;1866
2920106;Mairi;2010;19326;11115;8211
2920205;Malhada;2010;16014;6559;9455
2920304;Malhada de Pedras;2010;8468;3234;5234
2920403;Manoel Vitorino;2010;14387;7359;7028
2920452;Mansidão;2010;12592;4782;7810
2920502;Maracás;2010;24613;17707;6906
2920601;Maragogipe;2010;42815;25093;17722
2920700;Maraú;2010;19101;3561;15540
2920809;Marcionílio Souza;2010;10500;5312;5188
2920908;Mascote;2010;14640;11679;2961
2921005;Mata de São João;2010;40183;29825;10358
2921054;Matina;2010;11145;3473;7672
2921104;Medeiros Neto;2010;21560;17064;4496
2921203;Miguel Calmon;2010;26475;16066;10409
2921302;Milagres;2010;10306;7789;2517
2921401;Mirangaba;2010;16279;7879;8400
2921450;Mirante;2010;10507;1809;8698
2921500;Monte Santo;2010;52338;8845;43493
2921609;Morpará;2010;8280;5538;2742
2921708;Morro do Chapéu;2010;35164;20267;14897
2921807;Mortugaba;2010;12477;5887;6590
2921906;Mucugê;2010;10545;4180;6365
2922003;Mucuri;2010;36026;27492;8534
2922052;Mulungu do Morro;2010;12249;5919;6330
2922102;Mundo Novo;2010;24395;13564;10831
2922201;Muniz Ferreira;2010;7317;3394;3923
2922250;Muquém do São Francisco;2010;10272;1283;8989
2922300;Muritiba;2010;28899;18040;10859
2922409;Mutuípe;2010;21449;9659;11790
2922508;Nazaré;2010;27274;22864;4410
2922607;Nilo Peçanha;2010;12530;3105;9425
2922656;Nordestina;2010;12371;3921;8450
2922706;Nova Canaã;2010;16713;6852;9861
2922730;Nova Fátima;2010;7602;5074;2528
2922755;Nova Ibiá;2010;6648;2807;3841
2922805;Nova Itarana;2010;7435;2715;4720
2922854;Nova Redenção;2010;8034;5237;2797
2922904;Nova Soure;2010;24136;11730;12406
2923001;Nova Viçosa;2010;38556;33526;5030
2923035;Novo Horizonte;2010;10673;3505;7168
2923050;Novo Triunfo;2010;15051;7503;7548
2923100;Olindina;2010;24943;12773;12170
2923209;Oliveira dos Brejinhos;2010;21831;6584;15247
2923308;Ouriçangas;2010;8298;2762;5536
2923357;Ourolândia;2010;16425;6341;10084
2923407;Palmas de Monte Alto;2010;20775;9832;10943
2923506;Palmeiras;2010;8410;5239;3171
2923605;Paramirim;2010;21001;10029;10972
2923704;Paratinga;2010;29504;10905;18599
2923803;Paripiranga;2010;27778;9533;18245
2923902;Pau Brasil;2010;10852;7382;3470
2924009;Paulo Afonso;2010;108396;93404;14992
2924058;Pé de Serra;2010;13752;5174;8578
2924108;Pedrão;2010;6876;1716;5160
2924207;Pedro Alexandre;2010;16995;2786;14209
2924306;Piatã;2010;17982;7612;10370
2924405;Pilão Arcado;2010;32860;11027;21833
2924504;Pindaí;2010;15628;4319;11309
2924603;Pindobaçu;2010;20121;11237;8884
2924652;Pintadas;2010;10342;5840;4502
2924678;Piraí do Norte;2010;9799;3689;6110
2924702;Piripá;2010;12783;6261;6522
2924801;Piritiba;2010;22399;15162;7237
2924900;Planaltino;2010;8822;3640;5182
2925006;Planalto;2010;24481;14869;9612
2925105;Poções;2010;44701;34659;10042
2925204;Pojuca;2010;33066;28378;4688
2925253;Ponto Novo;2010;15742;8405;7337
2925303;Porto Seguro;2010;126929;104078;22851
2925402;Potiraguá;2010;9810;6604;3206
2925501;Prado;2010;27627;15474;12153
2925600;Presidente Dutra;2010;13750;9056;4694
2925709;Presidente Jânio Quadros;2010;13652;4198;9454
2925758;Presidente Tancredo Neves;2010;23846;9569;14277
2925808;Queimadas;2010;24602;12492;12110
2925907;Quijingue;2010;27228;6377;20851
2925931;Quixabeira;2010;9554;3663;5891
2925956;Rafael Jambeiro;2010;22874;6850;16024
2926004;Remanso;2010;38957;23470;15487
2926103;Retirolândia;2010;12055;6722;5333
2926202;Riachão das Neves;2010;21937;10744;11193
2926301;Riachão do Jacuípe;2010;33172;19860;13312
2926400;Riacho de Santana;2010;30646;13091;17555
2926509;Ribeira do Amparo;2010;14276;1921;12355
2926608;Ribeira do Pombal;2010;47518;29756;17762
2926657;Ribeirão do Largo;2010;8602;4647;3955
2926707;Rio de Contas;2010;13007;6309;6698
2926806;Rio do Antônio;2010;14815;5993;8822
2926905;Rio do Pires;2010;11918;5267;6651
2927002;Rio Real;2010;37164;23310;13854
2927101;Rodelas;2010;7775;6540;1235
2927200;Ruy Barbosa;2010;29887;22093;7794
2927309;Salinas da Margarida;2010;13456;5960;7496
2927408;Salvador;2010;2675656;2674923;733
2927507;Santa Bárbara;2010;19064;8669;10395
2927606;Santa Brígida;2010;15060;5611;9449
2927705;Santa Cruz Cabrália;2010;26264;19002;7262
2927804;Santa Cruz da Vitória;2010;6673;5076;1597
2927903;Santa Inês;2010;10363;9514;849
2928000;Santaluz;2010;33838;20795;13043
2928059;Santa Luzia;2010;13344;8072;5272
2928109;Santa Maria da Vitória;2010;40309;23816;16493
2928208;Santana;2010;24750;13483;11267
2928307;Santanópolis;2010;8776;1684;7092
2928406;Santa Rita de Cássia;2010;26250;14907;11343
2928505;Santa Terezinha;2010;9648;2334;7314
2928604;Santo Amaro;2010;57800;44766;13034
2928703;Santo Antônio de Jesus;2010;90985;79299;11686
2928802;Santo Estêvão;2010;47880;27690;20190
2928901;São Desidério;2010;27659;8633;19026
2928950;São Domingos;2010;9226;5916;3310
2929008;São Félix;2010;14098;9265;4833
2929057;São Félix do Coribe;2010;13048;10587;2461
2929107;São Felipe;2010;20305;9820;10485
2929206;São Francisco do Conde;2010;33183;27391;5792
2929255;São Gabriel;2010;18427;10494;7933
2929305;São Gonçalo dos Campos;2010;33283;16505;16778
2929354;São José da Vitória;2010;5715;5162;553
2929370;São José do Jacuípe;2010;10180;6991;3189
2929404;São Miguel das Matas;2010;10414;3360;7054
2929503;São Sebastião do Passé;2010;42153;33112;9041
2929602;Sapeaçu;2010;16585;8084;8501
2929701;Sátiro Dias;2010;18964;4332;14632
2929750;Saubara;2010;11201;10948;253
2929800;Saúde;2010;11845;6646;5199
2929909;Seabra;2010;41798;20277;21521
2930006;Sebastião Laranjeiras;2010;10371;4084;6287
2930105;Senhor do Bonfim;2010;74419;57566;16853
2930154;Serra do Ramalho;2010;31638;6274;25364
2930204;Sento Sé;2010;37425;21676;15749
2930303;Serra Dourada;2010;18112;6002;12110
2930402;Serra Preta;2010;15401;6920;8481
2930501;Serrinha;2010;76762;47188;29574
2930600;Serrolândia;2010;12344;7279;5065
2930709;Simões Filho;2010;118047;105811;12236
2930758;Sítio do Mato;2010;12050;6866;5184
2930766;Sítio do Quinto;2010;12592;5172;7420
2930774;Sobradinho;2010;22000;20002;1998
2930808;Souto Soares;2010;15899;6039;9860
2930907;Tabocas do Brejo Velho;2010;11431;3932;7499
2931004;Tanhaçu;2010;20013;8290;11723
2931053;Tanque Novo;2010;16128;7317;8811
2931103;Tanquinho;2010;8008;5711;2297
2931202;Taperoá;2010;18748;8725;10023
2931301;Tapiramutá;2010;16516;12784;3732
2931350;Teixeira de Freitas;2010;138341;129263;9078
2931400;Teodoro Sampaio;2010;7895;6341;1554
2931509;Teofilândia;2010;21482;6692;14790
2931608;Teolândia;2010;14836;5068;9768
2931707;Terra Nova;2010;12803;11488;1315
2931806;Tremedal;2010;17029;3939;13090
2931905;Tucano;2010;52418;21958;30460
2932002;Uauá;2010;24294;10761;13533
2932101;Ubaíra;2010;19750;8822;10928
2932200;Ubaitaba;2010;20691;17598;3093
2932309;Ubatã;2010;25004;17951;7053
2932408;Uibaí;2010;13625;8311;5314
2932457;Umburanas;2010;17000;7510;9490
2932507;Una;2010;24110;15030;9080
2932606;Urandi;2010;16466;5939;10527
2932705;Uruçuca;2010;19837;15779;4058
2932804;Utinga;2010;18173;12810;5363
2932903;Valença;2010;88673;64368;24305
2933000;Valente;2010;24560;13487;11073
2933059;Várzea da Roça;2010;13786;6481;7305
2933109;Várzea do Poço;2010;8661;5789;2872
2933158;Várzea Nova;2010;13073;8553;4520
2933174;Varzedo;2010;9109;3364;5745
2933208;Vera Cruz;2010;37567;35244;2323
2933257;Vereda;2010;6800;1379;5421
2933307;Vitória da Conquista;2010;306866;274739;32127
2933406;Wagner;2010;8983;6482;2501
2933455;Wanderley;2010;12485;5878;6607
2933505;Wenceslau Guimarães;2010;22189;7511;14678
2933604;Xique-Xique;2010;45536;32541;12995
3100104;Abadia dos Dourados;2010;6704;4189;2515
3100203;Abaeté;2010;22690;19704;2986
3100302;Abre Campo;2010;13311;7281;6030
3100401;Acaiaca;2010;3920;2553;1367
3100500;Açucena;2010;10276;4805;5471
3100609;Água Boa;2010;15195;7035;8160
3100708;Água Comprida;2010;2025;1520;505
3100807;Aguanil;2010;4054;2345;1709
3100906;Águas Formosas;2010;18479;14318;4161
3101003;Águas Vermelhas;2010;12722;8941;3781
3101102;Aimorés;2010;24959;19700;5259
3101201;Aiuruoca;2010;6162;3123;3039
3101300;Alagoa;2010;2709;1110;1599
3101409;Albertina;2010;2913;2012;901
3101508;Além Paraíba;2010;34349;32067;2282
3101607;Alfenas;2010;73774;69176;4598
3101631;Alfredo Vasconcelos;2010;6075;4031;2044
3101706;Almenara;2010;38775;31750;7025
3101805;Alpercata;2010;7172;5660;1512
3101904;Alpinópolis;2010;18488;14990;3498
3102001;Alterosa;2010;13717;10002;3715
3102050;Alto Caparaó;2010;5297;3964;1333
3102100;Alto Rio Doce;2010;12159;5070;7089
3102209;Alvarenga;2010;4444;2119;2325
3102308;Alvinópolis;2010;15261;11433;3828
3102407;Alvorada de Minas;2010;3546;1450;2096
3102506;Amparo do Serra;2010;5053;2642;2411
3102605;Andradas;2010;37270;28016;9254
3102704;Cachoeira de Pajeú;2010;8959;4461;4498
3102803;Andrelândia;2010;12173;9810;2363
3102852;Angelândia;2010;8003;4036;3967
3102902;Antônio Carlos;2010;11114;7826;3288
3103009;Antônio Dias;2010;9565;4672;4893
3103108;Antônio Prado de Minas;2010;1671;1003;668
3103207;Araçaí;2010;2243;1783;460
3103306;Aracitaba;2010;2058;1641;417
3103405;Araçuaí;2010;36013;23435;12578
3103504;Araguari;2010;109801;102583;7218
3103603;Arantina;2010;2823;2633;190
3103702;Araponga;2010;8152;3041;5111
3103751;Araporã;2010;6144;5898;246
3103801;Arapuá;2010;2775;2088;687
3103900;Araújos;2010;7883;6812;1071
3104007;Araxá;2010;93672;92284;1388
3104106;Arceburgo;2010;9509;8179;1330
3104205;Arcos;2010;36597;33961;2636
3104304;Areado;2010;13731;11525;2206
3104403;Argirita;2010;2901;2192;709
3104452;Aricanduva;2010;4770;1695;3075
3104502;Arinos;2010;17674;10854;6820
3104601;Astolfo Dutra;2010;13049;11882;1167
3104700;Ataléia;2010;14455;7199;7256
3104809;Augusto de Lima;2010;4960;2924;2036
3104908;Baependi;2010;18307;13247;5060
3105004;Baldim;2010;7913;5067;2846
3105103;Bambuí;2010;22734;19325;3409
3105202;Bandeira;2010;4987;2377;2610
3105301;Bandeira do Sul;2010;5338;4870;468
3105400;Barão de Cocais;2010;28442;25786;2656
3105509;Barão de Monte Alto;2010;5720;4117;1603
3105608;Barbacena;2010;126284;115568;10716
3105707;Barra Longa;2010;6143;2313;3830
3105905;Barroso;2010;19599;18979;620
3106002;Bela Vista de Minas;2010;10004;9378;626
3106101;Belmiro Braga;2010;3403;1099;2304
3106200;Belo Horizonte;2010;2375151;2375151;0
3106309;Belo Oriente;2010;23397;19682;3715
3106408;Belo Vale;2010;7536;3295;4241
3106507;Berilo;2010;12300;3888;8412
3106606;Bertópolis;2010;4498;2731;1767
3106655;Berizal;2010;4370;2485;1885
3106705;Betim;2010;378089;375331;2758
3106804;Bias Fortes;2010;3793;1499;2294
3106903;Bicas;2010;13653;12957;696
3107000;Biquinhas;2010;2630;1639;991
3107109;Boa Esperança;2010;38516;32191;6325
3107208;Bocaina de Minas;2010;5007;2396;2611
3107307;Bocaiúva;2010;46654;36600;10054
3107406;Bom Despacho;2010;45624;42963;2661
3107505;Bom Jardim de Minas;2010;6501;5576;925
3107604;Bom Jesus da Penha;2010;3887;2825;1062
3107703;Bom Jesus do Amparo;2010;5491;2516;2975
3107802;Bom Jesus do Galho;2010;15364;10024;5340
3107901;Bom Repouso;2010;10457;5679;4778
3108008;Bom Sucesso;2010;17243;14194;3049
3108107;Bonfim;2010;6818;3332;3486
3108206;Bonfinópolis de Minas;2010;5865;4137;1728
3108255;Bonito de Minas;2010;9673;2209;7464
3108305;Borda da Mata;2010;17118;13718;3400
3108404;Botelhos;2010;14920;11366;3554
3108503;Botumirim;2010;6497;3470;3027
3108552;Brasilândia de Minas;2010;14226;12372;1854
3108602;Brasília de Minas;2010;31213;20675;10538
3108701;Brás Pires;2010;4637;2223;2414
3108800;Braúnas;2010;5030;1593;3437
3108909;Brazópolis;2010;14661;7891;6770
3109006;Brumadinho;2010;33973;28642;5331
3109105;Bueno Brandão;2010;10892;5674;5218
3109204;Buenópolis;2010;10292;7767;2525
3109253;Bugre;2010;3992;1531;2461
3109303;Buritis;2010;22737;16100;6637
3109402;Buritizeiro;2010;26922;23630;3292
3109451;Cabeceira Grande;2010;6453;5297;1156
3109501;Cabo Verde;2010;13823;7627;6196
3109600;Cachoeira da Prata;2010;3654;3528;126
3109709;Cachoeira de Minas;2010;11034;7064;3970
3109808;Cachoeira Dourada;2010;2505;2225;280
3109907;Caetanópolis;2010;10218;8389;1829
3110004;Caeté;2010;40750;35436;5314
3110103;Caiana;2010;4968;2618;2350
3110202;Cajuri;2010;4047;2096;1951
3110301;Caldas;2010;13633;7739;5894
3110400;Camacho;2010;3154;1458;1696
3110509;Camanducaia;2010;21080;15469;5611
3110608;Cambuí;2010;26488;22359;4129
3110707;Cambuquira;2010;12602;10457;2145
3110806;Campanário;2010;3564;2651;913
3110905;Campanha;2010;15433;13326;2107
3111002;Campestre;2010;20686;10959;9727
3111101;Campina Verde;2010;19324;14433;4891
3111150;Campo Azul;2010;3684;1551;2133
3111200;Campo Belo;2010;51544;48626;2918
3111309;Campo do Meio;2010;11476;10059;1417
3111408;Campo Florido;2010;6870;5208;1662
3111507;Campos Altos;2010;14206;12913;1293
3111606;Campos Gerais;2010;27600;19156;8444
3111705;Canaã;2010;4628;1859;2769
3111804;Canápolis;2010;11365;10180;1185
3111903;Cana Verde;2010;5589;4068;1521
3112000;Candeias;2010;14595;10206;4389
3112059;Cantagalo;2010;4195;2479;1716
3112109;Caparaó;2010;5209;2006;3203
3112208;Capela Nova;2010;4755;2132;2623
3112307;Capelinha;2010;34803;24753;10050
3112406;Capetinga;2010;7089;5919;1170
3112505;Capim Branco;2010;8881;8090;791
3112604;Capinópolis;2010;15290;14302;988
3112653;Capitão Andrade;2010;4925;3573;1352
3112703;Capitão Enéas;2010;14206;11520;2686
3112802;Capitólio;2010;8183;6502;1681
3112901;Caputira;2010;9030;3779;5251
3113008;Caraí;2010;22343;7191;15152
3113107;Caranaíba;2010;3288;1176;2112
3113206;Carandaí;2010;23346;18205;5141
3113305;Carangola;2010;32296;26059;6237
3113404;Caratinga;2010;85239;70474;14765
3113503;Carbonita;2010;9148;6738;2410
3113602;Careaçu;2010;6298;4702;1596
3113701;Carlos Chagas;2010;20069;12964;7105
3113800;Carmésia;2010;2446;1311;1135
3113909;Carmo da Cachoeira;2010;11836;8966;2870
3114006;Carmo da Mata;2010;10927;8610;2317
3114105;Carmo de Minas;2010;13750;10189;3561
3114204;Carmo do Cajuru;2010;20012;17340;2672
3114303;Carmo do Paranaíba;2010;29735;25200;4535
3114402;Carmo do Rio Claro;2010;20426;14362;6064
3114501;Carmópolis de Minas;2010;17048;11821;5227
3114550;Carneirinho;2010;9471;6975;2496
3114600;Carrancas;2010;3948;2612;1336
3114709;Carvalhópolis;2010;3341;2459;882
3114808;Carvalhos;2010;4556;2437;2119
3114907;Casa Grande;2010;2244;1122;1122
3115003;Cascalho Rico;2010;2857;1796;1061
3115102;Cássia;2010;17412;14221;3191
3115201;Conceição da Barra de Minas;2010;3954;2793;1161
3115300;Cataguases;2010;69757;66889;2868
3115359;Catas Altas;2010;4846;4240;606
3115409;Catas Altas da Noruega;2010;3462;1429;2033
3115458;Catuji;2010;6708;1692;5016
3115474;Catuti;2010;5102;2978;2124
3115508;Caxambu;2010;21705;21252;453
3115607;Cedro do Abaeté;2010;1210;1033;177
3115706;Central de Minas;2010;6772;5594;1178
3115805;Centralina;2010;10266;9314;952
3115904;Chácara;2010;2792;1903;889
3116001;Chalé;2010;5645;2784;2861
3116100;Chapada do Norte;2010;15189;5694;9495
3116159;Chapada Gaúcha;2010;10805;5761;5044
3116209;Chiador;2010;2785;1486;1299
3116308;Cipotânea;2010;6547;3014;3533
3116407;Claraval;2010;4542;2530;2012
3116506;Claro dos Poções;2010;7775;5251;2524
3116605;Cláudio;2010;25771;20917;4854
3116704;Coimbra;2010;7054;5156;1898
3116803;Coluna;2010;9024;3814;5210
3116902;Comendador Gomes;2010;2972;1508;1464
3117009;Comercinho;2010;8298;3547;4751
3117108;Conceição da Aparecida;2010;9820;6199;3621
3117207;Conceição das Pedras;2010;2749;1509;1240
3117306;Conceição das Alagoas;2010;23043;20880;2163
3117405;Conceição de Ipanema;2010;4456;1523;2933
3117504;Conceição do Mato Dentro;2010;17908;12269;5639
3117603;Conceição do Pará;2010;5158;2015;3143
3117702;Conceição do Rio Verde;2010;12949;11454;1495
3117801;Conceição dos Ouros;2010;10388;8123;2265
3117836;Cônego Marinho;2010;7101;1915;5186
3117876;Confins;2010;5936;5936;0
3117900;Congonhal;2010;10468;7755;2713
3118007;Congonhas;2010;48519;47236;1283
3118106;Congonhas do Norte;2010;4943;2598;2345
3118205;Conquista;2010;6526;5671;855
3118304;Conselheiro Lafaiete;2010;116512;111266;5246
3118403;Conselheiro Pena;2010;22242;17601;4641
3118502;Consolação;2010;1727;950;777
3118601;Contagem;2010;603442;601400;2042
3118700;Coqueiral;2010;9289;6588;2701
3118809;Coração de Jesus;2010;26033;14766;11267
3118908;Cordisburgo;2010;8667;5961;2706
3119005;Cordislândia;2010;3435;2757;678
3119104;Corinto;2010;23914;21194;2720
3119203;Coroaci;2010;10270;5181;5089
3119302;Coromandel;2010;27547;21665;5882
3119401;Coronel Fabriciano;2010;103694;102395;1299
3119500;Coronel Murta;2010;9117;6693;2424
3119609;Coronel Pacheco;2010;2983;2145;838
3119708;Coronel Xavier Chaves;2010;3301;1800;1501
3119807;Córrego Danta;2010;3391;2088;1303
3119906;Córrego do Bom Jesus;2010;3730;2049;1681
3119955;Córrego Fundo;2010;5790;4430;1360
3120003;Córrego Novo;2010;3127;2038;1089
3120102;Couto de Magalhães de Minas;2010;4204;3835;369
3120151;Crisólita;2010;6047;3489;2558
3120201;Cristais;2010;11286;8845;2441
3120300;Cristália;2010;5760;3033;2727
3120409;Cristiano Otoni;2010;5007;4156;851
3120508;Cristina;2010;10210;5955;4255
3120607;Crucilândia;2010;4757;2979;1778
3120706;Cruzeiro da Fortaleza;2010;3934;3361;573
3120805;Cruzília;2010;14591;13286;1305
3120839;Cuparaque;2010;4680;3885;795
3120870;Curral de Dentro;2010;6913;5837;1076
3120904;Curvelo;2010;74219;67382;6837
3121001;Datas;2010;5211;3088;2123
3121100;Delfim Moreira;2010;7971;3025;4946
3121209;Delfinópolis;2010;6830;4846;1984
3121258;Delta;2010;8089;7584;505
3121308;Descoberto;2010;4768;4069;699
3121407;Desterro de Entre Rios;2010;7002;3596;3406
3121506;Desterro do Melo;2010;3015;1390;1625
3121605;Diamantina;2010;45880;40064;5816
3121704;Diogo de Vasconcelos;2010;3848;1099;2749
3121803;Dionísio;2010;8739;7165;1574
3121902;Divinésia;2010;3293;2175;1118
3122009;Divino;2010;19133;10796;8337
3122108;Divino das Laranjeiras;2010;4937;4108;829
3122207;Divinolândia de Minas;2010;7024;5760;1264
3122306;Divinópolis;2010;213016;207516;5500
3122355;Divisa Alegre;2010;5884;5693;191
3122405;Divisa Nova;2010;5763;4659;1104
3122454;Divisópolis;2010;8974;6403;2571
3122470;Dom Bosco;2010;3814;2052;1762
3122504;Dom Cavati;2010;5209;4607;602
3122603;Dom Joaquim;2010;4535;2922;1613
3122702;Dom Silvério;2010;5196;4058;1138
3122801;Dom Viçoso;2010;2994;998;1996
3122900;Dona Eusébia;2010;6001;5133;868
3123007;Dores de Campos;2010;9299;8457;842
3123106;Dores de Guanhães;2010;5223;1622;3601
3123205;Dores do Indaiá;2010;13778;12614;1164
3123304;Dores do Turvo;2010;4462;2030;2432
3123403;Doresópolis;2010;1440;1132;308
3123502;Douradoquara;2010;1841;1233;608
3123528;Durandé;2010;7423;3547;3876
3123601;Elói Mendes;2010;25220;20374;4846
3123700;Engenheiro Caldas;2010;10280;8325;1955
3123809;Engenheiro Navarro;2010;7122;4750;2372
3123858;Entre Folhas;2010;5175;3889;1286
3123908;Entre Rios de Minas;2010;14242;9878;4364
3124005;Ervália;2010;17946;9470;8476
3124104;Esmeraldas;2010;60271;56215;4056
3124203;Espera Feliz;2010;22856;14174;8682
3124302;Espinosa;2010;31113;18023;13090
3124401;Espírito Santo do Dourado;2010;4429;1683;2746
3124500;Estiva;2010;10845;4899;5946
3124609;Estrela Dalva;2010;2470;1781;689
3124708;Estrela do Indaiá;2010;3516;2777;739
3124807;Estrela do Sul;2010;7446;6057;1389
3124906;Eugenópolis;2010;10540;7405;3135
3125002;Ewbank da Câmara;2010;3753;3459;294
3125101;Extrema;2010;28599;26023;2576
3125200;Fama;2010;2350;1515;835
3125309;Faria Lemos;2010;3376;2332;1044
3125408;Felício dos Santos;2010;5142;2229;2913
3125507;São Gonçalo do Rio Preto;2010;3056;1954;1102
3125606;Felisburgo;2010;6877;5088;1789
3125705;Felixlândia;2010;14121;10922;3199
3125804;Fernandes Tourinho;2010;3030;2016;1014
3125903;Ferros;2010;10837;5091;5746
3125952;Fervedouro;2010;10349;4764;5585
3126000;Florestal;2010;6600;5504;1096
3126109;Formiga;2010;65128;59487;5641
3126208;Formoso;2010;8177;5173;3004
3126307;Fortaleza de Minas;2010;4098;2911;1187
3126406;Fortuna de Minas;2010;2705;1865;840
3126505;Francisco Badaró;2010;10248;3191;7057
3126604;Francisco Dumont;2010;4863;3197;1666
3126703;Francisco Sá;2010;24912;14897;10015
3126752;Franciscópolis;2010;5800;2398;3402
3126802;Frei Gaspar;2010;5879;1916;3963
3126901;Frei Inocêncio;2010;8920;6764;2156
3126950;Frei Lagonegro;2010;3329;618;2711
3127008;Fronteira;2010;14041;13095;946
3127057;Fronteira dos Vales;2010;4687;3038;1649
3127073;Fruta de Leite;2010;5940;2036;3904
3127107;Frutal;2010;53468;46089;7379
3127206;Funilândia;2010;3855;2029;1826
3127305;Galiléia;2010;6951;5692;1259
3127339;Gameleiras;2010;5139;1413;3726
3127354;Glaucilândia;2010;2962;1048;1914
3127370;Goiabeira;2010;3053;2473;580
3127388;Goianá;2010;3659;2969;690
3127404;Gonçalves;2010;4220;1164;3056
3127503;Gonzaga;2010;5921;3237;2684
3127602;Gouveia;2010;11681;8229;3452
3127701;Governador Valadares;2010;263689;253300;10389
3127800;Grão Mogol;2010;15024;5391;9633
3127909;Grupiara;2010;1373;1173;200
3128006;Guanhães;2010;31262;25421;5841
3128105;Guapé;2010;13872;7174;6698
3128204;Guaraciaba;2010;10223;3218;7005
3128253;Guaraciama;2010;4718;3025;1693
3128303;Guaranésia;2010;18714;16836;1878
3128402;Guarani;2010;8678;6876;1802
3128501;Guarará;2010;3929;3487;442
3128600;Guarda-Mor;2010;6565;3688;2877
3128709;Guaxupé;2010;49430;46480;2950
3128808;Guidoval;2010;7206;5199;2007
3128907;Guimarânia;2010;7265;5924;1341
3129004;Guiricema;2010;8707;4225;4482
3129103;Gurinhatã;2010;6137;2692;3445
3129202;Heliodora;2010;6121;4430;1691
3129301;Iapu;2010;10315;7164;3151
3129400;Ibertioga;2010;5036;3457;1579
3129509;Ibiá;2010;23218;19646;3572
3129608;Ibiaí;2010;7839;6004;1835
3129657;Ibiracatu;2010;6155;3123;3032
3129707;Ibiraci;2010;12176;8208;3968
3129806;Ibirité;2010;158954;158590;364
3129905;Ibitiúra de Minas;2010;3382;2370;1012
3130002;Ibituruna;2010;2866;2485;381
3130051;Icaraí de Minas;2010;10746;2986;7760
3130101;Igarapé;2010;34851;32661;2190
3130200;Igaratinga;2010;9264;7677;1587
3130309;Iguatama;2010;8029;6715;1314
3130408;Ijaci;2010;5859;5605;254
3130507;Ilicínea;2010;11488;9096;2392
3130556;Imbé de Minas;2010;6424;2046;4378
3130606;Inconfidentes;2010;6908;3678;3230
3130655;Indaiabira;2010;7330;2742;4588
3130705;Indianópolis;2010;6190;4056;2134
3130804;Ingaí;2010;2629;1630;999
3130903;Inhapim;2010;24294;13993;10301
3131000;Inhaúma;2010;5760;4206;1554
3131109;Inimutaba;2010;6724;4743;1981
3131158;Ipaba;2010;16708;15028;1680
3131208;Ipanema;2010;18170;14200;3970
3131307;Ipatinga;2010;239468;236968;2500
3131406;Ipiaçu;2010;4107;3741;366
3131505;Ipuiúna;2010;9521;7448;2073
3131604;Iraí de Minas;2010;6467;5158;1309
3131703;Itabira;2010;109783;102316;7467
3131802;Itabirinha;2010;10692;8370;2322
3131901;Itabirito;2010;45449;43566;1883
3132008;Itacambira;2010;4988;1006;3982
3132107;Itacarambi;2010;17720;13799;3921
3132206;Itaguara;2010;12372;9526;2846
3132305;Itaipé;2010;11798;4943;6855
3132404;Itajubá;2010;90658;82764;7894
3132503;Itamarandiba;2010;32175;21988;10187
3132602;Itamarati de Minas;2010;4079;3210;869
3132701;Itambacuri;2010;22809;15119;7690
3132800;Itambé do Mato Dentro;2010;2283;908;1375
3132909;Itamogi;2010;10349;7759;2590
3133006;Itamonte;2010;14003;9612;4391
3133105;Itanhandu;2010;14175;11925;2250
3133204;Itanhomi;2010;11856;8646;3210
3133303;Itaobim;2010;21001;15779;5222
3133402;Itapagipe;2010;13656;9558;4098
3133501;Itapecerica;2010;21377;16503;4874
3133600;Itapeva;2010;8664;4511;4153
3133709;Itatiaiuçu;2010;9928;6221;3707
3133758;Itaú de Minas;2010;14945;14562;383
3133808;Itaúna;2010;85463;80451;5012
3133907;Itaverava;2010;5799;2565;3234
3134004;Itinga;2010;14407;6554;7853
3134103;Itueta;2010;5830;3299;2531
3134202;Ituiutaba;2010;97171;93125;4046
3134301;Itumirim;2010;6139;4704;1435
3134400;Iturama;2010;34456;32598;1858
3134509;Itutinga;2010;3913;2756;1157
3134608;Jaboticatubas;2010;17134;10740;6394
3134707;Jacinto;2010;12134;9197;2937
3134806;Jacuí;2010;7502;4570;2932
3134905;Jacutinga;2010;22772;19076;3696
3135001;Jaguaraçu;2010;2990;2138;852
3135050;Jaíba;2010;33587;17635;15952
3135076;Jampruca;2010;5067;3288;1779
3135100;Janaúba;2010;66803;60570;6233
3135209;Januária;2010;65463;41009;24454
3135308;Japaraíba;2010;3939;2550;1389
3135357;Japonvar;2010;8298;3050;5248
3135407;Jeceaba;2010;5395;2988;2407
3135456;Jenipapo de Minas;2010;7116;2883;4233
3135506;Jequeri;2010;12848;7293;5555
3135605;Jequitaí;2010;8005;5504;2501
3135704;Jequitibá;2010;5156;1963;3193
3135803;Jequitinhonha;2010;24131;17061;7070
3135902;Jesuânia;2010;4768;3094;1674
3136009;Joaíma;2010;14941;10273;4668
3136108;Joanésia;2010;5425;2062;3363
3136207;João Monlevade;2010;73610;73277;333
3136306;João Pinheiro;2010;45260;36761;8499
3136405;Joaquim Felício;2010;4305;2526;1779
3136504;Jordânia;2010;10324;7221;3103
3136520;José Gonçalves de Minas;2010;4553;1138;3415
3136553;José Raydan;2010;4376;1568;2808
3136579;Josenópolis;2010;4566;2444;2122
3136603;Nova União;2010;5555;2872;2683
3136652;Juatuba;2010;22202;21827;375
3136702;Juiz de Fora;2010;516247;510378;5869
3136801;Juramento;2010;4113;2272;1841
3136900;Juruaia;2010;9238;4514;4724
3136959;Juvenília;2010;5708;4392;1316
3137007;Ladainha;2010;16994;4310;12684
3137106;Lagamar;2010;7600;5128;2472
3137205;Lagoa da Prata;2010;45984;44938;1046
3137304;Lagoa dos Patos;2010;4225;3079;1146
3137403;Lagoa Dourada;2010;12256;6889;5367
3137502;Lagoa Formosa;2010;17161;12967;4194
3137536;Lagoa Grande;2010;8631;6408;2223
3137601;Lagoa Santa;2010;52520;48949;3571
3137700;Lajinha;2010;19609;12250;7359
3137809;Lambari;2010;19554;14036;5518
3137908;Lamim;2010;3452;1511;1941
3138005;Laranjal;2010;6465;4738;1727
3138104;Lassance;2010;6484;3882;2602
3138203;Lavras;2010;92200;87856;4344
3138302;Leandro Ferreira;2010;3205;2152;1053
3138351;Leme do Prado;2010;4804;1761;3043
3138401;Leopoldina;2010;51130;45704;5426
3138500;Liberdade;2010;5346;3869;1477
3138609;Lima Duarte;2010;16149;12363;3786
3138625;Limeira do Oeste;2010;6890;5017;1873
3138658;Lontra;2010;8397;5630;2767
3138674;Luisburgo;2010;6234;1836;4398
3138682;Luislândia;2010;6400;2989;3411
3138708;Luminárias;2010;5422;4166;1256
3138807;Luz;2010;17486;15709;1777
3138906;Machacalis;2010;6976;5749;1227
3139003;Machado;2010;38688;32068;6620
3139102;Madre de Deus de Minas;2010;4904;3732;1172
3139201;Malacacheta;2010;18776;11818;6958
3139250;Mamonas;2010;6321;2812;3509
3139300;Manga;2010;19813;13848;5965
3139409;Manhuaçu;2010;79574;64839;14735
3139508;Manhumirim;2010;21382;17043;4339
3139607;Mantena;2010;27111;21258;5853
3139706;Maravilhas;2010;7163;4896;2267
3139805;Mar de Espanha;2010;11749;10750;999
3139904;Maria da Fé;2010;14216;8383;5833
3140001;Mariana;2010;54219;47721;6498
3140100;Marilac;2010;4219;3423;796
3140159;Mário Campos;2010;13192;12458;734
3140209;Maripá de Minas;2010;2788;2266;522
3140308;Marliéria;2010;4012;2844;1168
3140407;Marmelópolis;2010;2968;1557;1411
3140506;Martinho Campos;2010;12611;11010;1601
3140530;Martins Soares;2010;7173;2927;4246
3140555;Mata Verde;2010;7874;6388;1486
3140605;Materlândia;2010;4595;2011;2584
3140704;Mateus Leme;2010;27856;24679;3177
3140803;Matias Barbosa;2010;13435;12944;491
3140852;Matias Cardoso;2010;9979;5136;4843
3140902;Matipó;2010;17639;13832;3807
3141009;Mato Verde;2010;12684;9459;3225
3141108;Matozinhos;2010;33955;30877;3078
3141207;Matutina;2010;3761;2693;1068
3141306;Medeiros;2010;3444;1948;1496
3141405;Medina;2010;21026;15092;5934
3141504;Mendes Pimentel;2010;6331;3455;2876
3141603;Mercês;2010;10368;7256;3112
3141702;Mesquita;2010;6069;3819;2250
3141801;Minas Novas;2010;30794;12584;18210
3141900;Minduri;2010;3840;3396;444
3142007;Mirabela;2010;13042;10028;3014
3142106;Miradouro;2010;10251;5671;4580
3142205;Miraí;2010;13808;10403;3405
3142254;Miravânia;2010;4549;1079;3470
3142304;Moeda;2010;4689;1789;2900
3142403;Moema;2010;7028;6040;988
3142502;Monjolos;2010;2360;1403;957
3142601;Monsenhor Paulo;2010;8161;6133;2028
3142700;Montalvânia;2010;15862;10239;5623
3142809;Monte Alegre de Minas;2010;19619;14506;5113
3142908;Monte Azul;2010;21994;12418;9576
3143005;Monte Belo;2010;13061;9058;4003
3143104;Monte Carmelo;2010;45772;40100;5672
3143153;Monte Formoso;2010;4656;1700;2956
3143203;Monte Santo de Minas;2010;21234;16423;4811
3143302;Montes Claros;2010;361915;344427;17488
3143401;Monte Sião;2010;21203;16268;4935
3143450;Montezuma;2010;7464;3079;4385
3143500;Morada Nova de Minas;2010;8255;6457;1798
3143609;Morro da Garça;2010;2660;1522;1138
3143708;Morro do Pilar;2010;3399;2581;818
3143807;Munhoz;2010;6257;3319;2938
3143906;Muriaé;2010;100765;93225;7540
3144003;Mutum;2010;26661;13790;12871
3144102;Muzambinho;2010;20430;15729;4701
3144201;Nacip Raydan;2010;3154;1979;1175
3144300;Nanuque;2010;40834;36789;4045
3144359;Naque;2010;6341;5961;380
3144375;Natalândia;2010;3280;2471;809
3144409;Natércia;2010;4658;2760;1898
3144508;Nazareno;2010;7954;6046;1908
3144607;Nepomuceno;2010;25733;19936;5797
3144656;Ninheira;2010;9815;2623;7192
3144672;Nova Belém;2010;3732;1348;2384
3144706;Nova Era;2010;17528;15420;2108
3144805;Nova Lima;2010;80998;79232;1766
3144904;Nova Módica;2010;3790;2328;1462
3145000;Nova Ponte;2010;12812;10991;1821
3145059;Nova Porteirinha;2010;7398;4069;3329
3145109;Nova Resende;2010;15374;8858;6516
3145208;Nova Serrana;2010;73699;69695;4004
3145307;Novo Cruzeiro;2010;30725;10522;20203
3145356;Novo Oriente de Minas;2010;10339;4421;5918
3145372;Novorizonte;2010;4963;1717;3246
3145406;Olaria;2010;1976;917;1059
3145455;Olhos-d'Água;2010;5267;2866;2401
3145505;Olímpio Noronha;2010;2533;2249;284
3145604;Oliveira;2010;39466;35185;4281
3145703;Oliveira Fortes;2010;2123;1177;946
3145802;Onça de Pitangui;2010;3055;1519;1536
3145851;Oratórios;2010;4493;3241;1252
3145877;Orizânia;2010;7284;2221;5063
3145901;Ouro Branco;2010;35268;31609;3659
3146008;Ouro Fino;2010;31568;23763;7805
3146107;Ouro Preto;2010;70281;61120;9161
3146206;Ouro Verde de Minas;2010;6016;3629;2387
3146255;Padre Carvalho;2010;5834;3462;2372
3146305;Padre Paraíso;2010;18849;11520;7329
3146404;Paineiras;2010;4631;3598;1033
3146503;Pains;2010;8014;6608;1406
3146552;Pai Pedro;2010;5934;1749;4185
3146602;Paiva;2010;1558;1219;339
3146701;Palma;2010;6545;5123;1422
3146750;Palmópolis;2010;6931;4488;2443
3146909;Papagaios;2010;14175;11920;2255
3147006;Paracatu;2010;84718;73772;10946
3147105;Pará de Minas;2010;84215;79599;4616
3147204;Paraguaçu;2010;20245;16679;3566
3147303;Paraisópolis;2010;19379;16058;3321
3147402;Paraopeba;2010;22563;19663;2900
3147501;Passabém;2010;1766;1012;754
3147600;Passa Quatro;2010;15582;11985;3597
3147709;Passa Tempo;2010;8197;6385;1812
3147808;Passa Vinte;2010;2079;1305;774
3147907;Passos;2010;106290;100859;5431
3147956;Patis;2010;5579;2301;3278
3148004;Patos de Minas;2010;138710;127724;10986
3148103;Patrocínio;2010;82471;72758;9713
3148202;Patrocínio do Muriaé;2010;5287;4308;979
3148301;Paula Cândido;2010;9271;4936;4335
3148400;Paulistas;2010;4918;2303;2615
3148509;Pavão;2010;8589;5204;3385
3148608;Peçanha;2010;17260;9097;8163
3148707;Pedra Azul;2010;23839;21006;2833
3148756;Pedra Bonita;2010;6673;1807;4866
3148806;Pedra do Anta;2010;3365;2192;1173
3148905;Pedra do Indaiá;2010;3875;2053;1822
3149002;Pedra Dourada;2010;2191;1301;890
3149101;Pedralva;2010;11467;5563;5904
3149150;Pedras de Maria da Cruz;2010;10315;6328;3987
3149200;Pedrinópolis;2010;3490;2927;563
3149309;Pedro Leopoldo;2010;58740;49991;8749
3149408;Pedro Teixeira;2010;1785;965;820
3149507;Pequeri;2010;3165;2916;249
3149606;Pequi;2010;4076;2953;1123
3149705;Perdigão;2010;8912;7862;1050
3149804;Perdizes;2010;14404;9935;4469
3149903;Perdões;2010;20087;17776;2311
3149952;Periquito;2010;7036;5289;1747
3150000;Pescador;2010;4128;3259;869
3150109;Piau;2010;2841;1670;1171
3150158;Piedade de Caratinga;2010;7110;4602;2508
3150208;Piedade de Ponte Nova;2010;4062;3178;884
3150307;Piedade do Rio Grande;2010;4709;3477;1232
3150406;Piedade dos Gerais;2010;4640;2122;2518
3150505;Pimenta;2010;8236;6945;1291
3150539;Pingo d'Água;2010;4420;4035;385
3150570;Pintópolis;2010;7211;2532;4679
3150604;Piracema;2010;6406;3034;3372
3150703;Pirajuba;2010;4656;4131;525
3150802;Piranga;2010;17232;5958;11274
3150901;Piranguçu;2010;5217;1772;3445
3151008;Piranguinho;2010;8016;4953;3063
3151107;Pirapetinga;2010;10364;9102;1262
3151206;Pirapora;2010;53368;52385;983
3151305;Piraúba;2010;10862;8814;2048
3151404;Pitangui;2010;25311;22624;2687
3151503;Piumhi;2010;31883;28564;3319
3151602;Planura;2010;10384;10091;293
3151701;Poço Fundo;2010;15959;9281;6678
3151800;Poços de Caldas;2010;152435;148722;3713
3151909;Pocrane;2010;8986;5399;3587
3152006;Pompéu;2010;29105;25740;3365
3152105;Ponte Nova;2010;57390;51185;6205
3152131;Ponto Chique;2010;3966;2581;1385
3152170;Ponto dos Volantes;2010;11345;4031;7314
3152204;Porteirinha;2010;37627;19338;18289
3152303;Porto Firme;2010;10417;4831;5586
3152402;Poté;2010;15667;9337;6330
3152501;Pouso Alegre;2010;130615;119590;11025
3152600;Pouso Alto;2010;6213;3658;2555
3152709;Prados;2010;8391;5936;2455
3152808;Prata;2010;25802;19381;6421
3152907;Pratápolis;2010;8807;7793;1014
3153004;Pratinha;2010;3265;1759;1506
3153103;Presidente Bernardes;2010;5537;1642;3895
3153202;Presidente Juscelino;2010;3908;1846;2062
3153301;Presidente Kubitschek;2010;2959;2017;942
3153400;Presidente Olegário;2010;18577;13150;5427
3153509;Alto Jequitibá;2010;8318;4300;4018
3153608;Prudente de Morais;2010;9573;9199;374
3153707;Quartel Geral;2010;3303;2766;537
3153806;Queluzito;2010;1861;847;1014
3153905;Raposos;2010;15342;14552;790
3154002;Raul Soares;2010;23818;15484;8334
3154101;Recreio;2010;10299;9073;1226
3154150;Reduto;2010;6569;3648;2921
3154200;Resende Costa;2010;10913;8776;2137
3154309;Resplendor;2010;17089;12832;4257
3154408;Ressaquinha;2010;4711;3023;1688
3154457;Riachinho;2010;8007;4435;3572
3154507;Riacho dos Machados;2010;9360;4499;4861
3154606;Ribeirão das Neves;2010;296317;294158;2159
3154705;Ribeirão Vermelho;2010;3826;3543;283
3154804;Rio Acima;2010;9090;7944;1146
3154903;Rio Casca;2010;14201;11334;2867
3155009;Rio Doce;2010;2465;1653;812
3155108;Rio do Prado;2010;5217;2730;2487
3155207;Rio Espera;2010;6070;2403;3667
3155306;Rio Manso;2010;5276;2810;2466
3155405;Rio Novo;2010;8712;7539;1173
3155504;Rio Paranaíba;2010;11885;7288;4597
3155603;Rio Pardo de Minas;2010;29099;11692;17407
3155702;Rio Piracicaba;2010;14149;11272;2877
3155801;Rio Pomba;2010;17110;14454;2656
3155900;Rio Preto;2010;5292;4451;841
3156007;Rio Vermelho;2010;13645;5481;8164
3156106;Ritápolis;2010;4925;3407;1518
3156205;Rochedo de Minas;2010;2116;1914;202
3156304;Rodeiro;2010;6867;5556;1311
3156403;Romaria;2010;3596;2715;881
3156452;Rosário da Limeira;2010;4247;2296;1951
3156502;Rubelita;2010;7772;2516;5256
3156601;Rubim;2010;9919;7703;2216
3156700;Sabará;2010;126269;123084;3185
3156809;Sabinópolis;2010;15704;10136;5568
3156908;Sacramento;2010;23896;19275;4621
3157005;Salinas;2010;39178;30716;8462
3157104;Salto da Divisa;2010;6859;5749;1110
3157203;Santa Bárbara;2010;27876;24794;3082
3157252;Santa Bárbara do Leste;2010;7682;3974;3708
3157278;Santa Bárbara do Monte Verde;2010;2788;1610;1178
3157302;Santa Bárbara do Tugúrio;2010;4570;2187;2383
3157336;Santa Cruz de Minas;2010;7865;7865;0
3157377;Santa Cruz de Salinas;2010;4397;1151;3246
3157401;Santa Cruz do Escalvado;2010;4992;1730;3262
3157500;Santa Efigênia de Minas;2010;4600;3053;1547
3157609;Santa Fé de Minas;2010;3968;2291;1677
3157658;Santa Helena de Minas;2010;6055;3769;2286
3157708;Santa Juliana;2010;11337;9795;1542
3157807;Santa Luzia;2010;202942;202378;564
3157906;Santa Margarida;2010;15011;7626;7385
3158003;Santa Maria de Itabira;2010;10552;6336;4216
3158102;Santa Maria do Salto;2010;5284;3742;1542
3158201;Santa Maria do Suaçuí;2010;14395;10722;3673
3158300;Santana da Vargem;2010;7231;5278;1953
3158409;Santana de Cataguases;2010;3622;2917;705
3158508;Santana de Pirapama;2010;8009;3331;4678
3158607;Santana do Deserto;2010;3860;1404;2456
3158706;Santana do Garambéu;2010;2234;1652;582
3158805;Santana do Jacaré;2010;4607;4428;179
3158904;Santana do Manhuaçu;2010;8582;4142;4440
3158953;Santana do Paraíso;2010;27265;25251;2014
3159001;Santana do Riacho;2010;4023;2279;1744
3159100;Santana dos Montes;2010;3822;2292;1530
3159209;Santa Rita de Caldas;2010;9027;5655;3372
3159308;Santa Rita de Jacutinga;2010;4993;3754;1239
3159357;Santa Rita de Minas;2010;6547;4774;1773
3159407;Santa Rita de Ibitipoca;2010;3583;2233;1350
3159506;Santa Rita do Itueto;2010;5697;2310;3387
3159605;Santa Rita do Sapucaí;2010;37754;32458;5296
3159704;Santa Rosa da Serra;2010;3224;1973;1251
3159803;Santa Vitória;2010;18138;14926;3212
3159902;Santo Antônio do Amparo;2010;17345;15187;2158
3160009;Santo Antônio do Aventureiro;2010;3538;2377;1161
3160108;Santo Antônio do Grama;2010;4085;3365;720
3160207;Santo Antônio do Itambé;2010;4135;1230;2905
3160306;Santo Antônio do Jacinto;2010;11775;6358;5417
3160405;Santo Antônio do Monte;2010;25975;22193;3782
3160454;Santo Antônio do Retiro;2010;6955;1590;5365
3160504;Santo Antônio do Rio Abaixo;2010;1777;888;889
3160603;Santo Hipólito;2010;3238;2249;989
3160702;Santos Dumont;2010;46284;41320;4964
3160801;São Bento Abade;2010;4577;4238;339
3160900;São Brás do Suaçuí;2010;3513;3129;384
3160959;São Domingos das Dores;2010;5408;2578;2830
3161007;São Domingos do Prata;2010;17357;10505;6852
3161056;São Félix de Minas;2010;3382;2089;1293
3161106;São Francisco;2010;53828;34204;19624
3161205;São Francisco de Paula;2010;6483;4651;1832
3161304;São Francisco de Sales;2010;5776;4332;1444
3161403;São Francisco do Glória;2010;5178;3132;2046
3161502;São Geraldo;2010;10263;7270;2993
3161601;São Geraldo da Piedade;2010;4389;1054;3335
3161650;São Geraldo do Baixio;2010;3486;2440;1046
3161700;São Gonçalo do Abaeté;2010;6264;4168;2096
3161809;São Gonçalo do Pará;2010;10398;7960;2438
3161908;São Gonçalo do Rio Abaixo;2010;9777;4649;5128
3162005;São Gonçalo do Sapucaí;2010;23906;19742;4164
3162104;São Gotardo;2010;31819;30061;1758
3162203;São João Batista do Glória;2010;6887;5607;1280
3162252;São João da Lagoa;2010;4656;2435;2221
3162302;São João da Mata;2010;2731;1752;979
3162401;São João da Ponte;2010;25358;8656;16702
3162450;São João das Missões;2010;11715;2446;9269
3162500;São João del Rei;2010;84469;79857;4612
3162559;São João do Manhuaçu;2010;10245;4806;5439
3162575;São João do Manteninha;2010;5188;2905;2283
3162609;São João do Oriente;2010;7874;6325;1549
3162658;São João do Pacuí;2010;4060;1921;2139
3162708;São João do Paraíso;2010;22319;10235;12084
3162807;São João Evangelista;2010;15553;10108;5445
3162906;São João Nepomuceno;2010;25057;23835;1222
3162922;São Joaquim de Bicas;2010;25537;18599;6938
3162948;São José da Barra;2010;6778;4894;1884
3162955;São José da Lapa;2010;19799;11400;8399
3163003;São José da Safira;2010;4075;2945;1130
3163102;São José da Varginha;2010;4198;2372;1826
3163201;São José do Alegre;2010;3996;2901;1095
3163300;São José do Divino;2010;3834;2725;1109
3163409;São José do Goiabal;2010;5636;3689;1947
3163508;São José do Jacuri;2010;6553;2006;4547
3163607;São José do Mantimento;2010;2592;1449;1143
3163706;São Lourenço;2010;41657;41657;0
3163805;São Miguel do Anta;2010;6760;3746;3014
3163904;São Pedro da União;2010;5040;2781;2259
3164001;São Pedro dos Ferros;2010;8356;6783;1573
3164100;São Pedro do Suaçuí;2010;5570;2302;3268
3164209;São Romão;2010;10276;6469;3807
3164308;São Roque de Minas;2010;6686;4222;2464
3164407;São Sebastião da Bela Vista;2010;4948;2889;2059
3164431;São Sebastião da Vargem Alegre;2010;2798;1603;1195
3164472;São Sebastião do Anta;2010;5739;4210;1529
3164506;São Sebastião do Maranhão;2010;10647;3250;7397
3164605;São Sebastião do Oeste;2010;5805;3247;2558
3164704;São Sebastião do Paraíso;2010;64980;59953;5027
3164803;São Sebastião do Rio Preto;2010;1613;876;737
3164902;São Sebastião do Rio Verde;2010;2110;1321;789
3165008;São Tiago;2010;10561;8471;2090
3165107;São Tomás de Aquino;2010;7093;5522;1571
3165206;São Thomé das Letras;2010;6655;3857;2798
3165305;São Vicente de Minas;2010;7008;5940;1068
3165404;Sapucaí-Mirim;2010;6241;3783;2458
3165503;Sardoá;2010;5594;1997;3597
3165537;Sarzedo;2010;25814;25526;288
3165552;Setubinha;2010;10885;2802;8083
3165560;Sem-Peixe;2010;2847;1507;1340
3165578;Senador Amaral;2010;5219;3101;2118
3165602;Senador Cortes;2010;1988;1512;476
3165701;Senador Firmino;2010;7230;4683;2547
3165800;Senador José Bento;2010;1868;683;1185
3165909;Senador Modestino Gonçalves;2010;4574;1803;2771
3166006;Senhora de Oliveira;2010;5683;3256;2427
3166105;Senhora do Porto;2010;3497;1286;2211
3166204;Senhora dos Remédios;2010;10196;3430;6766
3166303;Sericita;2010;7128;3718;3410
3166402;Seritinga;2010;1789;1483;306
3166501;Serra Azul de Minas;2010;4220;1710;2510
3166600;Serra da Saudade;2010;815;527;288
3166709;Serra dos Aimorés;2010;8412;6774;1638
3166808;Serra do Salitre;2010;10549;7755;2794
3166907;Serrania;2010;7542;6576;966
3166956;Serranópolis de Minas;2010;4425;1728;2697
3167004;Serranos;2010;1995;1543;452
3167103;Serro;2010;20835;12895;7940
3167202;Sete Lagoas;2010;214152;208956;5196
3167301;Silveirânia;2010;2192;1429;763
3167400;Silvianópolis;2010;6027;3645;2382
3167509;Simão Pereira;2010;2537;1496;1041
3167608;Simonésia;2010;18298;7096;11202
3167707;Sobrália;2010;5830;4129;1701
3167806;Soledade de Minas;2010;5676;3761;1915
3167905;Tabuleiro;2010;4079;2701;1378
3168002;Taiobeiras;2010;30917;25060;5857
3168051;Taparuba;2010;3137;1405;1732
3168101;Tapira;2010;4112;2744;1368
3168200;Tapiraí;2010;1873;1085;788
3168309;Taquaraçu de Minas;2010;3794;1755;2039
3168408;Tarumirim;2010;14293;8019;6274
3168507;Teixeiras;2010;11355;7623;3732
3168606;Teófilo Otoni;2010;134745;110076;24669
3168705;Timóteo;2010;81243;81139;104
3168804;Tiradentes;2010;6961;5376;1585
3168903;Tiros;2010;6906;4815;2091
3169000;Tocantins;2010;15823;12909;2914
3169059;Tocos do Moji;2010;3950;1018;2932
3169109;Toledo;2010;5764;2190;3574
3169208;Tombos;2010;9537;7648;1889
3169307;Três Corações;2010;72765;65826;6939
3169356;Três Marias;2010;28318;26840;1478
3169406;Três Pontas;2010;53860;46280;7580
3169505;Tumiritinga;2010;6293;4323;1970
3169604;Tupaciguara;2010;24188;22042;2146
3169703;Turmalina;2010;18055;12926;5129
3169802;Turvolândia;2010;4658;2910;1748
3169901;Ubá;2010;101519;97636;3883
3170008;Ubaí;2010;11681;5665;6016
3170057;Ubaporanga;2010;12040;6434;5606
3170107;Uberaba;2010;295988;289376;6612
3170206;Uberlândia;2010;604013;587266;16747
3170305;Umburatiba;2010;2705;1558;1147
3170404;Unaí;2010;77565;62329;15236
3170438;União de Minas;2010;4418;2726;1692
3170479;Uruana de Minas;2010;3235;1818;1417
3170503;Urucânia;2010;10291;7946;2345
3170529;Urucuia;2010;13604;6165;7439
3170578;Vargem Alegre;2010;6461;4771;1690
3170602;Vargem Bonita;2010;2163;1142;1021
3170651;Vargem Grande do Rio Pardo;2010;4733;2421;2312
3170701;Varginha;2010;123081;119061;4020
3170750;Varjão de Minas;2010;6054;5021;1033
3170800;Várzea da Palma;2010;35809;31313;4496
3170909;Varzelândia;2010;19116;8904;10212
3171006;Vazante;2010;19723;15919;3804
3171030;Verdelândia;2010;8346;4762;3584
3171071;Veredinha;2010;5549;3769;1780
3171105;Veríssimo;2010;3483;2037;1446
3171154;Vermelho Novo;2010;4689;1852;2837
3171204;Vespasiano;2010;104527;104527;0
3171303;Viçosa;2010;72220;67305;4915
3171402;Vieiras;2010;3731;1853;1878
3171501;Mathias Lobato;2010;3370;3060;310
3171600;Virgem da Lapa;2010;13619;6840;6779
3171709;Virgínia;2010;8623;3936;4687
3171808;Virginópolis;2010;10572;6208;4364
3171907;Virgolândia;2010;5658;3402;2256
3172004;Visconde do Rio Branco;2010;37942;31380;6562
3172103;Volta Grande;2010;5070;3802;1268
3172202;Wenceslau Braz;2010;2553;1270;1283
3200102;Afonso Cláudio;2010;31091;15855;15236
3200136;Águia Branca;2010;9519;3051;6468
3200169;Água Doce do Norte;2010;11771;6699;5072
3200201;Alegre;2010;30768;21512;9256
3200300;Alfredo Chaves;2010;13955;6545;7410
3200359;Alto Rio Novo;2010;7317;4256;3061
3200409;Anchieta;2010;23902;18161;5741
3200508;Apiacá;2010;7512;5211;2301
3200607;Aracruz;2010;81832;71451;10381
3200706;Atílio Vivacqua;2010;9850;6116;3734
3200805;Baixo Guandu;2010;29081;22512;6569
3200904;Barra de São Francisco;2010;40649;26357;14292
3201001;Boa Esperança;2010;14199;10239;3960
3201100;Bom Jesus do Norte;2010;9476;8699;777
3201159;Brejetuba;2010;11915;3416;8499
3201209;Cachoeiro de Itapemirim;2010;189889;173589;16300
3201308;Cariacica;2010;348738;337643;11095
3201407;Castelo;2010;34747;21817;12930
3201506;Colatina;2010;111788;98395;13393
3201605;Conceição da Barra;2010;28449;22575;5874
3201704;Conceição do Castelo;2010;11681;5898;5783
3201803;Divino de São Lourenço;2010;4516;1742;2774
3201902;Domingos Martins;2010;31847;7741;24106
3202009;Dores do Rio Preto;2010;6397;3547;2850
3202108;Ecoporanga;2010;23212;14779;8433
3202207;Fundão;2010;17025;14378;2647
3202256;Governador Lindenberg;2010;10869;4226;6643
3202306;Guaçuí;2010;27851;22401;5450
3202405;Guarapari;2010;105286;100528;4758
3202454;Ibatiba;2010;22366;13378;8988
3202504;Ibiraçu;2010;11178;8466;2712
3202553;Ibitirama;2010;8957;3177;5780
3202603;Iconha;2010;12523;7277;5246
3202652;Irupi;2010;11723;4437;7286
3202702;Itaguaçu;2010;14134;8054;6080
3202801;Itapemirim;2010;30988;19330;11658
3202900;Itarana;2010;10881;4095;6786
3203007;Iúna;2010;27328;15620;11708
3203056;Jaguaré;2010;24678;15033;9645
3203106;Jerônimo Monteiro;2010;10879;8535;2344
3203130;João Neiva;2010;15809;12752;3057
3203163;Laranja da Terra;2010;10826;3528;7298
3203205;Linhares;2010;141306;121567;19739
3203304;Mantenópolis;2010;13612;8647;4965
3203320;Marataízes;2010;34140;27614;6526
3203346;Marechal Floriano;2010;14262;7421;6841
3203353;Marilândia;2010;11107;5648;5459
3203403;Mimoso do Sul;2010;25902;16232;9670
3203502;Montanha;2010;17849;13522;4327
3203601;Mucurici;2010;5655;3590;2065
3203700;Muniz Freire;2010;18397;8670;9727
3203809;Muqui;2010;14396;9309;5087
3203908;Nova Venécia;2010;46031;30831;15200
3204005;Pancas;2010;21548;10099;11449
3204054;Pedro Canário;2010;23794;22053;1741
3204104;Pinheiros;2010;23895;18718;5177
3204203;Piúma;2010;18123;17449;674
3204252;Ponto Belo;2010;6979;5588;1391
3204302;Presidente Kennedy;2010;10314;3440;6874
3204351;Rio Bananal;2010;17530;6788;10742
3204401;Rio Novo do Sul;2010;11325;5946;5379
3204500;Santa Leopoldina;2010;12240;2752;9488
3204559;Santa Maria de Jetibá;2010;34176;11797;22379
3204609;Santa Teresa;2010;21823;11768;10055
3204658;São Domingos do Norte;2010;8001;3437;4564
3204708;São Gabriel da Palha;2010;31859;24325;7534
3204807;São José do Calçado;2010;10408;8350;2058
3204906;São Mateus;2010;109028;84541;24487
3204955;São Roque do Canaã;2010;11273;5584;5689
3205002;Serra;2010;409267;406411;2856
3205010;Sooretama;2010;23843;16873;6970
3205036;Vargem Alta;2010;19130;6722;12408
3205069;Venda Nova do Imigrante;2010;20447;14809;5638
3205101;Viana;2010;65001;59632;5369
3205150;Vila Pavão;2010;8672;2998;5674
3205176;Vila Valério;2010;13830;5042;8788
3205200;Vila Velha;2010;414586;412575;2011
3205309;Vitória;2010;327801;327801;0
3300100;Angra dos Reis;2010;169511;163199;6312
3300159;Aperibé;2010;10213;8878;1335
3300209;Araruama;2010;112008;106486;5522
3300225;Areal;2010;11423;9923;1500
3300233;Armação dos Búzios;2010;27560;27560;0
3300258;Arraial do Cabo;2010;27715;27715;0
3300308;Barra do Piraí;2010;94778;91902;2876
3300407;Barra Mansa;2010;177813;176230;1583
3300456;Belford Roxo;2010;469332;469332;0
3300506;Bom Jardim;2010;25333;15266;10067
3300605;Bom Jesus do Itabapoana;2010;35411;29927;5484
3300704;Cabo Frio;2010;186227;140486;45741
3300803;Cachoeiras de Macacu;2010;54273;46944;7329
3300902;Cambuci;2010;14827;11292;3535
3300936;Carapebus;2010;13359;10542;2817
3300951;Comendador Levy Gasparian;2010;8180;7862;318
3301009;Campos dos Goytacazes;2010;463731;418725;45006
3301108;Cantagalo;2010;19830;14022;5808
3301157;Cardoso Moreira;2010;12600;8757;3843
3301207;Carmo;2010;17434;13470;3964
3301306;Casimiro de Abreu;2010;35347;28521;6826
3301405;Conceição de Macabu;2010;21211;18337;2874
3301504;Cordeiro;2010;20430;19862;568
3301603;Duas Barras;2010;10930;7736;3194
3301702;Duque de Caxias;2010;855048;852138;2910
3301801;Engenheiro Paulo de Frontin;2010;13237;9523;3714
3301850;Guapimirim;2010;51483;49792;1691
3301876;Iguaba Grande;2010;22851;22851;0
3301900;Itaboraí;2010;218008;215327;2681
3302007;Itaguaí;2010;109091;104209;4882
3302056;Italva;2010;14063;10242;3821
3302106;Itaocara;2010;22899;17326;5573
3302205;Itaperuna;2010;95841;88368;7473
3302254;Itatiaia;2010;28783;27813;970
3302270;Japeri;2010;95492;95492;0
3302304;Laje do Muriaé;2010;7487;5637;1850
3302403;Macaé;2010;206728;202859;3869
3302452;Macuco;2010;5269;4593;676
3302502;Magé;2010;227322;215236;12086
3302601;Mangaratiba;2010;36456;32120;4336
3302700;Maricá;2010;127461;125401;2060
3302809;Mendes;2010;17935;17701;234
3302858;Mesquita;2010;168376;168376;0
3302908;Miguel Pereira;2010;24642;21501;3141
3303005;Miracema;2010;26843;24741;2102
3303104;Natividade;2010;15082;12046;3036
3303203;Nilópolis;2010;157425;157425;0
3303302;Niterói;2010;487562;487562;0
3303401;Nova Friburgo;2010;182082;159372;22710
3303500;Nova Iguaçu;2010;796257;787563;8694
3303609;Paracambi;2010;47124;41722;5402
3303708;Paraíba do Sul;2010;41084;36154;4930
3303807;Paraty;2010;37533;27689;9844
3303856;Paty do Alferes;2010;26359;18585;7774
3303906;Petrópolis;2010;295917;281286;14631
3303955;Pinheiral;2010;22719;20411;2308
3304003;Piraí;2010;26314;20836;5478
3304102;Porciúncula;2010;17760;13890;3870
3304110;Porto Real;2010;16592;16497;95
3304128;Quatis;2010;12793;12029;764
3304144;Queimados;2010;137962;137962;0
3304151;Quissamã;2010;20242;12996;7246
3304201;Resende;2010;119769;112331;7438
3304300;Rio Bonito;2010;55551;41259;14292
3304409;Rio Claro;2010;17425;13769;3656
3304508;Rio das Flores;2010;8561;5959;2602
3304524;Rio das Ostras;2010;105676;99905;5771
3304557;Rio de Janeiro;2010;6320446;6320446;0
3304607;Santa Maria Madalena;2010;10321;5932;4389
3304706;Santo Antônio de Pádua;2010;40589;31100;9489
3304755;São Francisco de Itabapoana;2010;41354;21092;20262
3304805;São Fidélis;2010;37543;29679;7864
3304904;São Gonçalo;2010;999728;998999;729
3305000;São João da Barra;2010;32747;25693;7054
3305109;São João de Meriti;2010;458673;458673;0
3305133;São José de Ubá;2010;7003;3098;3905
3305158;São José do Vale do Rio Preto;2010;20251;9007;11244
3305208;São Pedro da Aldeia;2010;87875;82148;5727
3305307;São Sebastião do Alto;2010;8895;4612;4283
3305406;Sapucaia;2010;17525;13273;4252
3305505;Saquarema;2010;74234;70456;3778
3305554;Seropédica;2010;78186;64285;13901
3305604;Silva Jardim;2010;21349;16121;5228
3305703;Sumidouro;2010;14900;5440;9460
3305752;Tanguá;2010;30732;27428;3304
3305802;Teresópolis;2010;163746;146231;17515
3305901;Trajano de Moraes;2010;10289;4780;5509
3306008;Três Rios;2010;77432;75165;2267
3306107;Valença;2010;71843;62224;9619
3306156;Varre-Sai;2010;9475;5790;3685
3306206;Vassouras;2010;34410;23199;11211
3306305;Volta Redonda;2010;257803;257686;117
3500105;Adamantina;2010;33797;31948;1849
3500204;Adolfo;2010;3557;3200;357
3500303;Aguaí;2010;32148;29001;3147
3500402;Águas da Prata;2010;7584;6771;813
3500501;Águas de Lindóia;2010;17266;17111;155
3500550;Águas de Santa Bárbara;2010;5601;4259;1342
3500600;Águas de São Pedro;2010;2707;2707;0
3500709;Agudos;2010;34524;32993;1531
3500758;Alambari;2010;4884;3672;1212
3500808;Alfredo Marcondes;2010;3891;3255;636
3500907;Altair;2010;3815;3022;793
3501004;Altinópolis;2010;15607;13636;1971
3501103;Alto Alegre;2010;4102;3234;868
3501152;Alumínio;2010;16839;14123;2716
3501202;Álvares Florence;2010;3897;2648;1249
3501301;Álvares Machado;2010;23513;21183;2330
3501400;Álvaro de Carvalho;2010;4650;2952;1698
3501509;Alvinlândia;2010;3000;2693;307
3501608;Americana;2010;210638;209654;984
3501707;Américo Brasiliense;2010;34478;34217;261
3501806;Américo de Campos;2010;5706;4788;918
3501905;Amparo;2010;65829;51811;14018
3502002;Analândia;2010;4293;3408;885
3502101;Andradina;2010;55334;51649;3685
3502200;Angatuba;2010;22210;15953;6257
3502309;Anhembi;2010;5653;4271;1382
3502408;Anhumas;2010;3738;3059;679
3502507;Aparecida;2010;35007;34498;509
3502606;Aparecida d'Oeste;2010;4450;3645;805
3502705;Apiaí;2010;25191;18218;6973
3502754;Araçariguama;2010;17080;17080;0
3502804;Araçatuba;2010;181579;178077;3502
3502903;Araçoiaba da Serra;2010;27299;18764;8535
3503000;Aramina;2010;5152;4816;336
3503109;Arandu;2010;6123;4614;1509
3503158;Arapeí;2010;2493;1875;618
3503208;Araraquara;2010;208662;202739;5923
3503307;Araras;2010;118843;112444;6399
3503356;Arco-Íris;2010;1925;1097;828
3503406;Arealva;2010;7841;6176;1665
3503505;Areias;2010;3696;2478;1218
3503604;Areiópolis;2010;10579;9401;1178
3503703;Ariranha;2010;8547;8094;453
3503802;Artur Nogueira;2010;44177;39998;4179
3503901;Arujá;2010;74905;71916;2989
3503950;Aspásia;2010;1809;1257;552
3504008;Assis;2010;95144;90991;4153
3504107;Atibaia;2010;126603;115229;11374
3504206;Auriflama;2010;14202;12948;1254
3504305;Avaí;2010;4959;3330;1629
3504404;Avanhandava;2010;11310;9563;1747
3504503;Avaré;2010;82934;79391;3543
3504602;Bady Bassitt;2010;14603;13659;944
3504701;Balbinos;2010;3702;1191;2511
3504800;Bálsamo;2010;8160;7474;686
3504909;Bananal;2010;10223;8157;2066
3505005;Barão de Antonina;2010;3116;1913;1203
3505104;Barbosa;2010;6593;5575;1018
3505203;Bariri;2010;31593;29975;1618
3505302;Barra Bonita;2010;35246;34507;739
3505351;Barra do Chapéu;2010;5244;1544;3700
3505401;Barra do Turvo;2010;7729;3174;4555
3505500;Barretos;2010;112101;108686;3415
3505609;Barrinha;2010;28496;28180;316
3505708;Barueri;2010;240749;240749;0
3505807;Bastos;2010;20445;17608;2837
3505906;Batatais;2010;56476;49945;6531
3506003;Bauru;2010;343937;338186;5751
3506102;Bebedouro;2010;75035;71503;3532
3506201;Bento de Abreu;2010;2674;2444;230
3506300;Bernardino de Campos;2010;10775;9658;1117
3506359;Bertioga;2010;47645;46867;778
3506409;Bilac;2010;7048;6481;567
3506508;Birigui;2010;108728;105487;3241
3506607;Biritiba Mirim;2010;28575;24525;4050
3506706;Boa Esperança do Sul;2010;13645;12184;1461
3506805;Bocaina;2010;10859;10006;853
3506904;Bofete;2010;9618;6132;3486
3507001;Boituva;2010;48314;45448;2866
3507100;Bom Jesus dos Perdões;2010;19708;17376;2332
3507159;Bom Sucesso de Itararé;2010;3571;2430;1141
3507209;Borá;2010;805;627;178
3507308;Boracéia;2010;4268;3827;441
3507407;Borborema;2010;14529;13095;1434
3507456;Borebi;2010;2293;2000;293
3507506;Botucatu;2010;127328;122744;4584
3507605;Bragança Paulista;2010;146744;142255;4489
3507704;Braúna;2010;5021;4390;631
3507753;Brejo Alegre;2010;2573;2110;463
3507803;Brodowski;2010;21107;20597;510
3507902;Brotas;2010;21580;18599;2981
3508009;Buri;2010;18563;14992;3571
3508108;Buritama;2010;15418;14526;892
3508207;Buritizal;2010;4053;3306;747
3508306;Cabrália Paulista;2010;4365;3777;588
3508405;Cabreúva;2010;41604;35261;6343
3508504;Caçapava;2010;84752;72517;12235
3508603;Cachoeira Paulista;2010;30091;24572;5519
3508702;Caconde;2010;18538;12639;5899
3508801;Cafelândia;2010;16607;14426;2181
3508900;Caiabu;2010;4072;3315;757
3509007;Caieiras;2010;86529;84386;2143
3509106;Caiuá;2010;5039;1930;3109
3509205;Cajamar;2010;64114;62823;1291
3509254;Cajati;2010;28372;20720;7652
3509304;Cajobi;2010;9768;9133;635
3509403;Cajuru;2010;23371;20795;2576
3509452;Campina do Monte Alegre;2010;5567;4710;857
3509502;Campinas;2010;1080113;1061540;18573
3509601;Campo Limpo Paulista;2010;74074;74074;0
3509700;Campos do Jordão;2010;47789;47570;219
3509809;Campos Novos Paulista;2010;4539;3528;1011
3509908;Cananéia;2010;12226;10436;1790
3509957;Canas;2010;4385;4070;315
3510005;Cândido Mota;2010;29884;28096;1788
3510104;Cândido Rodrigues;2010;2668;2153;515
3510153;Canitar;2010;4369;4138;231
3510203;Capão Bonito;2010;46178;37824;8354
3510302;Capela do Alto;2010;17532;14522;3010
3510401;Capivari;2010;48576;45904;2672
3510500;Caraguatatuba;2010;100840;96612;4228
3510609;Carapicuíba;2010;369584;369584;0
3510708;Cardoso;2010;11805;10730;1075
3510807;Casa Branca;2010;28307;23154;5153
3510906;Cássia dos Coqueiros;2010;2634;1795;839
3511003;Castilho;2010;18003;13586;4417
3511102;Catanduva;2010;112820;111914;906
3511201;Catiguá;2010;7127;6569;558
3511300;Cedral;2010;7972;6307;1665
3511409;Cerqueira César;2010;17532;15716;1816
3511508;Cerquilho;2010;39617;37567;2050
3511607;Cesário Lange;2010;15540;10492;5048
3511706;Charqueada;2010;15085;13686;1399
3511904;Clementina;2010;7065;6734;331
3512001;Colina;2010;17371;16223;1148
3512100;Colômbia;2010;5994;4332;1662
3512209;Conchal;2010;25229;23839;1390
3512308;Conchas;2010;16288;13197;3091
3512407;Cordeirópolis;2010;21080;18934;2146
3512506;Coroados;2010;5238;4242;996
3512605;Coronel Macedo;2010;5001;3865;1136
3512704;Corumbataí;2010;3874;2093;1781
3512803;Cosmópolis;2010;58827;54634;4193
3512902;Cosmorama;2010;7214;4945;2269
3513009;Cotia;2010;201150;201150;0
3513108;Cravinhos;2010;31691;30902;789
3513207;Cristais Paulista;2010;7588;5528;2060
3513306;Cruzália;2010;2274;1510;764
3513405;Cruzeiro;2010;77039;75076;1963
3513504;Cubatão;2010;118720;118720;0
3513603;Cunha;2010;21866;12167;9699
3513702;Descalvado;2010;31056;27712;3344
3513801;Diadema;2010;386089;386089;0
3513850;Dirce Reis;2010;1689;1279;410
3513900;Divinolândia;2010;11208;7500;3708
3514007;Dobrada;2010;7939;7762;177
3514106;Dois Córregos;2010;24761;23446;1315
3514205;Dolcinópolis;2010;2096;1949;147
3514304;Dourado;2010;8609;7869;740
3514403;Dracena;2010;43258;39946;3312
3514502;Duartina;2010;12251;10997;1254
3514601;Dumont;2010;8143;7854;289
3514700;Echaporã;2010;6318;5032;1286
3514809;Eldorado;2010;14641;7205;7436
3514908;Elias Fausto;2010;15775;12558;3217
3514924;Elisiário;2010;3120;2858;262
3514957;Embaúba;2010;2423;2060;363
3515004;Embu das Artes;2010;240230;240230;0
3515103;Embu-Guaçu;2010;62769;61095;1674
3515129;Emilianópolis;2010;3020;2497;523
3515152;Engenheiro Coelho;2010;15721;11498;4223
3515186;Espírito Santo do Pinhal;2010;41907;37245;4662
3515194;Espírito Santo do Turvo;2010;4244;3630;614
3515202;Estrela d'Oeste;2010;8208;6831;1377
3515301;Estrela do Norte;2010;2658;2099;559
3515350;Euclides da Cunha Paulista;2010;9585;6111;3474
3515400;Fartura;2010;15320;12238;3082
3515509;Fernandópolis;2010;64696;62714;1982
3515608;Fernando Prestes;2010;5534;4698;836
3515657;Fernão;2010;1563;850;713
3515707;Ferraz de Vasconcelos;2010;168306;160754;7552
3515806;Flora Rica;2010;1752;1418;334
3515905;Floreal;2010;3003;2439;564
3516002;Flórida Paulista;2010;12848;10137;2711
3516101;Florínea;2010;2829;2512;317
3516200;Franca;2010;318640;313046;5594
3516309;Francisco Morato;2010;154472;154207;265
3516408;Franco da Rocha;2010;131604;121244;10360
3516507;Gabriel Monteiro;2010;2708;2257;451
3516606;Gália;2010;7011;5225;1786
3516705;Garça;2010;43115;39192;3923
3516804;Gastão Vidigal;2010;4193;3756;437
3516853;Gavião Peixoto;2010;4419;3575;844
3516903;General Salgado;2010;10669;9084;1585
3517000;Getulina;2010;10765;8334;2431
3517109;Glicério;2010;4565;3362;1203
3517208;Guaiçara;2010;10670;9694;976
3517307;Guaimbê;2010;5425;4740;685
3517406;Guaíra;2010;37404;36059;1345
3517505;Guapiaçu;2010;17869;15805;2064
3517604;Guapiara;2010;17998;7233;10765
3517703;Guará;2010;19858;19223;635
3517802;Guaraçaí;2010;8435;6654;1781
3517901;Guaraci;2010;9976;8927;1049
3518008;Guarani d'Oeste;2010;1970;1735;235
3518107;Guarantã;2010;6404;5462;942
3518206;Guararapes;2010;30597;28318;2279
3518305;Guararema;2010;25844;22240;3604
3518404;Guaratinguetá;2010;112072;106762;5310
3518503;Guareí;2010;14565;8413;6152
3518602;Guariba;2010;35486;34748;738
3518701;Guarujá;2010;290752;290696;56
3518800;Guarulhos;2010;1221979;1221979;0
3518859;Guatapará;2010;6966;5116;1850
3518909;Guzolândia;2010;4754;4021;733
3519006;Herculândia;2010;8696;7921;775
3519055;Holambra;2010;11299;8184;3115
3519071;Hortolândia;2010;192692;192692;0
3519105;Iacanga;2010;10013;8726;1287
3519204;Iacri;2010;6419;5050;1369
3519253;Iaras;2010;6376;2837;3539
3519303;Ibaté;2010;30734;29508;1226
3519402;Ibirá;2010;10896;10045;851
3519501;Ibirarema;2010;6725;6212;513
3519600;Ibitinga;2010;53158;51057;2101
3519709;Ibiúna;2010;71217;24933;46284
3519808;Icém;2010;7462;6404;1058
3519907;Iepê;2010;7628;6773;855
3520004;Igaraçu do Tietê;2010;23362;23236;126
3520103;Igarapava;2010;27952;26362;1590
3520202;Igaratá;2010;8831;7005;1826
3520301;Iguape;2010;28841;24687;4154
3520400;Ilhabela;2010;28196;28004;192
3520426;Ilha Comprida;2010;9025;9025;0
3520442;Ilha Solteira;2010;25064;23520;1544
3520509;Indaiatuba;2010;201619;199592;2027
3520608;Indiana;2010;4825;4127;698
3520707;Indiaporã;2010;3903;3379;524
3520806;Inúbia Paulista;2010;3630;3177;453
3520905;Ipaussu;2010;13663;12875;788
3521002;Iperó;2010;28300;17463;10837
3521101;Ipeúna;2010;6016;5178;838
3521150;Ipiguá;2010;4463;2697;1766
3521200;Iporanga;2010;4299;2401;1898
3521309;Ipuã;2010;14148;13562;586
3521408;Iracemápolis;2010;20029;19616;413
3521507;Irapuã;2010;7275;6489;786
3521606;Irapuru;2010;7789;5507;2282
3521705;Itaberá;2010;17858;12139;5719
3521804;Itaí;2010;24008;18852;5156
3521903;Itajobi;2010;14556;12142;2414
3522000;Itaju;2010;3246;2361;885
3522109;Itanhaém;2010;87057;86242;815
3522158;Itaoca;2010;3228;1760;1468
3522208;Itapecerica da Serra;2010;152614;151349;1265
3522307;Itapetininga;2010;144377;131050;13327
3522406;Itapeva;2010;87753;73956;13797
3522505;Itapevi;2010;200769;200769;0
3522604;Itapira;2010;68537;63576;4961
3522653;Itapirapuã Paulista;2010;3880;1892;1988
3522703;Itápolis;2010;40051;36325;3726
3522802;Itaporanga;2010;14549;11033;3516
3522901;Itapuí;2010;12173;11630;543
3523008;Itapura;2010;4357;3482;875
3523107;Itaquaquecetuba;2010;321770;321770;0
3523206;Itararé;2010;47934;44270;3664
3523305;Itariri;2010;15471;9879;5592
3523404;Itatiba;2010;101471;85666;15805
3523503;Itatinga;2010;18052;16420;1632
3523602;Itirapina;2010;15524;14001;1523
3523701;Itirapuã;2010;5914;4929;985
3523800;Itobi;2010;7546;6800;746
3523909;Itu;2010;154147;144269;9878
3524006;Itupeva;2010;44859;38955;5904
3524105;Ituverava;2010;38695;36430;2265
3524204;Jaborandi;2010;6592;6166;426
3524303;Jaboticabal;2010;71662;69527;2135
3524402;Jacareí;2010;211214;208297;2917
3524501;Jaci;2010;5657;4871;786
3524600;Jacupiranga;2010;17208;9369;7839
3524709;Jaguariúna;2010;44311;43033;1278
3524808;Jales;2010;47012;44239;2773
3524907;Jambeiro;2010;5349;2561;2788
3525003;Jandira;2010;108344;108344;0
3525102;Jardinópolis;2010;37661;36141;1520
3525201;Jarinu;2010;23847;18429;5418
3525300;Jaú;2010;131040;126943;4097
3525409;Jeriquara;2010;3160;2606;554
3525508;Joanópolis;2010;11768;11768;0
3525607;João Ramalho;2010;4150;3543;607
3525706;José Bonifácio;2010;32763;29684;3079
3525805;Júlio Mesquita;2010;4430;4214;216
3525854;Jumirim;2010;2798;1623;1175
3525904;Jundiaí;2010;370126;354204;15922
3526001;Junqueirópolis;2010;18726;15399;3327
3526100;Juquiá;2010;19246;12139;7107
3526209;Juquitiba;2010;28737;22240;6497
3526308;Lagoinha;2010;4841;3138;1703
3526407;Laranjal Paulista;2010;25251;22612;2639
3526506;Lavínia;2010;8779;4285;4494
3526605;Lavrinhas;2010;6590;6049;541
3526704;Leme;2010;91756;89862;1894
3526803;Lençóis Paulista;2010;61428;60051;1377
3526902;Limeira;2010;276022;267804;8218
3527009;Lindóia;2010;6712;6712;0
3527108;Lins;2010;71432;70597;835
3527207;Lorena;2010;82537;80174;2363
3527256;Lourdes;2010;2128;1744;384
3527306;Louveira;2010;37125;35695;1430
3527405;Lucélia;2010;19882;17219;2663
3527504;Lucianópolis;2010;2249;1780;469
3527603;Luís Antônio;2010;11286;10901;385
3527702;Luiziânia;2010;5030;4611;419
3527801;Lupércio;2010;4353;3865;488
3527900;Lutécia;2010;2714;2158;556
3528007;Macatuba;2010;16259;15776;483
3528106;Macaubal;2010;7663;6773;890
3528205;Macedônia;2010;3664;2777;887
3528304;Magda;2010;3200;2655;545
3528403;Mairinque;2010;43223;34690;8533
3528502;Mairiporã;2010;80956;70772;10184
3528601;Manduri;2010;8992;7778;1214
3528700;Marabá Paulista;2010;4812;2142;2670
3528809;Maracaí;2010;13332;12085;1247
3528858;Marapoama;2010;2633;2199;434
3528908;Mariápolis;2010;3916;3137;779
3529005;Marília;2010;216745;207021;9724
3529104;Marinópolis;2010;2113;1671;442
3529203;Martinópolis;2010;24219;20341;3878
3529302;Matão;2010;76786;75377;1409
3529401;Mauá;2010;417064;417064;0
3529500;Mendonça;2010;4640;3793;847
3529609;Meridiano;2010;3855;2674;1181
3529658;Mesópolis;2010;1886;1468;418
3529708;Miguelópolis;2010;20451;19265;1186
3529807;Mineiros do Tietê;2010;12038;11500;538
3529906;Miracatu;2010;20592;10586;10006
3530003;Mira Estrela;2010;2820;1881;939
3530102;Mirandópolis;2010;27483;24455;3028
3530201;Mirante do Paranapanema;2010;17059;10045;7014
3530300;Mirassol;2010;53792;52433;1359
3530409;Mirassolândia;2010;4295;3492;803
3530508;Mococa;2010;66290;61149;5141
3530607;Mogi das Cruzes;2010;387779;357313;30466
3530706;Mogi Guaçu;2010;137245;130295;6950
3530805;Mogi Mirim;2010;86505;80945;5560
3530904;Mombuca;2010;3266;2685;581
3531001;Monções;2010;2132;1836;296
3531100;Mongaguá;2010;46293;46169;124
3531209;Monte Alegre do Sul;2010;7152;4091;3061
3531308;Monte Alto;2010;46642;44543;2099
3531407;Monte Aprazível;2010;21746;19803;1943
3531506;Monte Azul Paulista;2010;18931;17713;1218
3531605;Monte Castelo;2010;4063;3211;852
3531704;Monteiro Lobato;2010;4120;1778;2342
3531803;Monte Mor;2010;48949;45978;2971
3531902;Morro Agudo;2010;29116;27907;1209
3532009;Morungaba;2010;11769;10051;1718
3532058;Motuca;2010;4290;3108;1182
3532108;Murutinga do Sul;2010;4186;2573;1613
3532157;Nantes;2010;2707;2431;276
3532207;Narandiba;2010;4288;3105;1183
3532306;Natividade da Serra;2010;6678;2788;3890
3532405;Nazaré Paulista;2010;16414;13911;2503
3532504;Neves Paulista;2010;8772;7916;856
3532603;Nhandeara;2010;10725;8688;2037
3532702;Nipoã;2010;4274;3797;477
3532801;Nova Aliança;2010;5891;4881;1010
3532827;Nova Campina;2010;8515;5762;2753
3532843;Nova Canaã Paulista;2010;2114;880;1234
3532868;Nova Castilho;2010;1125;746;379
3532900;Nova Europa;2010;9300;8625;675
3533007;Nova Granada;2010;19180;17775;1405
3533106;Nova Guataporanga;2010;2177;1890;287
3533205;Nova Independência;2010;3068;2446;622
3533254;Novais;2010;4592;4181;411
3533304;Nova Luzitânia;2010;3441;3087;354
3533403;Nova Odessa;2010;51242;50444;798
3533502;Novo Horizonte;2010;36593;34048;2545
3533601;Nuporanga;2010;6817;6185;632
3533700;Ocauçu;2010;4163;3324;839
3533809;Óleo;2010;2673;1763;910
3533908;Olímpia;2010;50024;47244;2780
3534005;Onda Verde;2010;3884;3043;841
3534104;Oriente;2010;6097;5695;402
3534203;Orindiúva;2010;5675;5223;452
3534302;Orlândia;2010;39781;38756;1025
3534401;Osasco;2010;666740;666740;0
3534500;Oscar Bressane;2010;2537;2099;438
3534609;Osvaldo Cruz;2010;30917;27782;3135
3534708;Ourinhos;2010;103035;100374;2661
3534757;Ouroeste;2010;8405;7546;859
3534807;Ouro Verde;2010;7800;7176;624
3534906;Pacaembu;2010;13226;9745;3481
3535002;Palestina;2010;11051;9188;1863
3535101;Palmares Paulista;2010;10934;10619;315
3535200;Palmeira d'Oeste;2010;9584;7268;2316
3535309;Palmital;2010;21186;19427;1759
3535408;Panorama;2010;14583;14165;418
3535507;Paraguaçu Paulista;2010;42278;38319;3959
3535606;Paraibuna;2010;17388;5242;12146
3535705;Paraíso;2010;5898;5188;710
3535804;Paranapanema;2010;17808;14477;3331
3535903;Paranapuã;2010;3815;3394;421
3536000;Parapuã;2010;10844;8896;1948
3536109;Pardinho;2010;5582;4389;1193
3536208;Pariquera-Açu;2010;18446;12661;5785
3536257;Parisi;2010;2032;1643;389
3536307;Patrocínio Paulista;2010;13000;10499;2501
3536406;Paulicéia;2010;6339;5270;1069
3536505;Paulínia;2010;82146;82069;77
3536570;Paulistânia;2010;1779;1212;567
3536604;Paulo de Faria;2010;8589;7750;839
3536703;Pederneiras;2010;41497;38592;2905
3536802;Pedra Bela;2010;5780;1440;4340
3536901;Pedranópolis;2010;2558;1591;967
3537008;Pedregulho;2010;15700;11583;4117
3537107;Pedreira;2010;41558;41495;63
3537156;Pedrinhas Paulista;2010;2940;2480;460
3537206;Pedro de Toledo;2010;10204;7033;3171
3537305;Penápolis;2010;58510;55882;2628
3537404;Pereira Barreto;2010;24962;23235;1727
3537503;Pereiras;2010;7454;4978;2476
3537602;Peruíbe;2010;59773;59214;559
3537701;Piacatu;2010;5287;4663;624
3537800;Piedade;2010;52143;23760;28383
3537909;Pilar do Sul;2010;26406;20748;5658
3538006;Pindamonhangaba;2010;146995;141708;5287
3538105;Pindorama;2010;15039;14235;804
3538204;Pinhalzinho;2010;13105;6455;6650
3538303;Piquerobi;2010;3537;2669;868
3538501;Piquete;2010;14107;13212;895
3538600;Piracaia;2010;25116;25116;0
3538709;Piracicaba;2010;364571;356743;7828
3538808;Piraju;2010;28475;25604;2871
3538907;Pirajuí;2010;22704;18501;4203
3539004;Pirangi;2010;10623;9528;1095
3539103;Pirapora do Bom Jesus;2010;15733;15733;0
3539202;Pirapozinho;2010;24694;23462;1232
3539301;Pirassununga;2010;70081;64216;5865
3539400;Piratininga;2010;12072;10352;1720
3539509;Pitangueiras;2010;35307;33948;1359
3539608;Planalto;2010;4463;3766;697
3539707;Platina;2010;3192;2513;679
3539806;Poá;2010;106013;104338;1675
3539905;Poloni;2010;5395;4802;593
3540002;Pompéia;2010;19964;18574;1390
3540101;Pongaí;2010;3481;2925;556
3540200;Pontal;2010;40244;39492;752
3540259;Pontalinda;2010;4074;3381;693
3540309;Pontes Gestal;2010;2518;2123;395
3540408;Populina;2010;4223;3412;811
3540507;Porangaba;2010;8326;4020;4306
3540606;Porto Feliz;2010;48893;41096;7797
3540705;Porto Ferreira;2010;51400;50478;922
3540754;Potim;2010;19397;14709;4688
3540804;Potirendaba;2010;15449;13884;1565
3540853;Pracinha;2010;2858;1369;1489
3540903;Pradópolis;2010;17377;16100;1277
3541000;Praia Grande;2010;262051;262051;0
3541059;Pratânia;2010;4599;3485;1114
3541109;Presidente Alves;2010;4123;3431;692
3541208;Presidente Bernardes;2010;13570;10500;3070
3541307;Presidente Epitácio;2010;41318;38545;2773
3541406;Presidente Prudente;2010;207610;203382;4228
3541505;Presidente Venceslau;2010;37910;36272;1638
3541604;Promissão;2010;35674;30070;5604
3541653;Quadra;2010;3236;828;2408
3541703;Quatá;2010;12799;12011;788
3541802;Queiroz;2010;2808;2385;423
3541901;Queluz;2010;11309;9275;2034
3542008;Quintana;2010;6004;5494;510
3542107;Rafard;2010;8612;7591;1021
3542206;Rancharia;2010;28804;25828;2976
3542305;Redenção da Serra;2010;3873;2213;1660
3542404;Regente Feijó;2010;18494;17049;1445
3542503;Reginópolis;2010;7323;4362;2961
3542602;Registro;2010;54261;48169;6092
3542701;Restinga;2010;6587;5179;1408
3542800;Ribeira;2010;3358;1236;2122
3542909;Ribeirão Bonito;2010;12135;11220;915
3543006;Ribeirão Branco;2010;18269;9293;8976
3543105;Ribeirão Corrente;2010;4273;3397;876
3543204;Ribeirão do Sul;2010;4446;3295;1151
3543238;Ribeirão dos Índios;2010;2187;1850;337
3543253;Ribeirão Grande;2010;7422;2344;5078
3543303;Ribeirão Pires;2010;113068;113068;0
3543402;Ribeirão Preto;2010;604682;603186;1496
3543501;Riversul;2010;6163;4492;1671
3543600;Rifaina;2010;3436;3008;428
3543709;Rincão;2010;10414;8460;1954
3543808;Rinópolis;2010;9935;8636;1299
3543907;Rio Claro;2010;186253;181720;4533
3544004;Rio das Pedras;2010;29501;28562;939
3544103;Rio Grande da Serra;2010;43974;43974;0
3544202;Riolândia;2010;10575;8366;2209
3544251;Rosana;2010;19691;15858;3833
3544301;Roseira;2010;9599;9116;483
3544400;Rubiácea;2010;2729;1563;1166
3544509;Rubinéia;2010;2862;2355;507
3544608;Sabino;2010;5217;4575;642
3544707;Sagres;2010;2395;1819;576
3544806;Sales;2010;5451;4907;544
3544905;Sales Oliveira;2010;10568;9569;999
3545001;Salesópolis;2010;15635;9954;5681
3545100;Salmourão;2010;4818;4321;497
3545159;Saltinho;2010;7059;5891;1168
3545209;Salto;2010;105516;104688;828
3545308;Salto de Pirapora;2010;40132;31463;8669
3545407;Salto Grande;2010;8787;7933;854
3545506;Sandovalina;2010;3699;2581;1118
3545605;Santa Adélia;2010;14333;13560;773
3545704;Santa Albertina;2010;5723;4891;832
3545803;Santa Bárbara d'Oeste;2010;180009;178596;1413
3546009;Santa Branca;2010;13763;12140;1623
3546108;Santa Clara d'Oeste;2010;2084;1571;513
3546207;Santa Cruz da Conceição;2010;4002;2708;1294
3546256;Santa Cruz da Esperança;2010;1953;1323;630
3546306;Santa Cruz das Palmeiras;2010;29932;29000;932
3546405;Santa Cruz do Rio Pardo;2010;43921;40154;3767
3546504;Santa Ernestina;2010;5568;5145;423
3546603;Santa Fé do Sul;2010;29239;28088;1151
3546702;Santa Gertrudes;2010;21634;21398;236
3546801;Santa Isabel;2010;50453;39591;10862
3546900;Santa Lúcia;2010;8248;7754;494
3547007;Santa Maria da Serra;2010;5413;4772;641
3547106;Santa Mercedes;2010;2831;2458;373
3547205;Santana da Ponte Pensa;2010;1641;1097;544
3547304;Santana de Parnaíba;2010;108813;108813;0
3547403;Santa Rita d'Oeste;2010;2543;1773;770
3547502;Santa Rita do Passa Quatro;2010;26478;23701;2777
3547601;Santa Rosa de Viterbo;2010;23862;22747;1115
3547650;Santa Salete;2010;1447;819;628
3547700;Santo Anastácio;2010;20475;19080;1395
3547809;Santo André;2010;676407;676407;0
3547908;Santo Antônio da Alegria;2010;6304;4669;1635
3548005;Santo Antônio de Posse;2010;20650;18834;1816
3548054;Santo Antônio do Aracanguá;2010;7626;5971;1655
3548104;Santo Antônio do Jardim;2010;5943;3532;2411
3548203;Santo Antônio do Pinhal;2010;6486;3855;2631
3548302;Santo Expedito;2010;2803;2478;325
3548401;Santópolis do Aguapeí;2010;4277;4133;144
3548500;Santos;2010;419400;419086;314
3548609;São Bento do Sapucaí;2010;10468;5040;5428
3548708;São Bernardo do Campo;2010;765463;752658;12805
3548807;São Caetano do Sul;2010;149263;149263;0
3548906;São Carlos;2010;221950;213061;8889
3549003;São Francisco;2010;2793;2167;626
3549102;São João da Boa Vista;2010;83639;80302;3337
3549201;São João das Duas Pontes;2010;2566;1961;605
3549250;São João de Iracema;2010;1780;1452;328
3549300;São João do Pau d'Alho;2010;2103;1705;398
3549409;São Joaquim da Barra;2010;46512;45678;834
3549508;São José da Bela Vista;2010;8406;7485;921
3549607;São José do Barreiro;2010;4077;2869;1208
3549706;São José do Rio Pardo;2010;51900;45959;5941
3549805;São José do Rio Preto;2010;408258;383490;24768
3549904;São José dos Campos;2010;629921;617119;12802
3549953;São Lourenço da Serra;2010;13973;12719;1254
3550001;São Luiz do Paraitinga;2010;10397;6180;4217
3550100;São Manuel;2010;38342;37413;929
3550209;São Miguel Arcanjo;2010;31450;21502;9948
3550308;São Paulo;2010;11253503;11152968;100535
3550407;São Pedro;2010;31662;26607;5055
3550506;São Pedro do Turvo;2010;7198;5150;2048
3550605;São Roque;2010;78821;71488;7333
3550704;São Sebastião;2010;73942;73011;931
3550803;São Sebastião da Grama;2010;12099;7971;4128
3550902;São Simão;2010;14346;12928;1418
3551009;São Vicente;2010;332445;331817;628
3551108;Sarapuí;2010;9027;6646;2381
3551207;Sarutaiá;2010;3622;2957;665
3551306;Sebastianópolis do Sul;2010;3031;2347;684
3551405;Serra Azul;2010;11256;8017;3239
3551504;Serrana;2010;38878;38466;412
3551603;Serra Negra;2010;26387;22893;3494
3551702;Sertãozinho;2010;110074;108772;1302
3551801;Sete Barras;2010;13005;7191;5814
3551900;Severínia;2010;15501;14774;727
3552007;Silveiras;2010;5792;2879;2913
3552106;Socorro;2010;36686;24944;11742
3552205;Sorocaba;2010;586625;580621;6004
3552304;Sud Mennucci;2010;7435;6389;1046
3552403;Sumaré;2010;241311;238470;2841
3552502;Suzano;2010;262480;253240;9240
3552551;Suzanápolis;2010;3383;2258;1125
3552601;Tabapuã;2010;11363;10519;844
3552700;Tabatinga;2010;14686;12578;2108
3552809;Taboão da Serra;2010;244528;244528;0
3552908;Taciba;2010;5714;4852;862
3553005;Taguaí;2010;10828;7757;3071
3553104;Taiaçu;2010;5894;5339;555
3553203;Taiúva;2010;5447;4967;480
3553302;Tambaú;2010;22406;19909;2497
3553401;Tanabi;2010;24055;21735;2320
3553500;Tapiraí;2010;8012;5679;2333
3553609;Tapiratiba;2010;12737;10504;2233
3553658;Taquaral;2010;2726;2613;113
3553708;Taquaritinga;2010;53988;51168;2820
3553807;Taquarituba;2010;22291;19579;2712
3553856;Taquarivaí;2010;5151;2811;2340
3553906;Tarabai;2010;6607;6109;498
3553955;Tarumã;2010;12885;12126;759
3554003;Tatuí;2010;107326;102256;5070
3554102;Taubaté;2010;278686;272673;6013
3554201;Tejupá;2010;4809;3120;1689
3554300;Teodoro Sampaio;2010;21386;17365;4021
3554409;Terra Roxa;2010;8505;8107;398
3554508;Tietê;2010;36835;33489;3346
3554607;Timburi;2010;2646;1924;722
3554656;Torre de Pedra;2010;2254;1469;785
3554706;Torrinha;2010;9330;7939;1391
3554755;Trabiju;2010;1544;1418;126
3554805;Tremembé;2010;40984;36936;4048
3554904;Três Fronteiras;2010;5427;4598;829
3554953;Tuiuti;2010;5930;2969;2961
3555000;Tupã;2010;63476;60930;2546
3555109;Tupi Paulista;2010;14269;11206;3063
3555208;Turiúba;2010;1930;1580;350
3555307;Turmalina;2010;1978;1407;571
3555356;Ubarana;2010;5289;4845;444
3555406;Ubatuba;2010;78801;76839;1962
3555505;Ubirajara;2010;4427;3229;1198
3555604;Uchoa;2010;9471;8801;670
3555703;União Paulista;2010;1599;1224;375
3555802;Urânia;2010;8836;7436;1400
3555901;Uru;2010;1251;1081;170
3556008;Urupês;2010;12714;11314;1400
3556107;Valentim Gentil;2010;11036;10073;963
3556206;Valinhos;2010;106793;101626;5167
3556305;Valparaíso;2010;22576;21469;1107
3556354;Vargem;2010;8801;4421;4380
3556404;Vargem Grande do Sul;2010;39266;37274;1992
3556453;Vargem Grande Paulista;2010;42997;42997;0
3556503;Várzea Paulista;2010;107089;107089;0
3556602;Vera Cruz;2010;10769;9363;1406
3556701;Vinhedo;2010;63611;61612;1999
3556800;Viradouro;2010;17297;16791;506
3556909;Vista Alegre do Alto;2010;6886;6352;534
3556958;Vitória Brasil;2010;1737;1435;302
3557006;Votorantim;2010;108809;104659;4150
3557105;Votuporanga;2010;84692;82319;2373
3557154;Zacarias;2010;2335;1836;499
3557204;Chavantes;2010;12114;11139;975
3557303;Estiva Gerbi;2010;10044;8011;2033
4100103;Abatiá;2010;7764;5732;2032
4100202;Adrianópolis;2010;6376;2060;4316
4100301;Agudos do Sul;2010;8270;2822;5448
4100400;Almirante Tamandaré;2010;103204;98892;4312
4100459;Altamira do Paraná;2010;4306;2135;2171
4100509;Altônia;2010;20516;15094;5422
4100608;Alto Paraná;2010;13663;11221;2442
4100707;Alto Piquiri;2010;10179;8376;1803
4100806;Alvorada do Sul;2010;10283;7338;2945
4100905;Amaporã;2010;5443;4330;1113
4101002;Ampére;2010;17308;13257;4051
4101051;Anahy;2010;2874;2108;766
4101101;Andirá;2010;20610;19351;1259
4101150;Ângulo;2010;2859;2253;606
4101200;Antonina;2010;18891;16063;2828
4101309;Antônio Olinto;2010;7351;687;6664
4101408;Apucarana;2010;120919;114104;6815
4101507;Arapongas;2010;104150;101851;2299
4101606;Arapoti;2010;25855;21778;4077
4101655;Arapuã;2010;3561;1334;2227
4101705;Araruna;2010;13419;10475;2944
4101804;Araucária;2010;119123;110205;8918
4101853;Ariranha do Ivaí;2010;2453;904;1549
4101903;Assaí;2010;16354;13587;2767
4102000;Assis Chateaubriand;2010;33025;29013;4012
4102109;Astorga;2010;24698;22559;2139
4102208;Atalaia;2010;3913;3347;566
4102307;Balsa Nova;2010;11300;6870;4430
4102406;Bandeirantes;2010;32184;28384;3800
4102505;Barbosa Ferraz;2010;12656;9581;3075
4102604;Barracão;2010;9735;7008;2727
4102703;Barra do Jacaré;2010;2727;1851;876
4102752;Bela Vista da Caroba;2010;3945;1041;2904
4102802;Bela Vista do Paraíso;2010;15079;14196;883
4102901;Bituruna;2010;15880;9899;5981
4103008;Boa Esperança;2010;4568;2640;1928
4103024;Boa Esperança do Iguaçu;2010;2764;953;1811
4103040;Boa Ventura de São Roque;2010;6554;1544;5010
4103057;Boa Vista da Aparecida;2010;7911;4900;3011
4103107;Bocaiúva do Sul;2010;10987;5128;5859
4103156;Bom Jesus do Sul;2010;3796;933;2863
4103206;Bom Sucesso;2010;6561;5329;1232
4103222;Bom Sucesso do Sul;2010;3293;1581;1712
4103305;Borrazópolis;2010;7878;5809;2069
4103354;Braganey;2010;5735;3417;2318
4103370;Brasilândia do Sul;2010;3209;2180;1029
4103404;Cafeara;2010;2695;2195;500
4103453;Cafelândia;2010;14662;12348;2314
4103479;Cafezal do Sul;2010;4290;3325;965
4103503;Califórnia;2010;8069;6028;2041
4103602;Cambará;2010;23886;22365;1521
4103701;Cambé;2010;96733;92952;3781
4103800;Cambira;2010;7236;5475;1761
4103909;Campina da Lagoa;2010;15394;12557;2837
4103958;Campina do Simão;2010;4076;1388;2688
4104006;Campina Grande do Sul;2010;38769;31961;6808
4104055;Campo Bonito;2010;4407;2580;1827
4104105;Campo do Tenente;2010;7125;4194;2931
4104204;Campo Largo;2010;112377;94171;18206
4104253;Campo Magro;2010;24843;19547;5296
4104303;Campo Mourão;2010;87194;82676;4518
4104402;Cândido de Abreu;2010;16655;4752;11903
4104428;Candói;2010;14983;7026;7957
4104451;Cantagalo;2010;12952;8509;4443
4104501;Capanema;2010;18526;11150;7376
4104600;Capitão Leônidas Marques;2010;14970;11490;3480
4104659;Carambeí;2010;19163;13918;5245
4104709;Carlópolis;2010;13706;9353;4353
4104808;Cascavel;2010;286205;270049;16156
4104907;Castro;2010;67084;49210;17874
4105003;Catanduvas;2010;10202;5342;4860
4105102;Centenário do Sul;2010;11190;9334;1856
4105201;Cerro Azul;2010;16938;4808;12130
4105300;Céu Azul;2010;11032;8387;2645
4105409;Chopinzinho;2010;19679;12508;7171
4105508;Cianorte;2010;69958;62282;7676
4105607;Cidade Gaúcha;2010;11062;9176;1886
4105706;Clevelândia;2010;17240;14758;2482
4105805;Colombo;2010;212967;203203;9764
4105904;Colorado;2010;22345;21005;1340
4106001;Congonhinhas;2010;8279;4834;3445
4106100;Conselheiro Mairinck;2010;3636;2515;1121
4106209;Contenda;2010;15891;9231;6660
4106308;Corbélia;2010;16312;13976;2336
4106407;Cornélio Procópio;2010;46928;44308;2620
4106456;Coronel Domingos Soares;2010;7238;1753;5485
4106506;Coronel Vivida;2010;21749;15445;6304
4106555;Corumbataí do Sul;2010;4002;2127;1875
4106571;Cruzeiro do Iguaçu;2010;4278;2623;1655
4106605;Cruzeiro do Oeste;2010;20416;17667;2749
4106704;Cruzeiro do Sul;2010;4563;3404;1159
4106803;Cruz Machado;2010;18040;6057;11983
4106852;Cruzmaltina;2010;3162;1503;1659
4106902;Curitiba;2010;1751907;1751907;0
4107009;Curiúva;2010;13923;9573;4350
4107108;Diamante do Norte;2010;5516;4551;965
4107124;Diamante do Sul;2010;3510;1405;2105
4107157;Diamante D'Oeste;2010;5027;2561;2466
4107207;Dois Vizinhos;2010;36179;28095;8084
4107256;Douradina;2010;7445;5236;2209
4107306;Doutor Camargo;2010;5828;5109;719
4107405;Enéas Marques;2010;6103;2126;3977
4107504;Engenheiro Beltrão;2010;13906;12278;1628
4107520;Esperança Nova;2010;1970;752;1218
4107538;Entre Rios do Oeste;2010;3926;2642;1284
4107546;Espigão Alto do Iguaçu;2010;4677;1646;3031
4107553;Farol;2010;3472;2018;1454
4107603;Faxinal;2010;16314;12739;3575
4107652;Fazenda Rio Grande;2010;81675;75928;5747
4107702;Fênix;2010;4802;3995;807
4107736;Fernandes Pinheiro;2010;5932;2094;3838
4107751;Figueira;2010;8293;7091;1202
4107801;Floraí;2010;5050;4472;578
4107850;Flor da Serra do Sul;2010;4726;1644;3082
4107900;Floresta;2010;5931;5470;461
4108007;Florestópolis;2010;11222;10544;678
4108106;Flórida;2010;2543;2322;221
4108205;Formosa do Oeste;2010;7541;4970;2571
4108304;Foz do Iguaçu;2010;256088;253962;2126
4108320;Francisco Alves;2010;6418;4234;2184
4108403;Francisco Beltrão;2010;78943;67449;11494
4108452;Foz do Jordão;2010;5420;3927;1493
4108502;General Carneiro;2010;13669;9569;4100
4108551;Godoy Moreira;2010;3337;1547;1790
4108601;Goioerê;2010;29018;25242;3776
4108650;Goioxim;2010;7503;1756;5747
4108700;Grandes Rios;2010;6625;3572;3053
4108809;Guaíra;2010;30704;28251;2453
4108908;Guairaçá;2010;6197;4959;1238
4108957;Guamiranga;2010;7900;2236;5664
4109005;Guapirama;2010;3891;2900;991
4109104;Guaporema;2010;2219;1281;938
4109203;Guaraci;2010;5227;4200;1027
4109302;Guaraniaçu;2010;14582;7804;6778
4109401;Guarapuava;2010;167328;152993;14335
4109500;Guaraqueçaba;2010;7871;2683;5188
4109609;Guaratuba;2010;32095;28805;3290
4109658;Honório Serpa;2010;5955;1988;3967
4109708;Ibaiti;2010;28751;23116;5635
4109757;Ibema;2010;6066;4941;1125
4109807;Ibiporã;2010;48198;45895;2303
4109906;Icaraíma;2010;8839;6240;2599
4110003;Iguaraçu;2010;3982;3559;423
4110052;Iguatu;2010;2234;1438;796
4110078;Imbaú;2010;11274;7060;4214
4110102;Imbituva;2010;28455;17888;10567
4110201;Inácio Martins;2010;10943;6288;4655
4110300;Inajá;2010;2988;2761;227
4110409;Indianópolis;2010;4299;3147;1152
4110508;Ipiranga;2010;14150;4889;9261
4110607;Iporã;2010;14981;11777;3204
4110656;Iracema do Oeste;2010;2578;2002;576
4110706;Irati;2010;56207;44932;11275
4110805;Iretama;2010;10622;6187;4435
4110904;Itaguajé;2010;4568;3636;932
4110953;Itaipulândia;2010;9026;4741;4285
4111001;Itambaracá;2010;6759;5080;1679
4111100;Itambé;2010;5979;5674;305
4111209;Itapejara d'Oeste;2010;10531;6987;3544
4111258;Itaperuçu;2010;23887;19956;3931
4111308;Itaúna do Sul;2010;3583;2549;1034
4111407;Ivaí;2010;12815;4629;8186
4111506;Ivaiporã;2010;31816;27438;4378
4111555;Ivaté;2010;7514;5233;2281
4111605;Ivatuba;2010;3010;2294;716
4111704;Jaboti;2010;4902;3027;1875
4111803;Jacarezinho;2010;39121;34774;4347
4111902;Jaguapitã;2010;12225;10380;1845
4112009;Jaguariaíva;2010;32606;28041;4565
4112108;Jandaia do Sul;2010;20269;18331;1938
4112207;Janiópolis;2010;6532;4038;2494
4112306;Japira;2010;4903;2733;2170
4112405;Japurá;2010;8549;7619;930
4112504;Jardim Alegre;2010;12324;7171;5153
4112603;Jardim Olinda;2010;1409;1001;408
4112702;Jataizinho;2010;11875;11053;822
4112751;Jesuítas;2010;9001;6070;2931
4112801;Joaquim Távora;2010;10736;8220;2516
4112900;Jundiaí do Sul;2010;3433;1976;1457
4112959;Juranda;2010;7641;5839;1802
4113007;Jussara;2010;6610;5924;686
4113106;Kaloré;2010;4506;3218;1288
4113205;Lapa;2010;44932;27222;17710
4113254;Laranjal;2010;6360;2031;4329
4113304;Laranjeiras do Sul;2010;30777;25031;5746
4113403;Leópolis;2010;4145;2401;1744
4113429;Lidianópolis;2010;3973;2046;1927
4113452;Lindoeste;2010;5361;2384;2977
4113502;Loanda;2010;21201;19274;1927
4113601;Lobato;2010;4401;4105;296
4113700;Londrina;2010;506701;493520;13181
4113734;Luiziana;2010;7315;4756;2559
4113759;Lunardelli;2010;5160;3594;1566
4113809;Lupionópolis;2010;4592;4079;513
4113908;Mallet;2010;12973;7570;5403
4114005;Mamborê;2010;13961;8984;4977
4114104;Mandaguaçu;2010;19781;17585;2196
4114203;Mandaguari;2010;32658;30934;1724
4114302;Mandirituba;2010;22220;7414;14806
4114351;Manfrinópolis;2010;3127;652;2475
4114401;Mangueirinha;2010;17048;8394;8654
4114500;Manoel Ribas;2010;13169;6805;6364
4114609;Marechal Cândido Rondon;2010;46819;39147;7672
4114708;Maria Helena;2010;5956;3994;1962
4114807;Marialva;2010;31959;25792;6167
4114906;Marilândia do Sul;2010;8863;6314;2549
4115002;Marilena;2010;6858;4984;1874
4115101;Mariluz;2010;10224;8467;1757
4115200;Maringá;2010;357077;350653;6424
4115309;Mariópolis;2010;6268;4469;1799
4115358;Maripá;2010;5684;3262;2422
4115408;Marmeleiro;2010;13900;8824;5076
4115457;Marquinho;2010;4981;524;4457
4115507;Marumbi;2010;4603;3141;1462
4115606;Matelândia;2010;16078;11613;4465
4115705;Matinhos;2010;29428;29260;168
4115739;Mato Rico;2010;3818;957;2861
4115754;Mauá da Serra;2010;8555;7013;1542
4115804;Medianeira;2010;41817;37390;4427
4115853;Mercedes;2010;5046;2439;2607
4115903;Mirador;2010;2327;1579;748
4116000;Miraselva;2010;1862;1430;432
4116059;Missal;2010;10474;5420;5054
4116109;Moreira Sales;2010;12606;9933;2673
4116208;Morretes;2010;15718;7178;8540
4116307;Munhoz de Melo;2010;3672;2974;698
4116406;Nossa Senhora das Graças;2010;3836;3182;654
4116505;Nova Aliança do Ivaí;2010;1431;1041;390
4116604;Nova América da Colina;2010;3478;2524;954
4116703;Nova Aurora;2010;11866;9040;2826
4116802;Nova Cantu;2010;7425;4104;3321
4116901;Nova Esperança;2010;26615;24323;2292
4116950;Nova Esperança do Sudoeste;2010;5098;1846;3252
4117008;Nova Fátima;2010;8147;6609;1538
4117057;Nova Laranjeiras;2010;11241;2372;8869
4117107;Nova Londrina;2010;13067;12014;1053
4117206;Nova Olímpia;2010;5503;4685;818
4117214;Nova Santa Bárbara;2010;3908;3279;629
4117222;Nova Santa Rosa;2010;7626;5315;2311
4117255;Nova Prata do Iguaçu;2010;10377;6067;4310
4117271;Nova Tebas;2010;7398;2891;4507
4117297;Novo Itacolomi;2010;2827;1588;1239
4117305;Ortigueira;2010;23380;9587;13793
4117404;Ourizona;2010;3380;3044;336
4117453;Ouro Verde do Oeste;2010;5692;4039;1653
4117503;Paiçandu;2010;35936;35445;491
4117602;Palmas;2010;42888;39795;3093
4117701;Palmeira;2010;32123;19375;12748
4117800;Palmital;2010;14865;7399;7466
4117909;Palotina;2010;28683;24646;4037
4118006;Paraíso do Norte;2010;11772;11099;673
4118105;Paranacity;2010;10250;9469;781
4118204;Paranaguá;2010;140469;135421;5048
4118303;Paranapoema;2010;2791;2500;291
4118402;Paranavaí;2010;81590;77735;3855
4118451;Pato Bragado;2010;4822;2993;1829
4118501;Pato Branco;2010;72370;68107;4263
4118600;Paula Freitas;2010;5434;2748;2686
4118709;Paulo Frontin;2010;6913;2173;4740
4118808;Peabiru;2010;13624;11009;2615
4118857;Perobal;2010;5653;3080;2573
4118907;Pérola;2010;10208;8070;2138
4119004;Pérola d'Oeste;2010;6761;3187;3574
4119103;Piên;2010;11236;4523;6713
4119152;Pinhais;2010;117008;117008;0
4119202;Pinhalão;2010;6215;3924;2291
4119251;Pinhal de São Bento;2010;2625;1166;1459
4119301;Pinhão;2010;30208;15317;14891
4119400;Piraí do Sul;2010;23424;16102;7322
4119509;Piraquara;2010;93207;45738;47469
4119608;Pitanga;2010;32638;20590;12048
4119657;Pitangueiras;2010;2814;2040;774
4119707;Planaltina do Paraná;2010;4095;2773;1322
4119806;Planalto;2010;13654;6068;7586
4119905;Ponta Grossa;2010;311611;304717;6894
4119954;Pontal do Paraná;2010;20920;20743;177
4120002;Porecatu;2010;14189;11442;2747
4120101;Porto Amazonas;2010;4514;2948;1566
4120150;Porto Barreiro;2010;3663;691;2972
4120200;Porto Rico;2010;2530;1764;766
4120309;Porto Vitória;2010;4020;2235;1785
4120333;Prado Ferreira;2010;3434;3015;419
4120358;Pranchita;2010;5628;3605;2023
4120408;Presidente Castelo Branco;2010;4784;4197;587
4120507;Primeiro de Maio;2010;10832;10083;749
4120606;Prudentópolis;2010;48792;22463;26329
4120655;Quarto Centenário;2010;4856;2912;1944
4120705;Quatiguá;2010;7045;6372;673
4120804;Quatro Barras;2010;19851;17941;1910
4120853;Quatro Pontes;2010;3803;2437;1366
4120903;Quedas do Iguaçu;2010;30605;20987;9618
4121000;Querência do Norte;2010;11729;7622;4107
4121109;Quinta do Sol;2010;5088;3811;1277
4121208;Quitandinha;2010;17089;4887;12202
4121257;Ramilândia;2010;4134;2043;2091
4121307;Rancho Alegre;2010;3955;3470;485
4121356;Rancho Alegre D'Oeste;2010;2847;2303;544
4121406;Realeza;2010;16338;11796;4542
4121505;Rebouças;2010;14176;7505;6671
4121604;Renascença;2010;6812;3485;3327
4121703;Reserva;2010;25172;12206;12966
4121752;Reserva do Iguaçu;2010;7307;3905;3402
4121802;Ribeirão Claro;2010;10678;7085;3593
4121901;Ribeirão do Pinhal;2010;13524;11078;2446
4122008;Rio Azul;2010;14093;5012;9081
4122107;Rio Bom;2010;3334;2007;1327
4122156;Rio Bonito do Iguaçu;2010;13661;3322;10339
4122172;Rio Branco do Ivaí;2010;3898;919;2979
4122206;Rio Branco do Sul;2010;30650;22045;8605
4122305;Rio Negro;2010;31274;25710;5564
4122404;Rolândia;2010;57862;54749;3113
4122503;Roncador;2010;11537;7120;4417
4122602;Rondon;2010;8996;7196;1800
4122651;Rosário do Ivaí;2010;5588;2721;2867
4122701;Sabáudia;2010;6096;5097;999
4122800;Salgado Filho;2010;4403;2254;2149
4122909;Salto do Itararé;2010;5178;3723;1455
4123006;Salto do Lontra;2010;13689;7431;6258
4123105;Santa Amélia;2010;3803;2886;917
4123204;Santa Cecília do Pavão;2010;3646;3057;589
4123303;Santa Cruz de Monte Castelo;2010;8092;5753;2339
4123402;Santa Fé;2010;10432;9232;1200
4123501;Santa Helena;2010;23413;12586;10827
4123600;Santa Inês;2010;1818;1192;626
4123709;Santa Isabel do Ivaí;2010;8760;7062;1698
4123808;Santa Izabel do Oeste;2010;13132;7421;5711
4123824;Santa Lúcia;2010;3925;2536;1389
4123857;Santa Maria do Oeste;2010;11500;3211;8289
4123907;Santa Mariana;2010;12435;8320;4115
4123956;Santa Mônica;2010;3571;1475;2096
4124004;Santana do Itararé;2010;5249;3456;1793
4124020;Santa Tereza do Oeste;2010;10332;8035;2297
4124053;Santa Terezinha de Itaipu;2010;20841;18837;2004
4124103;Santo Antônio da Platina;2010;42707;36944;5763
4124202;Santo Antônio do Caiuá;2010;2727;2123;604
4124301;Santo Antônio do Paraíso;2010;2408;1822;586
4124400;Santo Antônio do Sudoeste;2010;18893;13711;5182
4124509;Santo Inácio;2010;5269;4200;1069
4124608;São Carlos do Ivaí;2010;6354;5679;675
4124707;São Jerônimo da Serra;2010;11337;5661;5676
4124806;São João;2010;10599;6735;3864
4124905;São João do Caiuá;2010;5911;5039;872
4125001;São João do Ivaí;2010;11525;8874;2651
4125100;São João do Triunfo;2010;13704;4048;9656
4125209;São Jorge d'Oeste;2010;9085;5214;3871
4125308;São Jorge do Ivaí;2010;5517;4781;736
4125357;São Jorge do Patrocínio;2010;6041;3539;2502
4125407;São José da Boa Vista;2010;6511;3864;2647
4125456;São José das Palmeiras;2010;3830;2411;1419
4125506;São José dos Pinhais;2010;264210;236895;27315
4125555;São Manoel do Paraná;2010;2098;1159;939
4125605;São Mateus do Sul;2010;41257;25706;15551
4125704;São Miguel do Iguaçu;2010;25769;16485;9284
4125753;São Pedro do Iguaçu;2010;6491;4055;2436
4125803;São Pedro do Ivaí;2010;10167;8044;2123
4125902;São Pedro do Paraná;2010;2491;1631;860
4126009;São Sebastião da Amoreira;2010;8626;7593;1033
4126108;São Tomé;2010;5349;4446;903
4126207;Sapopema;2010;6736;3552;3184
4126256;Sarandi;2010;82847;82543;304
4126272;Saudade do Iguaçu;2010;5028;2503;2525
4126306;Sengés;2010;18414;15107;3307
4126355;Serranópolis do Iguaçu;2010;4568;2322;2246
4126405;Sertaneja;2010;5817;5105;712
4126504;Sertanópolis;2010;15638;13711;1927
4126603;Siqueira Campos;2010;18454;13424;5030
4126652;Sulina;2010;3394;1390;2004
4126678;Tamarana;2010;12262;5858;6404
4126702;Tamboara;2010;4664;3996;668
4126801;Tapejara;2010;14598;13166;1432
4126900;Tapira;2010;5836;3435;2401
4127007;Teixeira Soares;2010;10283;4796;5487
4127106;Telêmaco Borba;2010;69872;68461;1411
4127205;Terra Boa;2010;15776;13051;2725
4127304;Terra Rica;2010;15221;12370;2851
4127403;Terra Roxa;2010;16759;12801;3958
4127502;Tibagi;2010;19344;11668;7676
4127601;Tijucas do Sul;2010;14537;2285;12252
4127700;Toledo;2010;119313;108259;11054
4127809;Tomazina;2010;8791;4119;4672
4127858;Três Barras do Paraná;2010;11824;6095;5729
4127882;Tunas do Paraná;2010;6256;2792;3464
4127908;Tuneiras do Oeste;2010;8695;5973;2722
4127957;Tupãssi;2010;7997;6286;1711
4127965;Turvo;2010;13811;5048;8763
4128005;Ubiratã;2010;21558;18397;3161
4128104;Umuarama;2010;100676;93455;7221
4128203;União da Vitória;2010;52735;49983;2752
4128302;Uniflor;2010;2466;1987;479
4128401;Uraí;2010;11472;9358;2114
4128500;Wenceslau Braz;2010;19298;15509;3789
4128534;Ventania;2010;9957;6511;3446
4128559;Vera Cruz do Oeste;2010;8973;6863;2110
4128609;Verê;2010;7878;3281;4597
4128625;Alto Paraíso;2010;3206;1772;1434
4128633;Doutor Ulysses;2010;5727;929;4798
4128658;Virmond;2010;3950;1880;2070
4128708;Vitorino;2010;6513;3988;2525
4128807;Xambrê;2010;6012;1990;4022
4200051;Abdon Batista;2010;2653;724;1929
4200101;Abelardo Luz;2010;17100;9570;7530
4200200;Agrolândia;2010;9323;5959;3364
4200309;Agronômica;2010;4904;1858;3046
4200408;Água Doce;2010;6961;3433;3528
4200507;Águas de Chapecó;2010;6110;3236;2874
4200556;Águas Frias;2010;2424;981;1443
4200606;Águas Mornas;2010;5548;2327;3221
4200705;Alfredo Wagner;2010;9410;2868;6542
4200754;Alto Bela Vista;2010;2005;605;1400
4200804;Anchieta;2010;6380;2586;3794
4200903;Angelina;2010;5250;1123;4127
4201000;Anita Garibaldi;2010;8623;4551;4072
4201109;Anitápolis;2010;3214;1315;1899
4201208;Antônio Carlos;2010;7458;2341;5117
4201257;Apiúna;2010;9600;4288;5312
4201273;Arabutã;2010;4193;1307;2886
4201307;Araquari;2010;24810;23353;1457
4201406;Araranguá;2010;61310;50526;10784
4201505;Armazém;2010;7753;4884;2869
4201604;Arroio Trinta;2010;3502;2397;1105
4201653;Arvoredo;2010;2260;501;1759
4201703;Ascurra;2010;7412;6457;955
4201802;Atalanta;2010;3300;1368;1932
4201901;Aurora;2010;5549;1931;3618
4201950;Balneário Arroio do Silva;2010;9586;9391;195
4202008;Balneário Camboriú;2010;108089;108089;0
4202057;Balneário Barra do Sul;2010;8430;8035;395
4202073;Balneário Gaivota;2010;8234;6363;1871
4202081;Bandeirante;2010;2906;931;1975
4202099;Barra Bonita;2010;1878;279;1599
4202107;Barra Velha;2010;22386;21320;1066
4202131;Bela Vista do Toldo;2010;6004;847;5157
4202156;Belmonte;2010;2635;1273;1362
4202206;Benedito Novo;2010;10336;5804;4532
4202305;Biguaçu;2010;58206;52758;5448
4202404;Blumenau;2010;309011;294821;14190
4202438;Bocaina do Sul;2010;3290;967;2323
4202453;Bombinhas;2010;14293;14293;0
4202503;Bom Jardim da Serra;2010;4395;2397;1998
4202537;Bom Jesus;2010;2526;1495;1031
4202578;Bom Jesus do Oeste;2010;2132;647;1485
4202602;Bom Retiro;2010;8942;6417;2525
4202701;Botuverá;2010;4468;1310;3158
4202800;Braço do Norte;2010;29018;23383;5635
4202859;Braço do Trombudo;2010;3457;1898;1559
4202875;Brunópolis;2010;2850;705;2145
4202909;Brusque;2010;105503;102025;3478
4203006;Caçador;2010;70762;64457;6305
4203105;Caibi;2010;6219;3578;2641
4203154;Calmon;2010;3387;2115;1272
4203204;Camboriú;2010;62361;59231;3130
4203253;Capão Alto;2010;2753;962;1791
4203303;Campo Alegre;2010;11748;7237;4511
4203402;Campo Belo do Sul;2010;7483;4406;3077
4203501;Campo Erê;2010;9370;6252;3118
4203600;Campos Novos;2010;32824;27064;5760
4203709;Canelinha;2010;10603;6726;3877
4203808;Canoinhas;2010;52765;39273;13492
4203907;Capinzal;2010;20769;17754;3015
4203956;Capivari de Baixo;2010;21674;19816;1858
4204004;Catanduvas;2010;9555;8094;1461
4204103;Caxambu do Sul;2010;4411;2155;2256
4204152;Celso Ramos;2010;2771;872;1899
4204178;Cerro Negro;2010;3581;764;2817
4204194;Chapadão do Lageado;2010;2762;513;2249
4204202;Chapecó;2010;183530;168113;15417
4204251;Cocal do Sul;2010;15159;12696;2463
4204301;Concórdia;2010;68621;54865;13756
4204350;Cordilheira Alta;2010;3767;1448;2319
4204400;Coronel Freitas;2010;10213;6067;4146
4204459;Coronel Martins;2010;2458;685;1773
4204509;Corupá;2010;13852;10669;3183
4204558;Correia Pinto;2010;14785;12022;2763
4204608;Criciúma;2010;192308;189630;2678
4204707;Cunha Porã;2010;10613;6519;4094
4204756;Cunhataí;2010;1882;569;1313
4204806;Curitibanos;2010;37748;34769;2979
4204905;Descanso;2010;8634;4297;4337
4205001;Dionísio Cerqueira;2010;14811;10191;4620
4205100;Dona Emma;2010;3721;1868;1853
4205159;Doutor Pedrinho;2010;3604;2019;1585
4205175;Entre Rios;2010;3018;928;2090
4205191;Ermo;2010;2050;619;1431
4205209;Erval Velho;2010;4352;2842;1510
4205308;Faxinal dos Guedes;2010;10661;7718;2943
4205357;Flor do Sertão;2010;1588;328;1260
4205407;Florianópolis;2010;421240;405189;16051
4205431;Formosa do Sul;2010;2601;1084;1517
4205456;Forquilhinha;2010;22548;18426;4122
4205506;Fraiburgo;2010;34553;30291;4262
4205555;Frei Rogério;2010;2474;706;1768
4205605;Galvão;2010;3472;2347;1125
4205704;Garopaba;2010;18138;15320;2818
4205803;Garuva;2010;14761;11451;3310
4205902;Gaspar;2010;57981;47126;10855
4206009;Governador Celso Ramos;2010;12999;12252;747
4206108;Grão Pará;2010;6223;3019;3204
4206207;Gravatal;2010;10635;4443;6192
4206306;Guabiruba;2010;18430;17066;1364
4206405;Guaraciaba;2010;10498;4924;5574
4206504;Guaramirim;2010;35172;28046;7126
4206603;Guarujá do Sul;2010;4908;2655;2253
4206652;Guatambú;2010;4679;1749;2930
4206702;Herval d'Oeste;2010;21239;18851;2388
4206751;Ibiam;2010;1945;695;1250
4206801;Ibicaré;2010;3373;1557;1816
4206900;Ibirama;2010;17330;14813;2517
4207007;Içara;2010;58833;53913;4920
4207106;Ilhota;2010;12355;7898;4457
4207205;Imaruí;2010;11672;4005;7667
4207304;Imbituba;2010;40170;40170;0
4207403;Imbuia;2010;5707;2515;3192
4207502;Indaial;2010;54854;52927;1927
4207577;Iomerê;2010;2739;907;1832
4207601;Ipira;2010;4752;2521;2231
4207650;Iporã do Oeste;2010;8409;4122;4287
4207684;Ipuaçu;2010;6798;1377;5421
4207700;Ipumirim;2010;7220;3148;4072
4207759;Iraceminha;2010;4253;1468;2785
4207809;Irani;2010;9531;6520;3011
4207858;Irati;2010;2096;449;1647
4207908;Irineópolis;2010;10448;3519;6929
4208005;Itá;2010;6426;4057;2369
4208104;Itaiópolis;2010;20301;10737;9564
4208203;Itajaí;2010;183373;173452;9921
4208302;Itapema;2010;45797;44659;1138
4208401;Itapiranga;2010;15409;7616;7793
4208450;Itapoá;2010;14763;14172;591
4208500;Ituporanga;2010;22250;14832;7418
4208609;Jaborá;2010;4041;1605;2436
4208708;Jacinto Machado;2010;10609;5133;5476
4208807;Jaguaruna;2010;17290;13198;4092
4208906;Jaraguá do Sul;2010;143123;132800;10323
4208955;Jardinópolis;2010;1766;799;967
4209003;Joaçaba;2010;27020;24924;2096
4209102;Joinville;2010;515288;497850;17438
4209151;José Boiteux;2010;4721;1611;3110
4209177;Jupiá;2010;2148;1044;1104
4209201;Lacerdópolis;2010;2199;1160;1039
4209300;Lages;2010;156727;153937;2790
4209409;Laguna;2010;51562;40655;10907
4209458;Lajeado Grande;2010;1490;648;842
4209508;Laurentino;2010;6004;4374;1630
4209607;Lauro Müller;2010;14367;11106;3261
4209706;Lebon Régis;2010;11838;7522;4316
4209805;Leoberto Leal;2010;3365;820;2545
4209854;Lindóia do Sul;2010;4642;1930;2712
4209904;Lontras;2010;10244;7014;3230
4210001;Luiz Alves;2010;10438;3256;7182
4210035;Luzerna;2010;5600;4259;1341
4210050;Macieira;2010;1826;501;1325
4210100;Mafra;2010;52912;41318;11594
4210209;Major Gercino;2010;3279;1249;2030
4210308;Major Vieira;2010;7479;2961;4518
4210407;Maracajá;2010;6404;4256;2148
4210506;Maravilha;2010;22101;18087;4014
4210555;Marema;2010;2203;760;1443
4210605;Massaranduba;2010;14674;7606;7068
4210704;Matos Costa;2010;2839;1465;1374
4210803;Meleiro;2010;7000;3649;3351
4210852;Mirim Doce;2010;2513;1202;1311
4210902;Modelo;2010;4045;2692;1353
4211009;Mondaí;2010;10231;6305;3926
4211058;Monte Carlo;2010;9312;8076;1236
4211108;Monte Castelo;2010;8346;4849;3497
4211207;Morro da Fumaça;2010;16126;13863;2263
4211256;Morro Grande;2010;2890;756;2134
4211306;Navegantes;2010;60556;57402;3154
4211405;Nova Erechim;2010;4275;3211;1064
4211454;Nova Itaberaba;2010;4267;1530;2737
4211504;Nova Trento;2010;12190;9129;3061
4211603;Nova Veneza;2010;13309;8927;4382
4211652;Novo Horizonte;2010;2750;921;1829
4211702;Orleans;2010;21393;16084;5309
4211751;Otacílio Costa;2010;16337;14891;1446
4211801;Ouro;2010;7372;4844;2528
4211850;Ouro Verde;2010;2271;715;1556
4211876;Paial;2010;1763;336;1427
4211892;Painel;2010;2353;945;1408
4211900;Palhoça;2010;137334;135311;2023
4212007;Palma Sola;2010;7765;4468;3297
4212056;Palmeira;2010;2373;925;1448
4212106;Palmitos;2010;16020;9871;6149
4212205;Papanduva;2010;17928;9184;8744
4212239;Paraíso;2010;4080;1451;2629
4212254;Passo de Torres;2010;6627;5876;751
4212270;Passos Maia;2010;4425;1099;3326
4212304;Paulo Lopes;2010;6692;4820;1872
4212403;Pedras Grandes;2010;4107;1261;2846
4212502;Penha;2010;25141;23064;2077
4212601;Peritiba;2010;2988;1481;1507
4212700;Petrolândia;2010;6131;2225;3906
4212809;Balneário Piçarras;2010;17078;15500;1578
4212908;Pinhalzinho;2010;16332;13615;2717
4213005;Pinheiro Preto;2010;3147;1700;1447
4213104;Piratuba;2010;4786;2855;1931
4213153;Planalto Alegre;2010;2654;1067;1587
4213203;Pomerode;2010;27759;23823;3936
4213302;Ponte Alta;2010;4894;3578;1316
4213351;Ponte Alta do Norte;2010;3303;3007;296
4213401;Ponte Serrada;2010;11031;7624;3407
4213500;Porto Belo;2010;16083;15167;916
4213609;Porto União;2010;33493;28266;5227
4213708;Pouso Redondo;2010;14810;9024;5786
4213807;Praia Grande;2010;7267;4297;2970
4213906;Presidente Castello Branco;2010;1725;553;1172
4214003;Presidente Getúlio;2010;14887;10535;4352
4214102;Presidente Nereu;2010;2284;808;1476
4214151;Princesa;2010;2758;1004;1754
4214201;Quilombo;2010;10248;5746;4502
4214300;Rancho Queimado;2010;2748;1290;1458
4214409;Rio das Antas;2010;6143;2740;3403
4214508;Rio do Campo;2010;6192;2632;3560
4214607;Rio do Oeste;2010;7090;3390;3700
4214706;Rio dos Cedros;2010;10284;5110;5174
4214805;Rio do Sul;2010;61198;56785;4413
4214904;Rio Fortuna;2010;4446;1523;2923
4215000;Rio Negrinho;2010;39846;36348;3498
4215059;Rio Rufino;2010;2436;688;1748
4215075;Riqueza;2010;4838;2154;2684
4215109;Rodeio;2010;10922;9424;1498
4215208;Romelândia;2010;5551;2008;3543
4215307;Salete;2010;7370;4987;2383
4215356;Saltinho;2010;3961;1255;2706
4215406;Salto Veloso;2010;4301;3402;899
4215455;Sangão;2010;10400;4856;5544
4215505;Santa Cecília;2010;15757;13663;2094
4215554;Santa Helena;2010;2382;882;1500
4215604;Santa Rosa de Lima;2010;2065;518;1547
4215653;Santa Rosa do Sul;2010;8054;3746;4308
4215679;Santa Terezinha;2010;8767;1513;7254
4215687;Santa Terezinha do Progresso;2010;2896;539;2357
4215695;Santiago do Sul;2010;1465;650;815
4215703;Santo Amaro da Imperatriz;2010;19823;14970;4853
4215752;São Bernardino;2010;2677;719;1958
4215802;São Bento do Sul;2010;74801;71234;3567
4215901;São Bonifácio;2010;3008;685;2323
4216008;São Carlos;2010;10291;6902;3389
4216057;São Cristóvão do Sul;2010;5012;3800;1212
4216107;São Domingos;2010;9491;6313;3178
4216206;São Francisco do Sul;2010;42520;39490;3030
4216255;São João do Oeste;2010;6036;2119;3917
4216305;São João Batista;2010;26260;23551;2709
4216354;São João do Itaperiú;2010;3435;1925;1510
4216404;São João do Sul;2010;7002;1572;5430
4216503;São Joaquim;2010;24812;17573;7239
4216602;São José;2010;209804;207312;2492
4216701;São José do Cedro;2010;13684;8447;5237
4216800;São José do Cerrito;2010;9273;2492;6781
4216909;São Lourenço do Oeste;2010;21792;16880;4912
4217006;São Ludgero;2010;10993;9863;1130
4217105;São Martinho;2010;3209;1231;1978
4217154;São Miguel da Boa Vista;2010;1904;439;1465
4217204;São Miguel do Oeste;2010;36306;32065;4241
4217253;São Pedro de Alcântara;2010;4704;3766;938
4217303;Saudades;2010;9016;5123;3893
4217402;Schroeder;2010;15316;13703;1613
4217501;Seara;2010;16936;11586;5350
4217550;Serra Alta;2010;3285;1835;1450
4217600;Siderópolis;2010;12998;10051;2947
4217709;Sombrio;2010;26613;19638;6975
4217758;Sul Brasil;2010;2766;1011;1755
4217808;Taió;2010;17260;9964;7296
4217907;Tangará;2010;8674;4984;3690
4217956;Tigrinhos;2010;1757;343;1414
4218004;Tijucas;2010;30960;26002;4958
4218103;Timbé do Sul;2010;5308;1845;3463
4218202;Timbó;2010;36774;34296;2478
4218251;Timbó Grande;2010;7167;4083;3084
4218301;Três Barras;2010;18129;15365;2764
4218350;Treviso;2010;3527;1833;1694
4218400;Treze de Maio;2010;6876;3401;3475
4218509;Treze Tílias;2010;6341;4715;1626
4218608;Trombudo Central;2010;6553;4101;2452
4218707;Tubarão;2010;97235;88094;9141
4218756;Tunápolis;2010;4633;1418;3215
4218806;Turvo;2010;11854;7915;3939
4218855;União do Oeste;2010;2910;1107;1803
4218905;Urubici;2010;10699;7066;3633
4218954;Urupema;2010;2482;1232;1250
4219002;Urussanga;2010;20223;11405;8818
4219101;Vargeão;2010;3532;1820;1712
4219150;Vargem;2010;2808;896;1912
4219176;Vargem Bonita;2010;4793;2677;2116
4219200;Vidal Ramos;2010;6290;1792;4498
4219309;Videira;2010;47188;42856;4332
4219358;Vitor Meireles;2010;5207;1445;3762
4219408;Witmarsum;2010;3600;845;2755
4219507;Xanxerê;2010;44128;39143;4985
4219606;Xavantina;2010;4142;1118;3024
4219705;Xaxim;2010;25713;20967;4746
4219853;Zortéa;2010;2991;2336;655
4300034;Aceguá;2010;4394;1059;3335
4300059;Água Santa;2010;3722;1447;2275
4300109;Agudo;2010;16722;6889;9833
4300208;Ajuricaba;2010;7255;4108;3147
4300307;Alecrim;2010;7045;2165;4880
4300406;Alegrete;2010;77653;69594;8059
4300455;Alegria;2010;4301;1585;2716
4300471;Almirante Tamandaré do Sul;2010;2067;839;1228
4300505;Alpestre;2010;8027;2211;5816
4300554;Alto Alegre;2010;1848;743;1105
4300570;Alto Feliz;2010;2917;816;2101
4300604;Alvorada;2010;195673;195673;0
4300638;Amaral Ferrador;2010;6353;1866;4487
4300646;Ametista do Sul;2010;7323;3811;3512
4300661;André da Rocha;2010;1216;496;720
4300703;Anta Gorda;2010;6073;2331;3742
4300802;Antônio Prado;2010;12833;9235;3598
4300851;Arambaré;2010;3693;2913;780
4300877;Araricá;2010;4864;3996;868
4300901;Aratiba;2010;6565;3316;3249
4301008;Arroio do Meio;2010;18783;14663;4120
4301057;Arroio do Sal;2010;7740;7509;231
4301073;Arroio do Padre;2010;2730;454;2276
4301107;Arroio dos Ratos;2010;13606;12956;650
4301206;Arroio do Tigre;2010;12648;5962;6686
4301305;Arroio Grande;2010;18470;16085;2385
4301404;Arvorezinha;2010;10225;6273;3952
4301503;Augusto Pestana;2010;7096;3657;3439
4301552;Áurea;2010;3665;1537;2128
4301602;Bagé;2010;116794;97765;19029
4301636;Balneário Pinhal;2010;10856;10743;113
4301651;Barão;2010;5741;2970;2771
4301701;Barão de Cotegipe;2010;6529;3966;2563
4301750;Barão do Triunfo;2010;7018;697;6321
4301800;Barracão;2010;5357;3037;2320
4301859;Barra do Guarita;2010;3089;1371;1718
4301875;Barra do Quaraí;2010;4012;2840;1172
4301909;Barra do Ribeiro;2010;12572;9291;3281
4301925;Barra do Rio Azul;2010;2003;403;1600
4301958;Barra Funda;2010;2367;1522;845
4302006;Barros Cassal;2010;11133;3531;7602
4302055;Benjamin Constant do Sul;2010;2307;341;1966
4302105;Bento Gonçalves;2010;107278;99104;8174
4302154;Boa Vista das Missões;2010;2114;886;1228
4302204;Boa Vista do Buricá;2010;6574;4366;2208
4302220;Boa Vista do Cadeado;2010;2441;472;1969
4302238;Boa Vista do Incra;2010;2425;724;1701
4302253;Boa Vista do Sul;2010;2776;391;2385
4302303;Bom Jesus;2010;11519;8593;2926
4302352;Bom Princípio;2010;11789;9198;2591
4302378;Bom Progresso;2010;2328;1146;1182
4302402;Bom Retiro do Sul;2010;11472;9162;2310
4302451;Boqueirão do Leão;2010;7673;1672;6001
4302501;Bossoroca;2010;6884;3682;3202
4302584;Bozano;2010;2200;629;1571
4302600;Braga;2010;3702;2282;1420
4302659;Brochier;2010;4675;2296;2379
4302709;Butiá;2010;20406;19330;1076
4302808;Caçapava do Sul;2010;33690;25410;8280
4302907;Cacequi;2010;13676;11952;1724
4303004;Cachoeira do Sul;2010;83827;71700;12127
4303103;Cachoeirinha;2010;118278;118278;0
4303202;Cacique Doble;2010;4868;1628;3240
4303301;Caibaté;2010;4954;2745;2209
4303400;Caiçara;2010;5071;1594;3477
4303509;Camaquã;2010;62764;49356;13408
4303558;Camargo;2010;2592;1095;1497
4303608;Cambará do Sul;2010;6542;3041;3501
4303673;Campestre da Serra;2010;3247;1231;2016
4303707;Campina das Missões;2010;6117;2188;3929
4303806;Campinas do Sul;2010;5506;4217;1289
4303905;Campo Bom;2010;60074;57338;2736
4304002;Campo Novo;2010;5459;4109;1350
4304101;Campos Borges;2010;3494;2006;1488
4304200;Candelária;2010;30171;15715;14456
4304309;Cândido Godói;2010;6535;1846;4689
4304358;Candiota;2010;8771;2598;6173
4304408;Canela;2010;39229;35831;3398
4304507;Canguçu;2010;53259;19694;33565
4304606;Canoas;2010;323827;323827;0
4304614;Canudos do Vale;2010;1807;411;1396
4304622;Capão Bonito do Sul;2010;1754;499;1255
4304630;Capão da Canoa;2010;42040;41787;253
4304655;Capão do Cipó;2010;3104;519;2585
4304663;Capão do Leão;2010;24298;22382;1916
4304671;Capivari do Sul;2010;3890;3230;660
4304689;Capela de Santana;2010;11612;6915;4697
4304697;Capitão;2010;2636;1147;1489
4304705;Carazinho;2010;59317;58253;1064
4304713;Caraá;2010;7312;1058;6254
4304804;Carlos Barbosa;2010;25192;19992;5200
4304853;Carlos Gomes;2010;1607;378;1229
4304903;Casca;2010;8651;5090;3561
4304952;Caseiros;2010;3007;1488;1519
4305009;Catuípe;2010;9323;5998;3325
4305108;Caxias do Sul;2010;435564;419406;16158
4305116;Centenário;2010;2965;949;2016
4305124;Cerrito;2010;6402;3747;2655
4305132;Cerro Branco;2010;4454;1274;3180
4305157;Cerro Grande;2010;2417;830;1587
4305173;Cerro Grande do Sul;2010;10268;2484;7784
4305207;Cerro Largo;2010;13289;10571;2718
4305306;Chapada;2010;9377;5573;3804
4305355;Charqueadas;2010;35320;34490;830
4305371;Charrua;2010;3471;584;2887
4305405;Chiapetta;2010;4044;2470;1574
4305439;Chuí;2010;5917;5697;220
4305447;Chuvisca;2010;4944;273;4671
4305454;Cidreira;2010;12668;12260;408
4305504;Ciríaco;2010;4922;2494;2428
4305587;Colinas;2010;2420;1105;1315
4305603;Colorado;2010;3550;1844;1706
4305702;Condor;2010;6552;4034;2518
4305801;Constantina;2010;9752;6510;3242
4305835;Coqueiro Baixo;2010;1528;282;1246
4305850;Coqueiros do Sul;2010;2457;904;1553
4305871;Coronel Barros;2010;2459;1093;1366
4305900;Coronel Bicaco;2010;7748;5068;2680
4305934;Coronel Pilar;2010;1725;174;1551
4305959;Cotiporã;2010;3917;2048;1869
4305975;Coxilha;2010;2826;1739;1087
4306007;Crissiumal;2010;14084;6124;7960
4306056;Cristal;2010;7280;4077;3203
4306072;Cristal do Sul;2010;2826;931;1895
4306106;Cruz Alta;2010;62821;60594;2227
4306130;Cruzaltense;2010;2141;489;1652
4306205;Cruzeiro do Sul;2010;12320;7476;4844
4306304;David Canabarro;2010;4683;1912;2771
4306320;Derrubadas;2010;3190;901;2289
4306353;Dezesseis de Novembro;2010;2866;667;2199
4306379;Dilermando de Aguiar;2010;3064;937;2127
4306403;Dois Irmãos;2010;27572;27276;296
4306429;Dois Irmãos das Missões;2010;2157;1094;1063
4306452;Dois Lajeados;2010;3278;1564;1714
4306502;Dom Feliciano;2010;14380;3334;11046
4306551;Dom Pedro de Alcântara;2010;2550;741;1809
4306601;Dom Pedrito;2010;38898;35255;3643
4306700;Dona Francisca;2010;3401;2146;1255
4306734;Doutor Maurício Cardoso;2010;5313;2619;2694
4306759;Doutor Ricardo;2010;2030;693;1337
4306767;Eldorado do Sul;2010;34343;30800;3543
4306809;Encantado;2010;20510;17879;2631
4306908;Encruzilhada do Sul;2010;24534;17119;7415
4306924;Engenho Velho;2010;1527;599;928
4306932;Entre-Ijuís;2010;8938;4893;4045
4306957;Entre Rios do Sul;2010;3080;2130;950
4306973;Erebango;2010;2970;1958;1012
4307005;Erechim;2010;96087;90552;5535
4307054;Ernestina;2010;3088;1671;1417
4307104;Herval;2010;6753;4519;2234
4307203;Erval Grande;2010;5163;2690;2473
4307302;Erval Seco;2010;7878;3437;4441
4307401;Esmeralda;2010;3168;2128;1040
4307450;Esperança do Sul;2010;3272;844;2428
4307500;Espumoso;2010;15240;11131;4109
4307559;Estação;2010;6011;5119;892
4307609;Estância Velha;2010;42574;41484;1090
4307708;Esteio;2010;80755;80663;92
4307807;Estrela;2010;30619;25913;4706
4307815;Estrela Velha;2010;3628;1167;2461
4307831;Eugênio de Castro;2010;2798;1480;1318
4307864;Fagundes Varela;2010;2579;1293;1286
4307906;Farroupilha;2010;63635;55053;8582
4308003;Faxinal do Soturno;2010;6672;4175;2497
4308052;Faxinalzinho;2010;2567;1273;1294
4308078;Fazenda Vilanova;2010;3697;2013;1684
4308102;Feliz;2010;12359;9416;2943
4308201;Flores da Cunha;2010;27126;20855;6271
4308250;Floriano Peixoto;2010;2018;292;1726
4308300;Fontoura Xavier;2010;10719;4100;6619
4308409;Formigueiro;2010;7014;2769;4245
4308433;Forquetinha;2010;2479;468;2011
4308458;Fortaleza dos Valos;2010;4575;2993;1582
4308508;Frederico Westphalen;2010;28843;23333;5510
4308607;Garibaldi;2010;30689;27213;3476
4308656;Garruchos;2010;3234;1057;2177
4308706;Gaurama;2010;5862;3388;2474
4308805;General Câmara;2010;8447;4966;3481
4308854;Gentil;2010;1677;723;954
4308904;Getúlio Vargas;2010;16154;13862;2292
4309001;Giruá;2010;17075;12907;4168
4309050;Glorinha;2010;6891;2067;4824
4309100;Gramado;2010;32273;29013;3260
4309126;Gramado dos Loureiros;2010;2269;526;1743
4309159;Gramado Xavier;2010;3970;529;3441
4309209;Gravataí;2010;255660;243497;12163
4309258;Guabiju;2010;1598;738;860
4309308;Guaíba;2010;95204;93064;2140
4309407;Guaporé;2010;22814;20820;1994
4309506;Guarani das Missões;2010;8115;5030;3085
4309555;Harmonia;2010;4254;2456;1798
4309571;Herveiras;2010;2954;384;2570
4309605;Horizontina;2010;18348;14569;3779
4309654;Hulha Negra;2010;6043;2909;3134
4309704;Humaitá;2010;4919;2911;2008
4309753;Ibarama;2010;4371;1053;3318
4309803;Ibiaçá;2010;4710;2849;1861
4309902;Ibiraiaras;2010;7171;3817;3354
4309951;Ibirapuitã;2010;4061;2391;1670
4310009;Ibirubá;2010;19310;15342;3968
4310108;Igrejinha;2010;31660;30190;1470
4310207;Ijuí;2010;78915;71550;7365
4310306;Ilópolis;2010;4102;2207;1895
4310330;Imbé;2010;17670;17661;9
4310363;Imigrante;2010;3023;1499;1524
4310405;Independência;2010;6618;4157;2461
4310413;Inhacorá;2010;2267;1346;921
4310439;Ipê;2010;6016;2913;3103
4310462;Ipiranga do Sul;2010;1944;679;1265
4310504;Iraí;2010;8078;4457;3621
4310538;Itaara;2010;5010;3968;1042
4310553;Itacurubi;2010;3441;1184;2257
4310579;Itapuca;2010;2344;558;1786
4310603;Itaqui;2010;38159;33311;4848
4310652;Itati;2010;2584;212;2372
4310702;Itatiba do Sul;2010;4171;1729;2442
4310751;Ivorá;2010;2156;705;1451
4310801;Ivoti;2010;19874;18062;1812
4310850;Jaboticaba;2010;4098;1487;2611
4310876;Jacuizinho;2010;2507;562;1945
4310900;Jacutinga;2010;3633;2573;1060
4311007;Jaguarão;2010;27931;26105;1826
4311106;Jaguari;2010;11473;6531;4942
4311122;Jaquirana;2010;4177;2430;1747
4311130;Jari;2010;3575;613;2962
4311155;Jóia;2010;8331;2089;6242
4311205;Júlio de Castilhos;2010;19579;16106;3473
4311239;Lagoa Bonita do Sul;2010;2662;384;2278
4311254;Lagoão;2010;6185;1655;4530
4311270;Lagoa dos Três Cantos;2010;1598;807;791
4311304;Lagoa Vermelha;2010;27525;24136;3389
4311403;Lajeado;2010;71445;71180;265
4311429;Lajeado do Bugre;2010;2487;706;1781
4311502;Lavras do Sul;2010;7679;4758;2921
4311601;Liberato Salzano;2010;5780;1297;4483
4311627;Lindolfo Collor;2010;5227;4287;940
4311643;Linha Nova;2010;1624;416;1208
4311700;Machadinho;2010;5510;3385;2125
4311718;Maçambará;2010;4738;1310;3428
4311734;Mampituba;2010;3003;568;2435
4311759;Manoel Viana;2010;7072;5362;1710
4311775;Maquiné;2010;6905;2064;4841
4311791;Maratá;2010;2527;753;1774
4311809;Marau;2010;36364;31558;4806
4311908;Marcelino Ramos;2010;5134;2722;2412
4311981;Mariana Pimentel;2010;3768;638;3130
4312005;Mariano Moro;2010;2210;1153;1057
4312054;Marques de Souza;2010;4068;1545;2523
4312104;Mata;2010;5111;2618;2493
4312138;Mato Castelhano;2010;2470;521;1949
4312153;Mato Leitão;2010;3865;1621;2244
4312179;Mato Queimado;2010;1799;479;1320
4312203;Maximiliano de Almeida;2010;4911;2974;1937
4312252;Minas do Leão;2010;7631;7340;291
4312302;Miraguaí;2010;4855;2069;2786
4312351;Montauri;2010;1542;644;898
4312377;Monte Alegre dos Campos;2010;3102;645;2457
4312385;Monte Belo do Sul;2010;2670;770;1900
4312401;Montenegro;2010;59415;53629;5786
4312427;Mormaço;2010;2749;600;2149
4312443;Morrinhos do Sul;2010;3182;1300;1882
4312450;Morro Redondo;2010;6227;2648;3579
4312476;Morro Reuter;2010;5676;4841;835
4312500;Mostardas;2010;12124;8143;3981
4312609;Muçum;2010;4791;4044;747
4312617;Muitos Capões;2010;2988;970;2018
4312625;Muliterno;2010;1813;508;1305
4312658;Não-Me-Toque;2010;15936;13966;1970
4312674;Nicolau Vergueiro;2010;1721;636;1085
4312708;Nonoai;2010;12074;9065;3009
4312757;Nova Alvorada;2010;3182;1332;1850
4312807;Nova Araçá;2010;4001;2880;1121
4312906;Nova Bassano;2010;8840;5514;3326
4312955;Nova Boa Vista;2010;1960;578;1382
4313003;Nova Bréscia;2010;3184;1511;1673
4313011;Nova Candelária;2010;2751;709;2042
4313037;Nova Esperança do Sul;2010;4671;3599;1072
4313060;Nova Hartz;2010;18346;15269;3077
4313086;Nova Pádua;2010;2450;732;1718
4313102;Nova Palma;2010;6342;3083;3259
4313201;Nova Petrópolis;2010;19045;14134;4911
4313300;Nova Prata;2010;22830;18659;4171
4313334;Nova Ramada;2010;2437;670;1767
4313359;Nova Roma do Sul;2010;3343;1585;1758
4313375;Nova Santa Rita;2010;22716;19475;3241
4313391;Novo Cabrais;2010;3855;545;3310
4313409;Novo Hamburgo;2010;238940;234798;4142
4313425;Novo Machado;2010;3925;1553;2372
4313441;Novo Tiradentes;2010;2277;654;1623
4313466;Novo Xingu;2010;1757;554;1203
4313490;Novo Barreiro;2010;3978;1306;2672
4313508;Osório;2010;40906;38448;2458
4313607;Paim Filho;2010;4243;2253;1990
4313656;Palmares do Sul;2010;10969;9803;1166
4313706;Palmeira das Missões;2010;34328;29831;4497
4313805;Palmitinho;2010;6920;3393;3527
4313904;Panambi;2010;38058;34562;3496
4313953;Pantano Grande;2010;9895;8314;1581
4314001;Paraí;2010;6812;3816;2996
4314027;Paraíso do Sul;2010;7336;2852;4484
4314035;Pareci Novo;2010;3511;981;2530
4314050;Parobé;2010;51502;48633;2869
4314068;Passa Sete;2010;5154;555;4599
4314076;Passo do Sobrado;2010;6011;1429;4582
4314100;Passo Fundo;2010;184826;180120;4706
4314134;Paulo Bento;2010;2196;594;1602
4314159;Paverama;2010;8044;4098;3946
4314175;Pedras Altas;2010;2212;768;1444
4314209;Pedro Osório;2010;7811;7301;510
4314308;Pejuçara;2010;3973;2672;1301
4314407;Pelotas;2010;328275;306193;22082
4314423;Picada Café;2010;5182;4559;623
4314456;Pinhal;2010;2513;1290;1223
4314464;Pinhal da Serra;2010;2130;478;1652
4314472;Pinhal Grande;2010;4471;1895;2576
4314498;Pinheirinho do Vale;2010;4497;915;3582
4314506;Pinheiro Machado;2010;12780;9784;2996
4314555;Pirapó;2010;2757;777;1980
4314605;Piratini;2010;19841;11570;8271
4314704;Planalto;2010;10524;5932;4592
4314753;Poço das Antas;2010;2017;861;1156
4314779;Pontão;2010;3857;1559;2298
4314787;Ponte Preta;2010;1750;512;1238
4314803;Portão;2010;30920;25276;5644
4314902;Porto Alegre;2010;1409351;1409351;0
4315008;Porto Lucena;2010;5413;2331;3082
4315057;Porto Mauá;2010;2542;954;1588
4315073;Porto Vera Cruz;2010;1852;440;1412
4315107;Porto Xavier;2010;10558;5210;5348
4315131;Pouso Novo;2010;1875;632;1243
4315149;Presidente Lucena;2010;2484;1511;973
4315156;Progresso;2010;6163;1873;4290
4315172;Protásio Alves;2010;2000;427;1573
4315206;Putinga;2010;4141;1577;2564
4315305;Quaraí;2010;23021;21310;1711
4315313;Quatro Irmãos;2010;1775;916;859
4315321;Quevedos;2010;2710;852;1858
4315354;Quinze de Novembro;2010;3653;1961;1692
4315404;Redentora;2010;10222;3002;7220
4315453;Relvado;2010;2155;734;1421
4315503;Restinga Sêca;2010;15849;8982;6867
4315552;Rio dos Índios;2010;3616;755;2861
4315602;Rio Grande;2010;197228;189429;7799
4315701;Rio Pardo;2010;37591;25614;11977
4315750;Riozinho;2010;4330;2748;1582
4315800;Roca Sales;2010;10284;6600;3684
4315909;Rodeio Bonito;2010;5743;4251;1492
4315958;Rolador;2010;2546;608;1938
4316006;Rolante;2010;19485;15310;4175
4316105;Ronda Alta;2010;10221;6867;3354
4316204;Rondinha;2010;5518;2317;3201
4316303;Roque Gonzales;2010;7203;3087;4116
4316402;Rosário do Sul;2010;39707;34931;4776
4316428;Sagrada Família;2010;2595;785;1810
4316436;Saldanha Marinho;2010;2869;1927;942
4316451;Salto do Jacuí;2010;11880;10208;1672
4316477;Salvador das Missões;2010;2669;1094;1575
4316501;Salvador do Sul;2010;6747;4009;2738
4316600;Sananduva;2010;15373;10697;4676
4316709;Santa Bárbara do Sul;2010;8829;6985;1844
4316733;Santa Cecília do Sul;2010;1655;480;1175
4316758;Santa Clara do Sul;2010;5697;2855;2842
4316808;Santa Cruz do Sul;2010;118374;105190;13184
4316907;Santa Maria;2010;261031;248347;12684
4316956;Santa Maria do Herval;2010;6053;4362;1691
4316972;Santa Margarida do Sul;2010;2352;552;1800
4317004;Santana da Boa Vista;2010;8242;3723;4519
4317103;Sant'Ana do Livramento;2010;82464;74410;8054
4317202;Santa Rosa;2010;68587;60366;8221
4317251;Santa Tereza;2010;1720;627;1093
4317301;Santa Vitória do Palmar;2010;30990;26890;4100
4317400;Santiago;2010;49071;44735;4336
4317509;Santo Ângelo;2010;76275;71804;4471
4317558;Santo Antônio do Palma;2010;2139;681;1458
4317608;Santo Antônio da Patrulha;2010;39685;28114;11571
4317707;Santo Antônio das Missões;2010;11210;6788;4422
4317756;Santo Antônio do Planalto;2010;1987;1233;754
4317806;Santo Augusto;2010;13968;11380;2588
4317905;Santo Cristo;2010;14378;7781;6597
4317954;Santo Expedito do Sul;2010;2461;872;1589
4318002;São Borja;2010;61671;55138;6533
4318051;São Domingos do Sul;2010;2926;1748;1178
4318101;São Francisco de Assis;2010;19254;13495;5759
4318200;São Francisco de Paula;2010;20537;13004;7533
4318309;São Gabriel;2010;60425;53775;6650
4318408;São Jerônimo;2010;22134;17055;5079
4318424;São João da Urtiga;2010;4726;2291;2435
4318432;São João do Polêsine;2010;2635;1354;1281
4318440;São Jorge;2010;2774;1451;1323
4318457;São José das Missões;2010;2720;828;1892
4318465;São José do Herval;2010;2204;867;1337
4318481;São José do Hortêncio;2010;4094;2645;1449
4318499;São José do Inhacorá;2010;2200;832;1368
4318507;São José do Norte;2010;25503;17383;8120
4318606;São José do Ouro;2010;6904;4423;2481
4318614;São José do Sul;2010;2082;720;1362
4318622;São José dos Ausentes;2010;3290;2062;1228
4318705;São Leopoldo;2010;214087;213238;849
4318804;São Lourenço do Sul;2010;43111;24237;18874
4318903;São Luiz Gonzaga;2010;34556;30508;4048
4319000;São Marcos;2010;20103;17598;2505
4319109;São Martinho;2010;5773;3441;2332
4319125;São Martinho da Serra;2010;3201;942;2259
4319158;São Miguel das Missões;2010;7421;3727;3694
4319208;São Nicolau;2010;5727;3692;2035
4319307;São Paulo das Missões;2010;6364;2199;4165
4319356;São Pedro da Serra;2010;3315;1429;1886
4319364;São Pedro das Missões;2010;1886;532;1354
4319372;São Pedro do Butiá;2010;2873;1209;1664
4319406;São Pedro do Sul;2010;16368;11929;4439
4319505;São Sebastião do Caí;2010;21932;17608;4324
4319604;São Sepé;2010;23798;18821;4977
4319703;São Valentim;2010;3632;1744;1888
4319711;São Valentim do Sul;2010;2168;746;1422
4319737;São Valério do Sul;2010;2647;510;2137
4319752;São Vendelino;2010;1944;1353;591
4319802;São Vicente do Sul;2010;8440;5881;2559
4319901;Sapiranga;2010;74985;72290;2695
4320008;Sapucaia do Sul;2010;130957;130469;488
4320107;Sarandi;2010;21285;17940;3345
4320206;Seberi;2010;10897;5923;4974
4320230;Sede Nova;2010;3011;1581;1430
4320263;Segredo;2010;7158;1807;5351
4320305;Selbach;2010;4929;3450;1479
4320321;Senador Salgado Filho;2010;2814;880;1934
4320354;Sentinela do Sul;2010;5198;1282;3916
4320404;Serafina Corrêa;2010;14253;12054;2199
4320453;Sério;2010;2281;530;1751
4320503;Sertão;2010;6294;3387;2907
4320552;Sertão Santana;2010;5850;1278;4572
4320578;Sete de Setembro;2010;2124;494;1630
4320602;Severiano de Almeida;2010;3842;1399;2443
4320651;Silveira Martins;2010;2449;1091;1358
4320677;Sinimbu;2010;10068;1437;8631
4320701;Sobradinho;2010;14283;11347;2936
4320800;Soledade;2010;30044;24032;6012
4320859;Tabaí;2010;4131;1246;2885
4320909;Tapejara;2010;19250;17080;2170
4321006;Tapera;2010;10448;8820;1628
4321105;Tapes;2010;16629;14478;2151
4321204;Taquara;2010;54643;45266;9377
4321303;Taquari;2010;26092;21875;4217
4321329;Taquaruçu do Sul;2010;2966;1164;1802
4321352;Tavares;2010;5351;3299;2052
4321402;Tenente Portela;2010;13719;8847;4872
4321436;Terra de Areia;2010;9878;5195;4683
4321451;Teutônia;2010;27272;23322;3950
4321469;Tio Hugo;2010;2724;1164;1560
4321477;Tiradentes do Sul;2010;6461;2098;4363
4321493;Toropi;2010;2952;611;2341
4321501;Torres;2010;34656;33340;1316
4321600;Tramandaí;2010;41585;40577;1008
4321626;Travesseiro;2010;2314;887;1427
4321634;Três Arroios;2010;2855;1027;1828
4321667;Três Cachoeiras;2010;10217;7501;2716
4321709;Três Coroas;2010;23848;20546;3302
4321808;Três de Maio;2010;23726;18962;4764
4321832;Três Forquilhas;2010;2914;385;2529
4321857;Três Palmeiras;2010;4381;2090;2291
4321907;Três Passos;2010;23965;19054;4911
4321956;Trindade do Sul;2010;5787;2899;2888
4322004;Triunfo;2010;25793;16857;8936
4322103;Tucunduva;2010;5898;4035;1863
4322152;Tunas;2010;4395;1375;3020
4322186;Tupanci do Sul;2010;1573;473;1100
4322202;Tupanciretã;2010;22281;18020;4261
4322251;Tupandi;2010;3924;2721;1203
4322301;Tuparendi;2010;8557;5294;3263
4322327;Turuçu;2010;3522;1557;1965
4322343;Ubiretama;2010;2296;500;1796
4322350;União da Serra;2010;1487;280;1207
4322376;Unistalda;2010;2450;913;1537
4322400;Uruguaiana;2010;125435;117415;8020
4322509;Vacaria;2010;61342;57339;4003
4322525;Vale Verde;2010;3253;882;2371
4322533;Vale do Sol;2010;11077;1249;9828
4322541;Vale Real;2010;5118;4566;552
4322558;Vanini;2010;1984;1001;983
4322608;Venâncio Aires;2010;65946;41400;24546
4322707;Vera Cruz;2010;23983;13320;10663
4322806;Veranópolis;2010;22810;19843;2967
4322855;Vespasiano Corrêa;2010;1974;406;1568
4322905;Viadutos;2010;5311;2643;2668
4323002;Viamão;2010;239384;224943;14441
4323101;Vicente Dutra;2010;5285;2351;2934
4323200;Victor Graeff;2010;3036;1284;1752
4323309;Vila Flores;2010;3207;1348;1859
4323358;Vila Lângaro;2010;2152;366;1786
4323408;Vila Maria;2010;4221;2249;1972
4323457;Vila Nova do Sul;2010;4221;2194;2027
4323507;Vista Alegre;2010;2832;1185;1647
4323606;Vista Alegre do Prata;2010;1569;463;1106
4323705;Vista Gaúcha;2010;2759;965;1794
4323754;Vitória das Missões;2010;3485;669;2816
4323770;Westfália;2010;2793;1130;1663
4323804;Xangri-lá;2010;12434;12379;55
5000203;Água Clara;2010;14424;9598;4826
5000252;Alcinópolis;2010;4569;3136;1433
5000609;Amambai;2010;34730;22375;12355
5000708;Anastácio;2010;23835;19674;4161
5000807;Anaurilândia;2010;8493;4322;4171
5000856;Angélica;2010;9185;7691;1494
5000906;Antônio João;2010;8208;6828;1380
5001003;Aparecida do Taboado;2010;22320;20096;2224
5001102;Aquidauana;2010;45614;35926;9688
5001243;Aral Moreira;2010;10251;5357;4894
5001508;Bandeirantes;2010;6609;4532;2077
5001904;Bataguassu;2010;19839;15239;4600
5002001;Batayporã;2010;10936;8331;2605
5002100;Bela Vista;2010;23181;18927;4254
5002159;Bodoquena;2010;7985;5777;2208
5002209;Bonito;2010;19587;16159;3428
5002308;Brasilândia;2010;11826;8013;3813
5002407;Caarapó;2010;25767;18309;7458
5002605;Camapuã;2010;13625;9797;3828
5002704;Campo Grande;2010;786797;776242;10555
5002803;Caracol;2010;5398;3238;2160
5002902;Cassilândia;2010;20966;19008;1958
5002951;Chapadão do Sul;2010;19648;16777;2871
5003108;Corguinho;2010;4862;1872;2990
5003157;Coronel Sapucaia;2010;14064;10208;3856
5003207;Corumbá;2010;103703;93452;10251
5003256;Costa Rica;2010;19695;16848;2847
5003306;Coxim;2010;32159;29145;3014
5003454;Deodápolis;2010;12139;10047;2092
5003488;Dois Irmãos do Buriti;2010;10363;4705;5658
5003504;Douradina;2010;5364;3286;2078
5003702;Dourados;2010;196035;181005;15030
5003751;Eldorado;2010;11694;9348;2346
5003801;Fátima do Sul;2010;19035;16967;2068
5003900;Figueirão;2010;2928;1530;1398
5004007;Glória de Dourados;2010;9927;7670;2257
5004106;Guia Lopes da Laguna;2010;10366;8785;1581
5004304;Iguatemi;2010;14875;11006;3869
5004403;Inocência;2010;7669;4871;2798
5004502;Itaporã;2010;20865;13290;7575
5004601;Itaquiraí;2010;18614;7600;11014
5004700;Ivinhema;2010;22341;17274;5067
5004809;Japorã;2010;7731;1400;6331
5004908;Jaraguari;2010;6341;1786;4555
5005004;Jardim;2010;24346;22741;1605
5005103;Jateí;2010;4011;1871;2140
5005152;Juti;2010;5900;3925;1975
5005202;Ladário;2010;19617;18587;1030
5005251;Laguna Carapã;2010;6491;2737;3754
5005400;Maracaju;2010;37405;32224;5181
5005608;Miranda;2010;25595;15567;10028
5005681;Mundo Novo;2010;17043;15271;1772
5005707;Naviraí;2010;46424;42855;3569
5005806;Nioaque;2010;14391;7057;7334
5006002;Nova Alvorada do Sul;2010;16432;12286;4146
5006200;Nova Andradina;2010;45585;38786;6799
5006259;Novo Horizonte do Sul;2010;4940;2660;2280
5006309;Paranaíba;2010;40192;35754;4438
5006358;Paranhos;2010;12350;6263;6087
5006408;Pedro Gomes;2010;7967;6148;1819
5006606;Ponta Porã;2010;77872;62067;15805
5006903;Porto Murtinho;2010;15372;10059;5313
5007109;Ribas do Rio Pardo;2010;20946;12965;7981
5007208;Rio Brilhante;2010;30663;24557;6106
5007307;Rio Negro;2010;5036;3665;1371
5007406;Rio Verde de Mato Grosso;2010;18890;16297;2593
5007505;Rochedo;2010;4928;2889;2039
5007554;Santa Rita do Pardo;2010;7259;3522;3737
5007695;São Gabriel do Oeste;2010;22203;19300;2903
5007703;Sete Quedas;2010;10780;8974;1806
5007802;Selvíria;2010;6287;4772;1515
5007901;Sidrolândia;2010;42132;27783;14349
5007935;Sonora;2010;14833;13401;1432
5007950;Tacuru;2010;10215;3767;6448
5007976;Taquarussu;2010;3518;2454;1064
5008008;Terenos;2010;17146;7275;9871
5008305;Três Lagoas;2010;101791;97069;4722
5008404;Vicentina;2010;5901;4243;1658
5100102;Acorizal;2010;5516;2927;2589
5100201;Água Boa;2010;20856;16759;4097
5100250;Alta Floresta;2010;49164;42718;6446
5100300;Alto Araguaia;2010;15644;13821;1823
5100359;Alto Boa Vista;2010;5247;3178;2069
5100409;Alto Garças;2010;10350;9455;895
5100508;Alto Paraguai;2010;10066;6383;3683
5100607;Alto Taquari;2010;8072;7323;749
5100805;Apiacás;2010;8567;6377;2190
5101001;Araguaiana;2010;3197;2189;1008
5101209;Araguainha;2010;1096;944;152
5101258;Araputanga;2010;15342;12185;3157
5101308;Arenápolis;2010;10316;9750;566
5101407;Aripuanã;2010;18656;11681;6975
5101605;Barão de Melgaço;2010;7591;3422;4169
5101704;Barra do Bugres;2010;31793;25996;5797
5101803;Barra do Garças;2010;56560;50947;5613
5101852;Bom Jesus do Araguaia;2010;5314;2648;2666
5101902;Brasnorte;2010;15357;10038;5319
5102504;Cáceres;2010;87942;76568;11374
5102603;Campinápolis;2010;14305;4820;9485
5102637;Campo Novo do Parecis;2010;27577;25584;1993
5102678;Campo Verde;2010;31589;25472;6117
5102686;Campos de Júlio;2010;5154;4014;1140
5102694;Canabrava do Norte;2010;4786;2691;2095
5102702;Canarana;2010;18754;14805;3949
5102793;Carlinda;2010;10990;4575;6415
5102850;Castanheira;2010;8231;3921;4310
5103007;Chapada dos Guimarães;2010;17821;11037;6784
5103056;Cláudia;2010;11028;8442;2586
5103106;Cocalinho;2010;5490;3647;1843
5103205;Colíder;2010;30766;25014;5752
5103254;Colniza;2010;26381;14987;11394
5103304;Comodoro;2010;18178;12582;5596
5103353;Confresa;2010;25124;14229;10895
5103361;Conquista D'Oeste;2010;3385;2053;1332
5103379;Cotriguaçu;2010;14983;5132;9851
5103403;Cuiabá;2010;551098;540814;10284
5103437;Curvelândia;2010;4866;2894;1972
5103452;Denise;2010;8523;7292;1231
5103502;Diamantino;2010;20341;15895;4446
5103601;Dom Aquino;2010;8171;6558;1613
5103700;Feliz Natal;2010;10933;8123;2810
5103809;Figueirópolis D'Oeste;2010;3796;2010;1786
5103858;Gaúcha do Norte;2010;6293;2196;4097
5103908;General Carneiro;2010;5027;2358;2669
5103957;Glória D'Oeste;2010;3135;2147;988
5104104;Guarantã do Norte;2010;32216;23940;8276
5104203;Guiratinga;2010;13934;11467;2467
5104500;Indiavaí;2010;2397;1781;616
5104526;Ipiranga do Norte;2010;5123;3475;1648
5104542;Itanhangá;2010;5276;3171;2105
5104559;Itaúba;2010;4575;3714;861
5104609;Itiquira;2010;11478;4442;7036
5104807;Jaciara;2010;25647;23623;2024
5104906;Jangada;2010;7696;2946;4750
5105002;Jauru;2010;10455;6171;4284
5105101;Juara;2010;32791;26020;6771
5105150;Juína;2010;39255;33960;5295
5105176;Juruena;2010;11201;6801;4400
5105200;Juscimeira;2010;11430;8501;2929
5105234;Lambari D'Oeste;2010;5431;2895;2536
5105259;Lucas do Rio Verde;2010;45556;42455;3101
5105309;Luciara;2010;2224;2034;190
5105507;Vila Bela da Santíssima Trindade;2010;14493;5166;9327
5105580;Marcelândia;2010;12006;7426;4580
5105606;Matupá;2010;14174;10927;3247
5105622;Mirassol d'Oeste;2010;25299;21470;3829
5105903;Nobres;2010;15002;12703;2299
5106000;Nortelândia;2010;6436;5269;1167
5106109;Nossa Senhora do Livramento;2010;11609;4242;7367
5106158;Nova Bandeirantes;2010;11643;4062;7581
5106174;Nova Nazaré;2010;3029;1119;1910
5106182;Nova Lacerda;2010;5436;2980;2456
5106190;Nova Santa Helena;2010;3468;1988;1480
5106208;Nova Brasilândia;2010;4587;3659;928
5106216;Nova Canaã do Norte;2010;12127;6816;5311
5106224;Nova Mutum;2010;31649;25865;5784
5106232;Nova Olímpia;2010;17515;15836;1679
5106240;Nova Ubiratã;2010;9218;5930;3288
5106257;Nova Xavantina;2010;19643;15746;3897
5106265;Novo Mundo;2010;7332;2883;4449
5106273;Novo Horizonte do Norte;2010;3749;1777;1972
5106281;Novo São Joaquim;2010;6042;3717;2325
5106299;Paranaíta;2010;10684;5652;5032
5106307;Paranatinga;2010;19290;14815;4475
5106315;Novo Santo Antônio;2010;2005;1346;659
5106372;Pedra Preta;2010;15755;11383;4372
5106422;Peixoto de Azevedo;2010;30812;19804;11008
5106455;Planalto da Serra;2010;2726;2054;672
5106505;Poconé;2010;31779;23062;8717
5106653;Pontal do Araguaia;2010;5395;4452;943
5106703;Ponte Branca;2010;1768;1509;259
5106752;Pontes e Lacerda;2010;41408;34662;6746
5106778;Porto Alegre do Norte;2010;10748;5179;5569
5106802;Porto dos Gaúchos;2010;5449;2764;2685
5106828;Porto Esperidião;2010;11031;4203;6828
5106851;Porto Estrela;2010;3649;1466;2183
5107008;Poxoréu;2010;17599;11923;5676
5107040;Primavera do Leste;2010;52066;49271;2795
5107065;Querência;2010;13033;5972;7061
5107107;São José dos Quatro Marcos;2010;18998;14507;4491
5107156;Reserva do Cabaçal;2010;2572;1622;950
5107180;Ribeirão Cascalheira;2010;8881;5565;3316
5107198;Ribeirãozinho;2010;2199;1554;645
5107206;Rio Branco;2010;5070;4145;925
5107248;Santa Carmem;2010;4085;3081;1004
5107263;Santo Afonso;2010;2991;1541;1450
5107297;São José do Povo;2010;3592;1734;1858
5107305;São José do Rio Claro;2010;17124;13168;3956
5107354;São José do Xingu;2010;5240;3783;1457
5107404;São Pedro da Cipa;2010;4158;3703;455
5107578;Rondolândia;2010;3604;950;2654
5107602;Rondonópolis;2010;195476;188028;7448
5107701;Rosário Oeste;2010;17679;10654;7025
5107743;Santa Cruz do Xingu;2010;1900;1251;649
5107750;Salto do Céu;2010;3908;2184;1724
5107768;Santa Rita do Trivelato;2010;2491;1367;1124
5107776;Santa Terezinha;2010;7397;2974;4423
5107792;Santo Antônio do Leste;2010;3754;2119;1635
5107800;Santo Antônio do Leverger;2010;18463;7160;11303
5107859;São Félix do Araguaia;2010;10625;6178;4447
5107875;Sapezal;2010;18094;15124;2970
5107883;Serra Nova Dourada;2010;1365;813;552
5107909;Sinop;2010;113099;93753;19346
5107925;Sorriso;2010;66521;58364;8157
5107941;Tabaporã;2010;9932;5243;4689
5107958;Tangará da Serra;2010;83431;75921;7510
5108006;Tapurah;2010;10392;6526;3866
5108055;Terra Nova do Norte;2010;11291;5079;6212
5108105;Tesouro;2010;3418;2400;1018
5108204;Torixoréu;2010;4071;3112;959
5108303;União do Sul;2010;3760;2338;1422
5108352;Vale de São Domingos;2010;3052;713;2339
5108402;Várzea Grande;2010;252596;248704;3892
5108501;Vera;2010;10235;7349;2886
5108600;Vila Rica;2010;21382;13962;7420
5108808;Nova Guarita;2010;4932;1940;2992
5108857;Nova Marilândia;2010;2951;1957;994
5108907;Nova Maringá;2010;6590;3421;3169
5108956;Nova Monte Verde;2010;8093;3973;4120
5200050;Abadia de Goiás;2010;6876;5081;1795
5200100;Abadiânia;2010;15757;10778;4979
5200134;Acreúna;2010;20279;17696;2583
5200159;Adelândia;2010;2477;2207;270
5200175;Água Fria de Goiás;2010;5090;2137;2953
5200209;Água Limpa;2010;2013;1426;587
5200258;Águas Lindas de Goiás;2010;159378;159138;240
5200308;Alexânia;2010;23814;19676;4138
5200506;Aloândia;2010;2051;1769;282
5200555;Alto Horizonte;2010;4505;3863;642
5200605;Alto Paraíso de Goiás;2010;6885;5219;1666
5200803;Alvorada do Norte;2010;8084;6873;1211
5200829;Amaralina;2010;3434;1101;2333
5200852;Americano do Brasil;2010;5508;4718;790
5200902;Amorinópolis;2010;3609;2171;1438
5201108;Anápolis;2010;334613;328755;5858
5201207;Anhanguera;2010;1020;955;65
5201306;Anicuns;2010;20239;17311;2928
5201405;Aparecida de Goiânia;2010;455657;455193;464
5201454;Aparecida do Rio Doce;2010;2427;1950;477
5201504;Aporé;2010;3803;2541;1262
5201603;Araçu;2010;3802;3357;445
5201702;Aragarças;2010;18305;17617;688
5201801;Aragoiânia;2010;8365;5528;2837
5202155;Araguapaz;2010;7510;5199;2311
5202353;Arenópolis;2010;3277;1919;1358
5202502;Aruanã;2010;7496;6178;1318
5202601;Aurilândia;2010;3650;2800;850
5202809;Avelinópolis;2010;2450;1877;573
5203104;Baliza;2010;3714;1094;2620
5203203;Barro Alto;2010;8716;6251;2465
5203302;Bela Vista de Goiás;2010;24554;17955;6599
5203401;Bom Jardim de Goiás;2010;8423;6349;2074
5203500;Bom Jesus de Goiás;2010;20727;19253;1474
5203559;Bonfinópolis;2010;7536;7021;515
5203575;Bonópolis;2010;3503;1301;2202
5203609;Brazabrantes;2010;3232;2170;1062
5203807;Britânia;2010;5509;4543;966
5203906;Buriti Alegre;2010;9054;8412;642
5203939;Buriti de Goiás;2010;2560;1735;825
5203962;Buritinópolis;2010;3321;1885;1436
5204003;Cabeceiras;2010;7354;5505;1849
5204102;Cachoeira Alta;2010;10553;8382;2171
5204201;Cachoeira de Goiás;2010;1417;1171;246
5204250;Cachoeira Dourada;2010;8254;5357;2897
5204300;Caçu;2010;13283;10735;2548
5204409;Caiapônia;2010;16757;12269;4488
5204508;Caldas Novas;2010;70473;67714;2759
5204557;Caldazinha;2010;3325;1918;1407
5204607;Campestre de Goiás;2010;3387;2376;1011
5204656;Campinaçu;2010;3656;2173;1483
5204706;Campinorte;2010;11111;8995;2116
5204805;Campo Alegre de Goiás;2010;6060;4481;1579
5204854;Campo Limpo de Goiás;2010;6241;5289;952
5204904;Campos Belos;2010;18410;16206;2204
5204953;Campos Verdes;2010;5020;4476;544
5205000;Carmo do Rio Verde;2010;8928;7054;1874
5205059;Castelândia;2010;3638;3344;294
5205109;Catalão;2010;86647;81064;5583
5205208;Caturaí;2010;4686;3664;1022
5205307;Cavalcante;2010;9392;4742;4650
5205406;Ceres;2010;20722;19790;932
5205455;Cezarina;2010;7545;5595;1950
5205471;Chapadão do Céu;2010;7001;5878;1123
5205497;Cidade Ocidental;2010;55915;43654;12261
5205513;Cocalzinho de Goiás;2010;17407;6444;10963
5205521;Colinas do Sul;2010;3523;2525;998
5205703;Córrego do Ouro;2010;2632;1633;999
5205802;Corumbá de Goiás;2010;10361;6416;3945
5205901;Corumbaíba;2010;8181;6307;1874
5206206;Cristalina;2010;46580;38421;8159
5206305;Cristianópolis;2010;2932;2472;460
5206404;Crixás;2010;15760;12318;3442
5206503;Cromínia;2010;3555;2675;880
5206602;Cumari;2010;2964;2419;545
5206701;Damianópolis;2010;3292;1853;1439
5206800;Damolândia;2010;2747;2182;565
5206909;Davinópolis;2010;2056;1400;656
5207105;Diorama;2010;2479;1506;973
5207253;Doverlândia;2010;7892;4916;2976
5207352;Edealina;2010;3733;2569;1164
5207402;Edéia;2010;11266;9538;1728
5207501;Estrela do Norte;2010;3320;2931;389
5207535;Faina;2010;6983;3849;3134
5207600;Fazenda Nova;2010;6322;4078;2244
5207808;Firminópolis;2010;11580;8778;2802
5207907;Flores de Goiás;2010;12066;3170;8896
5208004;Formosa;2010;100085;92023;8062
5208103;Formoso;2010;4883;3607;1276
5208152;Gameleira de Goiás;2010;3275;1094;2181
5208301;Divinópolis de Goiás;2010;4962;3491;1471
5208400;Goianápolis;2010;10695;9691;1004
5208509;Goiandira;2010;5265;4538;727
5208608;Goianésia;2010;59549;55660;3889
5208707;Goiânia;2010;1302001;1297154;4847
5208806;Goianira;2010;34060;33451;609
5208905;Goiás;2010;24727;18638;6089
5209101;Goiatuba;2010;32492;29941;2551
5209150;Gouvelândia;2010;4949;3895;1054
5209200;Guapó;2010;13976;11333;2643
5209291;Guaraíta;2010;2376;1442;934
5209408;Guarani de Goiás;2010;4258;1763;2495
5209457;Guarinos;2010;2299;1131;1168
5209606;Heitoraí;2010;3571;2645;926
5209705;Hidrolândia;2010;17398;10470;6928
5209804;Hidrolina;2010;4029;2980;1049
5209903;Iaciara;2010;12427;9300;3127
5209937;Inaciolândia;2010;5699;4815;884
5209952;Indiara;2010;13687;11446;2241
5210000;Inhumas;2010;48246;45103;3143
5210109;Ipameri;2010;24735;21336;3399
5210158;Ipiranga de Goiás;2010;2844;1272;1572
5210208;Iporá;2010;31274;28545;2729
5210307;Israelândia;2010;2887;2249;638
5210406;Itaberaí;2010;35371;29784;5587
5210562;Itaguari;2010;4513;3968;545
5210604;Itaguaru;2010;5437;4521;916
5210802;Itajá;2010;5062;3740;1322
5210901;Itapaci;2010;18458;16675;1783
5211008;Itapirapuã;2010;7835;5536;2299
5211206;Itapuranga;2010;26125;21235;4890
5211305;Itarumã;2010;6300;4078;2222
5211404;Itauçu;2010;8575;6461;2114
5211503;Itumbiara;2010;92883;88942;3941
5211602;Ivolândia;2010;2663;1535;1128
5211701;Jandaia;2010;6164;4154;2010
5211800;Jaraguá;2010;41870;35328;6542
5211909;Jataí;2010;88006;81010;6996
5212006;Jaupaci;2010;3000;2358;642
5212055;Jesúpolis;2010;2300;1834;466
5212105;Joviânia;2010;7118;6472;646
5212204;Jussara;2010;19153;15207;3946
5212253;Lagoa Santa;2010;1254;776;478
5212303;Leopoldo de Bulhões;2010;7882;4843;3039
5212501;Luziânia;2010;174531;162807;11724
5212600;Mairipotaba;2010;2374;1570;804
5212709;Mambaí;2010;6871;4802;2069
5212808;Mara Rosa;2010;10649;7961;2688
5212907;Marzagão;2010;2072;1804;268
5212956;Matrinchã;2010;4414;2995;1419
5213004;Maurilândia;2010;11521;11120;401
5213053;Mimoso de Goiás;2010;2685;1242;1443
5213087;Minaçu;2010;31154;26554;4600
5213103;Mineiros;2010;52935;48286;4649
5213400;Moiporá;2010;1763;1133;630
5213509;Monte Alegre de Goiás;2010;7730;3164;4566
5213707;Montes Claros de Goiás;2010;7987;5325;2662
5213756;Montividiu;2010;10572;8584;1988
5213772;Montividiu do Norte;2010;4122;1347;2775
5213806;Morrinhos;2010;41460;35959;5501
5213855;Morro Agudo de Goiás;2010;2356;1649;707
5213905;Mossâmedes;2010;5007;3275;1732
5214002;Mozarlândia;2010;13404;12161;1243
5214051;Mundo Novo;2010;6438;3767;2671
5214101;Mutunópolis;2010;3849;2540;1309
5214408;Nazário;2010;7874;6187;1687
5214507;Nerópolis;2010;24210;23229;981
5214606;Niquelândia;2010;42361;33343;9018
5214705;Nova América;2010;2259;1647;612
5214804;Nova Aurora;2010;2062;1873;189
5214838;Nova Crixás;2010;11927;7728;4199
5214861;Nova Glória;2010;8508;5730;2778
5214879;Nova Iguaçu de Goiás;2010;2826;2024;802
5214903;Nova Roma;2010;3471;1426;2045
5215009;Nova Veneza;2010;8129;7026;1103
5215207;Novo Brasil;2010;3519;2274;1245
5215231;Novo Gama;2010;95018;93971;1047
5215256;Novo Planalto;2010;3956;2587;1369
5215306;Orizona;2010;14300;7975;6325
5215405;Ouro Verde de Goiás;2010;4034;2683;1351
5215504;Ouvidor;2010;5467;4810;657
5215603;Padre Bernardo;2010;27671;10786;16885
5215652;Palestina de Goiás;2010;3371;2180;1191
5215702;Palmeiras de Goiás;2010;23338;19166;4172
5215801;Palmelo;2010;2335;2216;119
5215900;Palminópolis;2010;3557;2699;858
5216007;Panamá;2010;2682;2035;647
5216304;Paranaiguara;2010;9100;8388;712
5216403;Paraúna;2010;10863;7987;2876
5216452;Perolândia;2010;2950;1859;1091
5216809;Petrolina de Goiás;2010;10283;6683;3600
5216908;Pilar de Goiás;2010;2773;1201;1572
5217104;Piracanjuba;2010;24026;17551;6475
5217203;Piranhas;2010;11266;9071;2195
5217302;Pirenópolis;2010;23006;15563;7443
5217401;Pires do Rio;2010;28762;27094;1668
5217609;Planaltina;2010;81649;77582;4067
5217708;Pontalina;2010;17121;13897;3224
5218003;Porangatu;2010;42355;35731;6624
5218052;Porteirão;2010;3347;2929;418
5218102;Portelândia;2010;3839;3110;729
5218300;Posse;2010;31419;23939;7480
5218391;Professor Jamil;2010;3239;2261;978
5218508;Quirinópolis;2010;43220;38458;4762
5218607;Rialma;2010;10523;9798;725
5218706;Rianápolis;2010;4566;4081;485
5218789;Rio Quente;2010;3312;2839;473
5218805;Rio Verde;2010;176424;163540;12884
5218904;Rubiataba;2010;18915;16184;2731
5219001;Sanclerlândia;2010;7550;6068;1482
5219100;Santa Bárbara de Goiás;2010;5751;5206;545
5219209;Santa Cruz de Goiás;2010;3142;981;2161
5219258;Santa Fé de Goiás;2010;4762;3811;951
5219308;Santa Helena de Goiás;2010;36469;34815;1654
5219357;Santa Isabel;2010;3686;1367;2319
5219407;Santa Rita do Araguaia;2010;6924;6159;765
5219456;Santa Rita do Novo Destino;2010;3173;1113;2060
5219506;Santa Rosa de Goiás;2010;2909;2177;732
5219605;Santa Tereza de Goiás;2010;3995;3355;640
5219704;Santa Terezinha de Goiás;2010;10302;7768;2534
5219712;Santo Antônio da Barra;2010;4423;3372;1051
5219738;Santo Antônio de Goiás;2010;4703;4271;432
5219753;Santo Antônio do Descoberto;2010;63248;56808;6440
5219803;São Domingos;2010;11272;5774;5498
5219902;São Francisco de Goiás;2010;6120;4464;1656
5220009;São João d'Aliança;2010;10257;6724;3533
5220058;São João da Paraúna;2010;1689;1277;412
5220108;São Luís de Montes Belos;2010;30034;26585;3449
5220157;São Luiz do Norte;2010;4617;3908;709
5220207;São Miguel do Araguaia;2010;22283;17661;4622
5220264;São Miguel do Passa Quatro;2010;3757;2074;1683
5220280;São Patrício;2010;1991;1171;820
5220405;São Simão;2010;17088;16309;779
5220454;Senador Canedo;2010;84443;84234;209
5220504;Serranópolis;2010;7481;5534;1947
5220603;Silvânia;2010;19089;12669;6420
5220686;Simolândia;2010;6514;5378;1136
5220702;Sítio d'Abadia;2010;2825;994;1831
5221007;Taquaral de Goiás;2010;3541;2881;660
5221080;Teresina de Goiás;2010;3016;2134;882
5221197;Terezópolis de Goiás;2010;6561;5677;884
5221304;Três Ranchos;2010;2819;2488;331
5221403;Trindade;2010;104488;100106;4382
5221452;Trombas;2010;3452;2194;1258
5221502;Turvânia;2010;4839;3891;948
5221551;Turvelândia;2010;4399;3138;1261
5221577;Uirapuru;2010;2933;1464;1469
5221601;Uruaçu;2010;36929;33796;3133
5221700;Uruana;2010;13826;11232;2594
5221809;Urutaí;2010;3074;2162;912
5221858;Valparaíso de Goiás;2010;132982;132982;0
5221908;Varjão;2010;3659;2243;1416
5222005;Vianópolis;2010;12548;9170;3378
5222054;Vicentinópolis;2010;7371;6321;1050
5222203;Vila Boa;2010;4735;3502;1233
5222302;Vila Propício;2010;5145;1504;3641
5300108;Brasília;2010;2570160;2481272;88888
